,GAME_ID,H_TEAM,A_TEAM,H_POINTS,A_POINTS,TOTAL,M_OF_VIC,WINNER,PLUS_MINUS,H_FG3_PCT,H_FT_PCT,H_REB,H_AST,H_STL,H_BLK,A_FG3_PCT,A_FT_PCT,A_REB,A_AST,A_STL,A_BLK
0,21400001,Orlando Magic,New Orleans Pelicans,84,101,185,17,New Orleans Pelicans,17,0.364,0.762,56,17,5,9,0.235,0.484,62,20,10,17
1,21400002,Dallas Mavericks,San Antonio Spurs,100,101,201,1,San Antonio Spurs,1,0.381,0.842,33,17,9,3,0.5,0.813,38,23,5,3
2,21400003,Houston Rockets,Los Angeles Lakers,108,90,198,18,Houston Rockets,18,0.414,0.68,47,22,7,3,0.3,0.795,36,16,7,3
3,21400004,Milwaukee Bucks,Charlotte Hornets,106,108,214,2,Charlotte Hornets,2,0.5,0.875,35,25,9,10,0.286,0.69,50,27,8,9
4,21400005,Philadelphia 76ers,Indiana Pacers,91,103,194,12,Indiana Pacers,12,0.286,0.567,42,17,10,5,0.32,0.679,50,22,5,13
5,21400006,Brooklyn Nets,Boston Celtics,105,121,226,16,Boston Celtics,16,0.368,0.769,39,20,6,7,0.364,0.652,35,28,11,5
6,21400007,Washington Wizards,Miami Heat,95,107,202,12,Miami Heat,12,0.316,0.708,36,20,7,2,0.321,0.87,44,20,9,3
7,21400008,Atlanta Hawks,Toronto Raptors,102,109,211,7,Toronto Raptors,7,0.591,0.529,42,26,6,8,0.308,0.818,48,26,13,9
8,21400009,Minnesota Timberwolves,Memphis Grizzlies,101,105,206,4,Memphis Grizzlies,4,0.5,0.739,47,20,8,4,0.267,0.75,33,21,10,5
9,21400010,Chicago Bulls,New York Knicks,104,80,184,24,Chicago Bulls,24,0.292,0.833,47,21,9,4,0.176,0.882,38,19,9,5
10,21400011,Detroit Pistons,Denver Nuggets,79,89,168,10,Denver Nuggets,10,0.231,0.579,45,15,4,5,0.25,0.742,51,17,7,4
11,21400012,Houston Rockets,Utah Jazz,104,93,197,11,Houston Rockets,11,0.519,0.714,35,18,7,6,0.167,0.824,34,16,8,6
12,21400013,Los Angeles Lakers,Phoenix Suns,99,119,218,20,Phoenix Suns,20,0.308,0.84,38,20,9,3,0.5,0.722,40,23,5,3
13,21400014,Golden State Warriors,Sacramento Kings,95,77,172,18,Golden State Warriors,18,0.222,0.719,44,21,12,8,0.167,0.743,50,13,11,3
14,21400015,Oklahoma City Thunder,Portland Trail Blazers,89,106,195,17,Portland Trail Blazers,17,0.125,0.808,43,19,9,5,0.379,0.773,42,23,4,9
15,21400016,Washington Wizards,Orlando Magic,105,98,203,7,Washington Wizards,7,0.538,0.769,37,22,10,0,0.4,0.75,33,20,4,1
16,21400017,Detroit Pistons,Minnesota Timberwolves,91,97,188,6,Minnesota Timberwolves,6,0.333,0.615,46,20,3,5,0.4,0.679,43,18,8,3
17,21400018,New York Knicks,Cleveland Cavaliers,95,90,185,5,New York Knicks,5,0.5,0.833,35,30,9,1,0.375,0.85,33,22,5,2
18,21400019,Utah Jazz,Dallas Mavericks,102,120,222,18,Dallas Mavericks,18,0.4,0.889,40,22,6,0,0.381,0.783,44,25,8,5
19,21400020,Oklahoma City Thunder,Los Angeles Clippers,90,93,183,3,Los Angeles Clippers,3,0.286,0.824,47,23,5,2,0.233,0.72,33,17,10,4
20,21400021,Memphis Grizzlies,Indiana Pacers,97,89,186,8,Memphis Grizzlies,8,0.368,0.741,40,20,11,2,0.381,0.813,46,19,5,3
21,21400022,Cleveland Cavaliers,Chicago Bulls,114,108,222,6,Cleveland Cavaliers,6,0.2,0.879,52,18,8,4,0.419,0.765,42,25,4,14
22,21400023,Philadelphia 76ers,Milwaukee Bucks,81,93,174,12,Milwaukee Bucks,12,0.217,0.545,42,20,9,5,0.375,0.571,55,25,10,11
23,21400024,San Antonio Spurs,Phoenix Suns,89,94,183,5,Phoenix Suns,5,0.32,0.739,45,20,3,3,0.111,0.846,50,15,2,5
24,21400025,Portland Trail Blazers,Sacramento Kings,94,103,197,9,Sacramento Kings,9,0.346,0.895,38,20,5,8,0.4,0.886,49,14,6,2
25,21400026,Los Angeles Clippers,Los Angeles Lakers,118,111,229,7,Los Angeles Clippers,7,0.364,0.864,36,25,6,2,0.35,0.714,40,24,5,2
26,21400027,Dallas Mavericks,New Orleans Pelicans,109,104,213,5,Dallas Mavericks,5,0.24,0.579,44,25,4,6,0.368,0.75,47,24,8,4
27,21400028,Memphis Grizzlies,Charlotte Hornets,71,69,140,2,Memphis Grizzlies,2,0.273,0.769,45,16,8,0,0.286,0.722,44,17,10,4
28,21400029,Toronto Raptors,Orlando Magic,108,95,203,13,Toronto Raptors,13,0.19,0.792,50,13,4,4,0.35,0.5,40,25,3,7
29,21400030,Miami Heat,Philadelphia 76ers,114,96,210,18,Miami Heat,18,0.5,0.69,35,33,16,0,0.304,0.731,37,28,9,10
30,21400031,Milwaukee Bucks,Washington Wizards,97,108,205,11,Washington Wizards,11,0.409,0.833,42,18,11,3,0.308,0.727,34,28,18,5
31,21400032,Indiana Pacers,Atlanta Hawks,92,102,194,10,Atlanta Hawks,10,0.375,0.857,44,25,5,5,0.35,0.758,37,26,10,6
32,21400033,Brooklyn Nets,Detroit Pistons,102,90,192,12,Brooklyn Nets,12,0.269,0.846,48,18,3,3,0.059,0.714,41,21,3,3
33,21400034,Boston Celtics,Houston Rockets,90,104,194,14,Houston Rockets,14,0.04,0.833,44,20,10,8,0.353,0.7,49,20,9,8
34,21400035,Chicago Bulls,Minnesota Timberwolves,106,105,211,1,Chicago Bulls,1,0.391,0.775,38,15,3,8,0.333,0.806,42,26,9,4
35,21400036,Denver Nuggets,Oklahoma City Thunder,91,102,193,11,Oklahoma City Thunder,11,0.269,0.7,41,19,4,10,0.3,0.71,41,24,8,6
36,21400037,Phoenix Suns,Utah Jazz,91,118,209,27,Utah Jazz,27,0.226,0.8,34,17,8,7,0.269,0.818,52,19,10,6
37,21400038,Los Angeles Lakers,Golden State Warriors,104,127,231,23,Golden State Warriors,23,0.286,0.72,37,21,9,3,0.478,0.857,43,30,10,4
38,21400039,Sacramento Kings,Los Angeles Clippers,98,92,190,6,Sacramento Kings,6,0.3,0.818,46,21,4,11,0.29,0.81,35,23,10,7
39,21400040,Toronto Raptors,Miami Heat,102,107,209,5,Miami Heat,5,0.25,0.615,28,11,8,5,0.375,0.737,43,22,6,6
40,21400041,Charlotte Hornets,New York Knicks,93,96,189,3,New York Knicks,3,0.4,0.724,38,20,7,2,0.5,0.588,35,23,5,0
41,21400042,Golden State Warriors,Portland Trail Blazers,95,90,185,5,Golden State Warriors,5,0.316,0.81,41,22,11,7,0.259,0.643,56,20,9,2
42,21400043,Houston Rockets,Philadelphia 76ers,104,93,197,11,Houston Rockets,11,0.471,0.8,47,27,12,6,0.5,0.696,31,19,12,4
43,21400044,Oklahoma City Thunder,Brooklyn Nets,85,116,201,31,Brooklyn Nets,31,0.348,0.619,44,14,3,3,0.478,0.895,42,25,11,3
44,21400045,New Orleans Pelicans,Memphis Grizzlies,81,93,174,12,Memphis Grizzlies,12,0.167,0.655,49,14,5,3,0.286,0.73,52,19,5,6
45,21400046,Boston Celtics,Dallas Mavericks,113,118,231,5,Dallas Mavericks,5,0.355,0.75,49,29,9,6,0.56,0.8,36,24,5,9
46,21400047,Sacramento Kings,Denver Nuggets,110,105,215,5,Sacramento Kings,5,0.222,0.851,50,21,8,5,0.208,0.848,42,22,4,7
47,21400048,Utah Jazz,Los Angeles Clippers,101,107,208,6,Los Angeles Clippers,6,0.37,0.792,43,24,4,2,0.435,0.882,35,28,6,6
48,21400049,Milwaukee Bucks,Indiana Pacers,87,81,168,6,Milwaukee Bucks,6,0.333,0.857,39,20,12,5,0.25,0.591,47,14,4,9
49,21400050,Houston Rockets,Miami Heat,108,91,199,17,Houston Rockets,17,0.459,0.778,38,22,8,5,0.429,0.63,34,16,7,2
50,21400051,Washington Wizards,New York Knicks,98,83,181,15,Washington Wizards,15,0.444,0.632,41,26,8,4,0.533,0.789,43,16,5,4
51,21400052,Oklahoma City Thunder,Toronto Raptors,88,100,188,12,Toronto Raptors,12,0.286,0.56,41,23,4,3,0.258,0.848,39,23,6,3
52,21400053,Orlando Magic,Chicago Bulls,90,98,188,8,Chicago Bulls,8,0.429,0.571,48,21,6,6,0.467,0.778,44,23,6,9
53,21400054,Charlotte Hornets,New Orleans Pelicans,91,100,191,9,New Orleans Pelicans,9,0.286,0.846,34,23,6,1,0.278,1,47,26,5,6
54,21400055,Cleveland Cavaliers,Portland Trail Blazers,82,101,183,19,Portland Trail Blazers,19,0.429,0.786,41,18,5,3,0.32,0.76,48,21,7,4
55,21400056,Phoenix Suns,Los Angeles Lakers,112,106,218,6,Phoenix Suns,6,0.333,0.774,52,28,6,7,0.375,0.732,49,16,7,8
56,21400057,Miami Heat,Charlotte Hornets,89,96,185,7,Charlotte Hornets,7,0.182,0.806,36,19,6,4,0.278,0.724,49,23,4,9
57,21400058,Orlando Magic,Philadelphia 76ers,91,89,180,2,Orlando Magic,2,0.15,0.833,51,14,11,3,0.32,0.652,38,22,12,12
58,21400059,Toronto Raptors,Boston Celtics,110,107,217,3,Toronto Raptors,3,0.438,0.826,24,18,11,4,0.385,0.944,55,22,5,3
59,21400060,Minnesota Timberwolves,Brooklyn Nets,98,91,189,7,Minnesota Timberwolves,7,0.412,0.773,51,22,9,4,0.381,0.647,42,17,6,5
60,21400061,New York Knicks,Detroit Pistons,95,98,193,3,Detroit Pistons,3,0.45,0.8,43,25,3,9,0.478,0.697,55,17,5,4
61,21400062,Chicago Bulls,Milwaukee Bucks,95,86,181,9,Chicago Bulls,9,0.313,0.733,42,24,8,3,0.2,0.85,50,19,10,3
62,21400063,Indiana Pacers,Washington Wizards,94,96,190,2,Washington Wizards,2,0.296,0.8,57,22,3,9,0.412,0.913,43,24,7,7
63,21400064,Atlanta Hawks,San Antonio Spurs,92,94,186,2,San Antonio Spurs,2,0.32,0.727,37,26,14,5,0.294,0.711,50,25,7,9
64,21400065,Memphis Grizzlies,Phoenix Suns,102,91,193,11,Memphis Grizzlies,11,0.529,0.765,37,25,10,1,0.381,0.905,35,13,11,4
65,21400066,Cleveland Cavaliers,Utah Jazz,100,102,202,2,Utah Jazz,2,0.375,0.85,30,6,8,4,0.333,0.773,41,26,3,8
66,21400067,Denver Nuggets,Sacramento Kings,109,131,240,22,Sacramento Kings,22,0.321,0.839,32,24,4,5,0.4,0.78,40,21,8,3
67,21400068,Los Angeles Clippers,Golden State Warriors,104,121,225,17,Golden State Warriors,17,0.368,0.778,30,26,12,2,0.6,1,39,29,7,3
68,21400069,San Antonio Spurs,Houston Rockets,81,98,179,17,Houston Rockets,17,0.1,0.895,41,17,12,1,0.37,0.606,44,18,7,6
69,21400070,Dallas Mavericks,Portland Trail Blazers,87,108,195,21,Portland Trail Blazers,21,0.217,1,34,14,6,4,0.4,0.842,53,25,3,6
70,21400071,Atlanta Hawks,Charlotte Hornets,119,122,241,3,Charlotte Hornets,3,0.394,0.769,38,28,8,3,0.286,0.741,51,31,6,7
71,21400072,Minnesota Timberwolves,Orlando Magic,103,112,215,9,Orlando Magic,9,0.222,0.76,38,24,9,7,0.5,0.789,52,19,5,6
72,21400073,Chicago Bulls,Philadelphia 76ers,118,115,233,3,Chicago Bulls,3,0.5,0.765,40,25,4,6,0.4,0.68,42,29,7,2
73,21400074,Indiana Pacers,Boston Celtics,98,101,199,3,Boston Celtics,3,0.263,1,42,18,2,6,0.333,0.875,38,26,6,3
74,21400075,New York Knicks,Brooklyn Nets,99,110,209,11,Brooklyn Nets,11,0.421,0.81,43,22,7,2,0.583,0.769,42,18,6,6
75,21400076,Milwaukee Bucks,Detroit Pistons,95,98,193,3,Detroit Pistons,3,0.25,0.783,35,26,10,6,0.478,0.542,40,18,7,5
76,21400077,Washington Wizards,Toronto Raptors,84,103,187,19,Toronto Raptors,19,0.158,0.656,50,19,7,5,0.409,0.774,49,19,5,3
77,21400078,Memphis Grizzlies,Oklahoma City Thunder,91,89,180,2,Memphis Grizzlies,2,0.5,0.824,38,21,10,4,0.48,0.273,44,16,3,1
78,21400079,Sacramento Kings,Phoenix Suns,114,112,226,2,Sacramento Kings,2,0.188,0.846,60,16,6,4,0.323,0.72,42,19,7,7
79,21400080,Dallas Mavericks,Utah Jazz,105,82,187,23,Dallas Mavericks,23,0.375,0.857,42,23,12,3,0.321,0.789,41,19,4,6
80,21400081,Cleveland Cavaliers,Denver Nuggets,110,101,211,9,Cleveland Cavaliers,9,0.261,0.727,42,25,5,3,0.379,0.667,42,22,5,5
81,21400082,Portland Trail Blazers,Los Angeles Clippers,102,106,208,4,Los Angeles Clippers,4,0.4,0.8,43,25,2,3,0.417,0.7,37,17,8,4
82,21400083,Washington Wizards,Indiana Pacers,97,90,187,7,Washington Wizards,7,0.182,0.739,49,23,8,4,0.333,0.64,38,11,5,3
83,21400084,New York Knicks,Atlanta Hawks,96,103,199,7,Atlanta Hawks,7,0.381,0.727,44,26,2,6,0.409,0.778,41,18,10,5
84,21400085,Minnesota Timberwolves,Miami Heat,92,102,194,10,Miami Heat,10,0.25,0.783,49,13,9,2,0.385,0.882,40,26,8,2
85,21400086,Boston Celtics,Chicago Bulls,106,101,207,5,Boston Celtics,5,0.368,0.75,45,25,6,3,0.444,0.6,38,26,5,2
86,21400087,Golden State Warriors,Houston Rockets,98,87,185,11,Golden State Warriors,11,0.321,0.647,54,22,11,8,0.238,0.81,46,13,14,0
87,21400088,Memphis Grizzlies,Milwaukee Bucks,92,93,185,1,Milwaukee Bucks,1,0.214,0.912,40,15,9,2,0.278,0.727,43,24,7,4
88,21400089,New Orleans Pelicans,San Antonio Spurs,100,99,199,1,New Orleans Pelicans,1,0.381,0.857,30,22,11,9,0.278,0.759,49,15,4,7
89,21400090,Orlando Magic,Brooklyn Nets,96,104,200,8,Brooklyn Nets,8,0.533,0.625,31,25,7,2,0.286,0.87,45,23,10,5
90,21400091,Utah Jazz,Detroit Pistons,97,96,193,1,Utah Jazz,1,0.4,0.714,43,20,7,2,0.261,0.72,51,19,6,2
91,21400092,Sacramento Kings,Oklahoma City Thunder,93,101,194,8,Oklahoma City Thunder,8,0.25,0.682,37,23,11,2,0.333,0.852,40,16,5,6
92,21400093,Philadelphia 76ers,Toronto Raptors,88,120,208,32,Toronto Raptors,32,0.294,0.667,31,19,11,6,0.412,0.9,39,23,12,8
93,21400094,Miami Heat,Dallas Mavericks,105,96,201,9,Miami Heat,9,0.391,0.6,38,31,7,3,0.31,0.708,41,22,8,7
94,21400095,Golden State Warriors,Phoenix Suns,95,107,202,12,Phoenix Suns,12,0.458,0.857,36,16,9,7,0.4,0.818,39,17,9,2
95,21400096,Denver Nuggets,Portland Trail Blazers,100,116,216,16,Portland Trail Blazers,16,0.385,0.767,55,14,5,7,0.516,0.714,51,27,7,11
96,21400097,Charlotte Hornets,Los Angeles Lakers,92,107,199,15,Los Angeles Lakers,15,0.214,0.704,39,15,5,0,0.353,0.773,38,28,8,2
97,21400098,New Orleans Pelicans,Cleveland Cavaliers,111,118,229,7,Cleveland Cavaliers,7,0.444,0.85,40,31,8,5,0.481,0.833,45,26,3,5
98,21400099,Utah Jazz,Indiana Pacers,86,97,183,11,Indiana Pacers,11,0.286,0.762,37,18,5,6,0.4,0.867,44,16,3,3
99,21400100,Atlanta Hawks,New York Knicks,91,85,176,6,Atlanta Hawks,6,0.37,0.964,38,20,7,3,0.231,0.583,40,23,4,2
100,21400101,Detroit Pistons,Chicago Bulls,91,102,193,11,Chicago Bulls,11,0.5,0.64,46,19,5,6,0.35,0.85,49,22,6,8
101,21400102,San Antonio Spurs,Los Angeles Clippers,89,85,174,4,San Antonio Spurs,4,0.105,0.778,39,20,11,4,0.227,0.824,44,26,6,8
102,21400103,Orlando Magic,Toronto Raptors,100,104,204,4,Toronto Raptors,4,0.48,0.625,39,26,8,5,0.429,0.833,40,16,9,1
103,21400104,Los Angeles Lakers,Memphis Grizzlies,102,107,209,5,Memphis Grizzlies,5,0.318,0.765,38,22,8,6,0.364,0.808,38,21,8,2
104,21400105,Oklahoma City Thunder,Milwaukee Bucks,78,85,163,7,Milwaukee Bucks,7,0.3,0.737,46,15,6,5,0.2,0.667,51,18,5,6
105,21400106,Sacramento Kings,Dallas Mavericks,98,106,204,8,Dallas Mavericks,8,0.474,0.781,43,17,5,1,0.37,0.833,33,23,8,8
106,21400107,Charlotte Hornets,Portland Trail Blazers,100,102,202,2,Portland Trail Blazers,2,0.438,0.852,38,16,5,3,0.32,0.875,48,25,6,4
107,21400108,San Antonio Spurs,Golden State Warriors,113,100,213,13,San Antonio Spurs,13,0.4,0.733,36,28,9,1,0.35,0.85,38,23,5,4
108,21400109,Detroit Pistons,Washington Wizards,103,107,210,4,Washington Wizards,4,0.409,0.818,39,19,5,6,0.273,0.727,46,27,10,6
109,21400110,Utah Jazz,Atlanta Hawks,97,100,197,3,Atlanta Hawks,3,0.217,0.5,30,28,12,8,0.45,0.722,46,23,8,4
110,21400111,Oklahoma City Thunder,Boston Celtics,109,94,203,15,Oklahoma City Thunder,15,0.417,0.864,41,23,1,3,0.273,0.846,35,28,5,3
111,21400112,Indiana Pacers,Miami Heat,81,75,156,6,Indiana Pacers,6,0.308,0.867,53,13,5,5,0.45,0.444,28,18,11,5
112,21400113,Orlando Magic,New York Knicks,97,95,192,2,Orlando Magic,2,0.5,0.781,37,20,4,1,0.348,0.929,40,17,2,6
113,21400114,Los Angeles Lakers,New Orleans Pelicans,102,109,211,7,New Orleans Pelicans,7,0.333,0.781,38,15,8,5,0.421,0.611,44,27,3,12
114,21400115,Portland Trail Blazers,Denver Nuggets,130,113,243,17,Portland Trail Blazers,17,0.485,0.828,46,30,7,9,0.348,0.818,47,21,10,2
115,21400116,Brooklyn Nets,Phoenix Suns,104,112,216,8,Phoenix Suns,8,0.429,0.781,37,17,9,4,0.333,0.897,44,20,10,2
116,21400117,Houston Rockets,Minnesota Timberwolves,113,101,214,12,Houston Rockets,12,0.464,0.737,40,25,7,7,0.5,0.767,41,22,6,6
117,21400118,Sacramento Kings,Memphis Grizzlies,110,111,221,1,Memphis Grizzlies,1,0.538,0.853,44,12,6,5,0.667,0.794,30,24,9,4
118,21400119,Chicago Bulls,Toronto Raptors,100,93,193,7,Chicago Bulls,7,0.267,0.688,48,26,7,7,0.32,0.714,38,17,11,7
119,21400120,Philadelphia 76ers,Dallas Mavericks,70,123,193,53,Dallas Mavericks,53,0.259,0.515,46,9,7,4,0.344,0.833,51,33,14,5
120,21400121,Brooklyn Nets,Golden State Warriors,99,107,206,8,Golden State Warriors,8,0.188,0.9,41,19,5,2,0.324,0.667,45,30,7,10
121,21400122,Denver Nuggets,Indiana Pacers,108,87,195,21,Denver Nuggets,21,0.348,0.56,46,20,8,5,0.364,0.5,42,17,2,7
122,21400123,Milwaukee Bucks,Orlando Magic,85,101,186,16,Orlando Magic,16,0.105,0.786,38,19,8,4,0.417,0.778,45,22,7,3
123,21400124,Miami Heat,Atlanta Hawks,103,114,217,11,Atlanta Hawks,11,0.476,0.92,32,27,10,3,0.393,0.826,36,33,10,5
124,21400125,Cleveland Cavaliers,Boston Celtics,122,121,243,1,Cleveland Cavaliers,1,0.348,0.757,40,22,5,5,0.3,0.826,39,32,7,1
125,21400126,Utah Jazz,New York Knicks,102,100,202,2,Utah Jazz,2,0.455,0.8,39,25,6,8,0.625,0.85,31,15,12,1
126,21400127,Philadelphia 76ers,Houston Rockets,87,88,175,1,Houston Rockets,1,0.333,0.667,46,19,10,5,0.206,0.622,47,16,17,11
127,21400128,Minnesota Timberwolves,New Orleans Pelicans,91,139,230,48,New Orleans Pelicans,48,0.214,0.732,37,13,5,3,0.75,0.75,34,31,13,3
128,21400129,Detroit Pistons,Oklahoma City Thunder,96,89,185,7,Detroit Pistons,7,0.355,0.6,55,18,8,5,0.333,0.167,42,23,9,7
129,21400130,Charlotte Hornets,Phoenix Suns,103,95,198,8,Charlotte Hornets,8,0.438,0.947,46,21,5,3,0.276,0.929,45,16,3,6
130,21400131,San Antonio Spurs,Los Angeles Lakers,93,80,173,13,San Antonio Spurs,13,0.435,0.85,44,28,9,2,0.167,0.71,46,17,6,5
131,21400132,Orlando Magic,Washington Wizards,93,98,191,5,Washington Wizards,5,0.412,0.667,40,14,5,2,0.3,0.688,40,31,5,8
132,21400133,Atlanta Hawks,Cleveland Cavaliers,94,127,221,33,Cleveland Cavaliers,33,0.136,0.846,37,26,6,8,0.613,0.769,47,39,12,2
133,21400134,Utah Jazz,Toronto Raptors,93,111,204,18,Toronto Raptors,18,0.313,0.733,38,22,5,3,0.381,0.739,42,15,6,5
134,21400135,Indiana Pacers,Chicago Bulls,99,90,189,9,Indiana Pacers,9,0.389,0.72,46,18,5,6,0.235,0.696,34,18,6,7
135,21400136,Detroit Pistons,Memphis Grizzlies,88,95,183,7,Memphis Grizzlies,7,0.385,0.588,43,15,4,6,0.267,0.818,53,18,5,4
136,21400137,Minnesota Timberwolves,Dallas Mavericks,117,131,248,14,Dallas Mavericks,14,0.412,0.828,41,24,2,2,0.308,0.826,40,31,5,10
137,21400138,Brooklyn Nets,Portland Trail Blazers,87,97,184,10,Portland Trail Blazers,10,0.053,0.941,43,15,7,2,0.423,0.741,47,26,6,3
138,21400139,San Antonio Spurs,Sacramento Kings,91,94,185,3,Sacramento Kings,3,0.292,0.889,38,24,6,8,0,0.833,42,19,5,6
139,21400140,Charlotte Hornets,Golden State Warriors,87,112,199,25,Golden State Warriors,25,0.412,0.571,41,14,5,2,0.423,0.786,51,30,7,3
140,21400141,Phoenix Suns,Los Angeles Clippers,107,120,227,13,Los Angeles Clippers,13,0.367,0.87,43,26,9,3,0.483,0.791,47,24,5,12
141,21400142,Denver Nuggets,New York Knicks,93,109,202,16,New York Knicks,16,0.382,0.615,39,20,9,0,0.429,0.778,43,16,9,3
142,21400143,Milwaukee Bucks,Miami Heat,91,84,175,7,Milwaukee Bucks,7,0.278,0.615,40,16,11,1,0.44,0.591,40,19,10,6
143,21400144,Houston Rockets,Oklahoma City Thunder,69,65,134,4,Houston Rockets,4,0.2,0.533,54,11,5,6,0.158,0.786,45,14,6,15
144,21400145,Golden State Warriors,Los Angeles Lakers,136,115,251,21,Golden State Warriors,21,0.5,0.882,51,32,4,5,0.188,0.791,48,17,9,4
145,21400146,Dallas Mavericks,Charlotte Hornets,107,80,187,27,Dallas Mavericks,27,0.357,0.688,50,32,7,4,0.455,0.462,35,22,1,3
146,21400147,Denver Nuggets,Cleveland Cavaliers,106,97,203,9,Denver Nuggets,9,0.387,0.8,39,25,10,4,0.345,0.826,42,18,7,8
147,21400148,Phoenix Suns,Boston Celtics,118,114,232,4,Phoenix Suns,4,0.429,0.813,40,30,11,2,0.4,0.645,44,28,10,4
148,21400149,Miami Heat,Brooklyn Nets,95,83,178,12,Miami Heat,12,0.333,0.889,41,19,6,2,0.391,0.615,35,18,10,5
149,21400150,Orlando Magic,Detroit Pistons,107,93,200,14,Orlando Magic,14,0.5,0.8,39,33,9,2,0.458,0.75,41,17,5,4
150,21400151,Houston Rockets,Memphis Grizzlies,93,119,212,26,Memphis Grizzlies,26,0.235,0.81,35,24,6,4,0.412,0.909,38,27,14,5
151,21400152,Philadelphia 76ers,San Antonio Spurs,75,100,175,25,San Antonio Spurs,25,0.154,0.708,39,15,11,4,0.385,0.857,52,27,9,8
152,21400153,New Orleans Pelicans,Portland Trail Blazers,93,102,195,9,Portland Trail Blazers,9,0.263,0.632,41,16,11,4,0.368,0.826,43,20,7,1
153,21400154,Chicago Bulls,Los Angeles Clippers,105,89,194,16,Chicago Bulls,16,0.385,0.68,45,28,7,2,0.304,0.455,40,20,2,5
154,21400155,Los Angeles Lakers,Atlanta Hawks,114,109,223,5,Los Angeles Lakers,5,0.353,0.636,44,24,7,0,0.333,0.783,38,22,7,3
155,21400156,New York Knicks,Milwaukee Bucks,113,117,230,4,Milwaukee Bucks,4,0.44,0.737,28,30,9,3,0.529,0.815,44,30,5,0
156,21400157,Oklahoma City Thunder,Utah Jazz,81,98,179,17,Utah Jazz,17,0.348,0.684,44,17,8,6,0.417,0.692,55,22,8,4
157,21400158,New Orleans Pelicans,Sacramento Kings,106,100,206,6,New Orleans Pelicans,6,0.375,0.792,32,21,6,6,0.364,0.69,52,23,3,2
158,21400159,San Antonio Spurs,Cleveland Cavaliers,92,90,182,2,San Antonio Spurs,2,0.313,0.68,42,26,11,4,0.389,0.692,38,23,7,5
159,21400160,Charlotte Hornets,Indiana Pacers,86,88,174,2,Indiana Pacers,2,0.357,0.583,41,18,6,6,0.133,0.667,51,15,3,3
160,21400161,Los Angeles Clippers,Orlando Magic,114,90,204,24,Los Angeles Clippers,24,0.571,0.75,39,24,8,9,0.333,0.778,48,21,5,1
161,21400162,Boston Celtics,Philadelphia 76ers,101,90,191,11,Boston Celtics,11,0.3,0.619,44,32,11,4,0.333,0.714,44,22,10,2
162,21400163,Dallas Mavericks,Washington Wizards,105,102,207,3,Dallas Mavericks,3,0.429,0.862,44,18,5,5,0.455,0.857,42,25,8,3
163,21400164,Milwaukee Bucks,Brooklyn Nets,122,118,240,4,Milwaukee Bucks,4,0.208,0.75,51,23,12,4,0.29,0.724,49,26,7,6
164,21400165,Phoenix Suns,Detroit Pistons,88,86,174,2,Phoenix Suns,2,0.267,0.769,41,21,10,4,0.28,0.684,43,21,9,1
165,21400166,Memphis Grizzlies,Toronto Raptors,92,96,188,4,Toronto Raptors,4,0.3,0.731,50,16,8,4,0.346,0.846,35,24,9,6
166,21400167,New York Knicks,Minnesota Timberwolves,99,115,214,16,Minnesota Timberwolves,16,0.563,0.786,33,19,6,3,0.5,0.727,35,26,15,2
167,21400168,Oklahoma City Thunder,Denver Nuggets,100,107,207,7,Denver Nuggets,7,0.435,0.72,39,21,5,0,0.345,0.773,42,25,6,5
168,21400169,Los Angeles Lakers,Houston Rockets,98,92,190,6,Los Angeles Lakers,6,0.25,0.826,47,17,8,3,0.395,0.739,38,20,8,6
169,21400170,Los Angeles Clippers,Miami Heat,110,93,203,17,Los Angeles Clippers,17,0.419,0.647,35,31,6,0,0.231,0.871,30,11,10,3
170,21400171,Chicago Bulls,Sacramento Kings,88,103,191,15,Sacramento Kings,15,0.263,0.688,42,23,6,4,0.667,0.852,40,26,5,4
171,21400172,Orlando Magic,Charlotte Hornets,105,100,205,5,Orlando Magic,5,0.25,0.719,43,12,2,5,0.35,0.6,45,22,4,7
172,21400173,Phoenix Suns,Philadelphia 76ers,122,96,218,26,Phoenix Suns,26,0.419,0.913,46,24,11,0,0.174,0.606,39,18,10,1
173,21400174,Detroit Pistons,Atlanta Hawks,89,99,188,10,Atlanta Hawks,10,0.19,0.958,45,12,6,3,0.208,0.692,46,20,7,5
174,21400175,Milwaukee Bucks,Toronto Raptors,82,124,206,42,Toronto Raptors,42,0.3,0.688,30,19,11,1,0.6,0.792,57,27,8,4
175,21400176,Boston Celtics,Memphis Grizzlies,100,117,217,17,Memphis Grizzlies,17,0.333,0.714,38,22,7,7,0.5,0.929,50,31,4,4
176,21400177,San Antonio Spurs,Minnesota Timberwolves,121,92,213,29,San Antonio Spurs,29,0.619,0.889,53,26,6,11,0.308,0.636,34,16,12,3
177,21400178,Brooklyn Nets,Oklahoma City Thunder,94,92,186,2,Brooklyn Nets,2,0.333,0.9,38,17,2,6,0.2,0.632,36,18,9,9
178,21400179,Cleveland Cavaliers,Washington Wizards,78,91,169,13,Washington Wizards,13,0.222,0.783,41,13,12,4,0.4,0.556,45,24,10,5
179,21400180,Los Angeles Lakers,Dallas Mavericks,106,140,246,34,Dallas Mavericks,34,0.385,0.619,33,24,3,4,0.514,0.714,39,37,4,2
180,21400181,New Orleans Pelicans,Denver Nuggets,97,117,214,20,Denver Nuggets,20,0.313,0.882,40,19,7,3,0.458,0.8,41,24,8,10
181,21400182,Utah Jazz,Golden State Warriors,88,101,189,13,Golden State Warriors,13,0.353,0.632,45,26,12,5,0.261,0.684,40,28,10,5
182,21400183,Chicago Bulls,Portland Trail Blazers,87,105,192,18,Portland Trail Blazers,18,0.364,0.679,48,14,9,2,0.563,0.818,46,26,8,5
183,21400184,Phoenix Suns,Indiana Pacers,106,83,189,23,Phoenix Suns,23,0.387,0.9,51,17,10,4,0.304,0.7,47,18,9,5
184,21400185,Miami Heat,Orlando Magic,99,92,191,7,Miami Heat,7,0.462,0.722,33,17,7,5,0.188,0.704,44,18,10,2
185,21400186,Toronto Raptors,Cleveland Cavaliers,110,93,203,17,Toronto Raptors,17,0.333,0.905,34,20,8,6,0.188,0.69,46,24,4,6
186,21400187,Philadelphia 76ers,New York Knicks,83,91,174,8,New York Knicks,8,0.308,0.6,36,13,8,1,0.353,0.905,40,15,7,2
187,21400188,Dallas Mavericks,Houston Rockets,92,95,187,3,Houston Rockets,3,0.171,0.727,50,17,6,5,0.326,0.87,47,17,8,0
188,21400189,Sacramento Kings,Minnesota Timberwolves,113,101,214,12,Sacramento Kings,12,0.308,0.833,50,24,4,2,0.353,0.778,37,23,10,7
189,21400190,Washington Wizards,Milwaukee Bucks,111,100,211,11,Washington Wizards,11,0.444,0.773,53,27,7,6,0.333,0.885,36,21,11,7
190,21400191,Brooklyn Nets,San Antonio Spurs,87,99,186,12,San Antonio Spurs,12,0.333,1,44,24,5,5,0.381,0.818,48,29,7,9
191,21400192,New Orleans Pelicans,Utah Jazz,106,94,200,12,New Orleans Pelicans,12,0.235,0.818,44,19,11,7,0.357,0.793,42,15,6,8
192,21400193,Los Angeles Clippers,Memphis Grizzlies,91,107,198,16,Memphis Grizzlies,16,0.28,0.714,32,14,10,1,0.333,0.696,52,20,3,3
193,21400194,Portland Trail Blazers,Boston Celtics,94,88,182,6,Portland Trail Blazers,6,0.368,0.867,55,20,7,3,0.217,0.75,46,17,12,1
194,21400195,Charlotte Hornets,Miami Heat,93,94,187,1,Miami Heat,1,0.333,0.75,33,18,9,1,0.478,0.895,36,19,4,5
195,21400196,Golden State Warriors,Oklahoma City Thunder,91,86,177,5,Golden State Warriors,5,0.28,0.75,52,26,7,8,0.176,0.704,57,13,3,12
196,21400197,Denver Nuggets,Los Angeles Lakers,101,94,195,7,Denver Nuggets,7,0.27,0.605,57,20,7,2,0.125,0.735,50,15,10,6
197,21400198,Los Angeles Clippers,Charlotte Hornets,113,92,205,21,Los Angeles Clippers,21,0.469,0.8,43,28,2,2,0.1,0.8,33,21,6,4
198,21400199,Orlando Magic,Cleveland Cavaliers,74,106,180,32,Cleveland Cavaliers,32,0.294,0.733,40,14,5,3,0.375,0.727,44,30,14,9
199,21400200,Portland Trail Blazers,Philadelphia 76ers,114,104,218,10,Portland Trail Blazers,10,0.259,0.826,52,30,6,5,0,0.833,29,28,11,6
200,21400201,Phoenix Suns,Toronto Raptors,100,104,204,4,Toronto Raptors,4,0.424,0.727,42,22,6,3,0.235,0.813,37,21,9,3
201,21400202,New York Knicks,Houston Rockets,86,91,177,5,Houston Rockets,5,0.273,0.667,40,25,8,5,0.389,0.684,38,19,13,4
202,21400203,Indiana Pacers,Dallas Mavericks,111,100,211,11,Indiana Pacers,11,0.5,0.667,44,20,6,4,0.333,0.571,37,21,6,6
203,21400204,Chicago Bulls,Utah Jazz,97,95,192,2,Chicago Bulls,2,0.45,0.696,35,20,9,3,0.333,0.8,41,22,9,6
204,21400205,Atlanta Hawks,Washington Wizards,106,102,208,4,Atlanta Hawks,4,0.28,0.794,43,17,16,6,0.45,0.724,47,25,2,3
205,21400206,Golden State Warriors,Miami Heat,114,97,211,17,Golden State Warriors,17,0.464,0.652,45,21,6,9,0.435,0.778,40,16,7,4
206,21400207,Detroit Pistons,Milwaukee Bucks,86,98,184,12,Milwaukee Bucks,12,0.35,0.412,36,23,7,5,0.455,0.769,50,22,9,2
207,21400208,Sacramento Kings,New Orleans Pelicans,99,89,188,10,Sacramento Kings,10,0.357,0.833,38,16,9,4,0.176,0.69,40,15,3,6
208,21400209,Chicago Bulls,Denver Nuggets,109,114,223,5,Denver Nuggets,5,0.333,0.865,37,20,9,4,0.5,0.741,45,22,5,7
209,21400210,Portland Trail Blazers,Charlotte Hornets,105,97,202,8,Portland Trail Blazers,8,0.444,0.75,50,21,4,7,0.333,0.667,47,29,3,5
210,21400211,Washington Wizards,Cleveland Cavaliers,87,113,200,26,Cleveland Cavaliers,26,0.385,0.727,26,24,5,5,0.3,0.816,32,23,13,2
211,21400212,Golden State Warriors,Orlando Magic,111,96,207,15,Golden State Warriors,15,0.462,0.579,47,30,7,6,0.3,0.75,46,21,8,1
212,21400213,Brooklyn Nets,Philadelphia 76ers,99,91,190,8,Brooklyn Nets,8,0.333,0.75,40,25,10,7,0.375,0.824,42,23,11,5
213,21400214,New York Knicks,Dallas Mavericks,102,109,211,7,Dallas Mavericks,7,0.5,0.625,53,21,7,3,0.129,0.763,56,20,12,5
214,21400215,Toronto Raptors,Atlanta Hawks,126,115,241,11,Toronto Raptors,11,0.483,0.848,36,24,7,7,0.417,0.875,32,31,2,4
215,21400216,Los Angeles Clippers,Detroit Pistons,104,98,202,6,Los Angeles Clippers,6,0.429,0.947,39,21,9,3,0.37,0.75,38,18,8,4
216,21400217,Sacramento Kings,Houston Rockets,89,102,191,13,Houston Rockets,13,0.313,0.786,48,16,2,8,0.343,0.4,41,26,13,5
217,21400218,Milwaukee Bucks,Minnesota Timberwolves,103,86,189,17,Milwaukee Bucks,17,0.313,0.947,43,22,12,7,0.214,0.618,38,19,11,6
218,21400219,Utah Jazz,Oklahoma City Thunder,82,97,179,15,Oklahoma City Thunder,15,0.188,0.607,38,11,9,2,0.462,0.5,45,21,9,7
219,21400220,Indiana Pacers,San Antonio Spurs,100,106,206,6,San Antonio Spurs,6,0.476,0.556,36,23,9,1,0.333,0.655,45,21,8,5
220,21400221,Denver Nuggets,Phoenix Suns,112,120,232,8,Phoenix Suns,8,0.32,0.765,47,19,10,4,0.52,0.81,41,27,9,8
221,21400222,Memphis Grizzlies,Los Angeles Lakers,99,93,192,6,Memphis Grizzlies,6,0.227,0.88,45,25,7,6,0.421,0.792,42,16,6,9
222,21400223,Chicago Bulls,Boston Celtics,109,102,211,7,Chicago Bulls,7,0.294,0.811,52,18,5,13,0.273,0.759,42,20,7,2
223,21400224,Golden State Warriors,Charlotte Hornets,106,101,207,5,Golden State Warriors,5,0.269,0.938,46,28,7,8,0.316,0.826,44,27,4,8
224,21400225,New Orleans Pelicans,Atlanta Hawks,91,100,191,9,Atlanta Hawks,9,0.292,0.75,42,23,8,4,0.294,0.864,42,26,6,7
225,21400226,Milwaukee Bucks,Detroit Pistons,104,88,192,16,Milwaukee Bucks,16,0.448,0.813,44,30,9,6,0.261,0.56,39,25,8,5
226,21400227,Dallas Mavericks,Toronto Raptors,106,102,208,4,Dallas Mavericks,4,0.423,0.682,37,27,7,9,0.424,0.75,55,17,7,1
227,21400228,Los Angeles Clippers,Houston Rockets,102,85,187,17,Los Angeles Clippers,17,0.36,0.773,45,23,8,4,0.27,0.733,40,17,7,6
228,21400229,New York Knicks,Oklahoma City Thunder,78,105,183,27,Oklahoma City Thunder,27,0.105,0.75,33,17,3,6,0.417,0.826,57,20,9,0
229,21400230,Orlando Magic,Indiana Pacers,83,98,181,15,Indiana Pacers,15,0.389,0.875,32,16,7,5,0.25,0.857,53,25,7,3
230,21400231,Sacramento Kings,San Antonio Spurs,104,112,216,8,San Antonio Spurs,8,0.6,0.846,46,22,4,4,0.5,0.8,33,29,8,9
231,21400232,Phoenix Suns,Denver Nuggets,97,122,219,25,Denver Nuggets,25,0.348,0.793,34,14,4,5,0.381,0.889,58,20,10,3
232,21400233,Memphis Grizzlies,Portland Trail Blazers,112,99,211,13,Memphis Grizzlies,13,0.462,0.615,46,28,7,4,0.286,0.722,45,22,6,6
233,21400234,Minnesota Timberwolves,Los Angeles Lakers,120,119,239,1,Minnesota Timberwolves,1,0.556,0.833,31,37,8,1,0.381,0.682,35,27,12,1
234,21400235,Dallas Mavericks,Philadelphia 76ers,110,103,213,7,Dallas Mavericks,7,0.267,0.733,40,28,13,5,0.286,0.806,55,26,10,4
235,21400236,New Orleans Pelicans,Washington Wizards,80,83,163,3,Washington Wizards,3,0.353,0.667,42,12,8,1,0.417,0.667,46,21,9,9
236,21400237,Charlotte Hornets,Atlanta Hawks,75,105,180,30,Atlanta Hawks,30,0.217,0.75,38,20,3,4,0.522,0.813,44,31,8,5
237,21400238,Indiana Pacers,Cleveland Cavaliers,97,109,206,12,Cleveland Cavaliers,12,0.318,0.769,48,26,2,1,0.438,0.625,44,20,4,6
238,21400239,Los Angeles Clippers,Utah Jazz,112,96,208,16,Los Angeles Clippers,16,0.393,0.733,37,21,6,5,0.333,0.636,37,19,6,2
239,21400240,Houston Rockets,Milwaukee Bucks,117,103,220,14,Houston Rockets,14,0.395,0.875,44,26,7,5,0.316,0.886,32,23,7,5
240,21400241,San Antonio Spurs,Boston Celtics,111,89,200,22,San Antonio Spurs,22,0.423,0.9,45,25,9,5,0.333,0.733,42,21,5,5
241,21400242,Chicago Bulls,Brooklyn Nets,102,84,186,18,Chicago Bulls,18,0.292,0.794,50,19,6,5,0.143,0.75,34,16,9,0
242,21400243,Golden State Warriors,Detroit Pistons,104,93,197,11,Golden State Warriors,11,0.429,0.778,49,24,5,8,0.478,0.667,44,25,11,5
243,21400244,Memphis Grizzlies,Sacramento Kings,97,85,182,12,Memphis Grizzlies,12,0.231,0.643,35,25,13,4,0.091,0.667,42,16,7,4
244,21400245,Miami Heat,New York Knicks,86,79,165,7,Miami Heat,7,0.304,0.613,41,20,8,1,0.125,0.7,50,14,6,3
245,21400246,Orlando Magic,Phoenix Suns,93,90,183,3,Orlando Magic,3,0.333,0.72,47,14,8,3,0.269,0.833,43,22,5,3
246,21400247,Minnesota Timberwolves,Portland Trail Blazers,93,107,200,14,Portland Trail Blazers,14,0.222,0.65,43,24,12,4,0.364,0.68,54,27,8,9
247,21400248,Toronto Raptors,Los Angeles Lakers,122,129,251,7,Los Angeles Lakers,7,0.265,0.742,53,25,6,6,0.417,0.735,54,24,4,7
248,21400249,San Antonio Spurs,Philadelphia 76ers,109,103,212,6,San Antonio Spurs,6,0.346,0.8,52,25,6,3,0.414,0.6,42,22,9,3
249,21400250,Miami Heat,Washington Wizards,86,107,193,21,Washington Wizards,21,0.091,0.6,33,12,5,2,0.526,0.792,42,29,7,3
250,21400251,Denver Nuggets,Utah Jazz,103,101,204,2,Denver Nuggets,2,0.346,0.706,39,23,7,6,0.389,0.733,48,18,3,6
251,21400252,Minnesota Timberwolves,Los Angeles Clippers,101,127,228,26,Los Angeles Clippers,26,0.167,0.725,32,26,9,3,0.441,0.833,50,33,5,7
252,21400253,Milwaukee Bucks,Cleveland Cavaliers,108,111,219,3,Cleveland Cavaliers,3,0.35,0.846,40,31,11,3,0.286,0.711,40,22,5,5
253,21400254,Boston Celtics,Atlanta Hawks,105,109,214,4,Atlanta Hawks,4,0.522,0.846,42,33,10,3,0.458,0.857,31,36,8,8
254,21400255,Los Angeles Lakers,Detroit Pistons,106,96,202,10,Los Angeles Lakers,10,0.588,0.75,47,25,9,6,0.286,0.774,49,20,6,5
255,21400256,Brooklyn Nets,New York Knicks,98,93,191,5,Brooklyn Nets,5,0.353,0.7,49,22,7,5,0.393,0.857,40,22,8,3
256,21400257,Dallas Mavericks,Chicago Bulls,132,129,261,3,Dallas Mavericks,3,0.5,0.852,46,30,9,6,0.308,0.794,52,38,5,6
257,21400258,Oklahoma City Thunder,New Orleans Pelicans,104,112,216,8,New Orleans Pelicans,8,0.292,0.852,45,16,7,6,0.294,0.644,49,23,13,11
258,21400259,Portland Trail Blazers,Denver Nuggets,105,103,208,2,Portland Trail Blazers,2,0.227,0.824,37,26,7,5,0.35,0.737,41,21,8,2
259,21400260,Indiana Pacers,Phoenix Suns,99,116,215,17,Phoenix Suns,17,0.308,0.765,41,20,8,3,0.48,0.692,44,18,13,5
260,21400261,Toronto Raptors,Sacramento Kings,117,109,226,8,Toronto Raptors,8,0.435,0.905,35,22,8,3,0.3,0.757,34,28,5,3
261,21400262,Orlando Magic,Golden State Warriors,97,98,195,1,Golden State Warriors,1,0.353,0.929,40,19,11,3,0.296,0.778,49,25,8,5
262,21400263,Chicago Bulls,Charlotte Hornets,102,95,197,7,Chicago Bulls,7,0.429,0.762,49,27,4,1,0.133,0.913,42,17,5,3
263,21400264,Los Angeles Lakers,Washington Wizards,95,111,206,16,Washington Wizards,16,0.414,0.81,43,16,8,6,0.316,0.789,53,33,6,3
264,21400265,Detroit Pistons,Boston Celtics,102,109,211,7,Boston Celtics,7,0.296,0.69,55,20,7,7,0.433,0.815,49,28,8,6
265,21400266,San Antonio Spurs,Brooklyn Nets,93,95,188,2,Brooklyn Nets,2,0.375,0.75,58,23,5,6,0.474,0.667,54,20,2,2
266,21400267,Atlanta Hawks,Miami Heat,112,102,214,10,Atlanta Hawks,10,0.48,0.87,30,25,9,1,0.375,0.75,30,25,10,5
267,21400268,Memphis Grizzlies,Houston Rockets,96,105,201,9,Houston Rockets,9,0.154,0.593,39,26,9,7,0.357,0.65,52,22,14,8
268,21400269,Dallas Mavericks,Milwaukee Bucks,107,105,212,2,Dallas Mavericks,2,0.296,0.682,46,20,8,6,0.636,0.688,39,24,11,2
269,21400270,Philadelphia 76ers,Minnesota Timberwolves,85,77,162,8,Philadelphia 76ers,8,0.208,0.64,49,15,12,7,0.176,0.824,50,17,8,5
270,21400271,Toronto Raptors,Utah Jazz,123,104,227,19,Toronto Raptors,19,0.571,0.875,37,15,7,3,0.286,0.8,35,21,7,5
271,21400272,Orlando Magic,Los Angeles Clippers,86,114,200,28,Los Angeles Clippers,28,0.35,0.52,34,21,11,2,0.387,0.72,44,32,11,6
272,21400273,Cleveland Cavaliers,New York Knicks,90,87,177,3,Cleveland Cavaliers,3,0.278,0.808,33,19,8,1,0.308,0.833,47,26,11,3
273,21400274,Indiana Pacers,Portland Trail Blazers,82,88,170,6,Portland Trail Blazers,6,0.278,0.625,51,19,5,5,0.19,0.783,48,20,9,5
274,21400275,New Orleans Pelicans,Golden State Warriors,85,112,197,27,Golden State Warriors,27,0.2,0.615,47,23,8,4,0.455,0.471,56,31,11,8
275,21400276,New York Knicks,Charlotte Hornets,102,103,205,1,Charlotte Hornets,1,0.455,0.818,34,23,5,4,0.222,0.833,41,19,2,7
276,21400277,Oklahoma City Thunder,Philadelphia 76ers,103,91,194,12,Oklahoma City Thunder,12,0.391,0.774,40,27,7,8,0.286,0.633,44,25,13,2
277,21400278,Denver Nuggets,Washington Wizards,89,119,208,30,Washington Wizards,30,0.227,0.733,36,16,8,7,0.35,0.815,52,35,12,11
278,21400279,Los Angeles Lakers,Boston Celtics,96,113,209,17,Boston Celtics,17,0.375,0.737,38,14,2,4,0.4,0.591,54,29,6,2
279,21400280,Atlanta Hawks,Brooklyn Nets,98,75,173,23,Atlanta Hawks,23,0.382,0.625,46,22,12,4,0.167,0.632,51,16,4,2
280,21400281,Cleveland Cavaliers,Toronto Raptors,105,91,196,14,Cleveland Cavaliers,14,0.45,0.667,48,28,7,2,0.333,0.65,40,25,4,4
281,21400282,San Antonio Spurs,Memphis Grizzlies,107,101,208,6,San Antonio Spurs,6,0.56,0.813,44,25,5,8,0.417,0.846,37,19,4,7
282,21400283,Houston Rockets,Minnesota Timberwolves,114,112,226,2,Houston Rockets,2,0.375,0.839,42,19,3,3,0.3,0.704,43,23,12,5
283,21400284,Phoenix Suns,Dallas Mavericks,118,106,224,12,Phoenix Suns,12,0.5,0.882,41,27,5,3,0.211,0.733,44,13,5,1
284,21400285,Miami Heat,Milwaukee Bucks,85,109,194,24,Milwaukee Bucks,24,0.389,0.667,20,21,16,3,0.563,0.846,45,21,11,3
285,21400286,Orlando Magic,Utah Jazz,98,93,191,5,Orlando Magic,5,0.412,0.85,38,15,6,3,0.5,0.619,41,23,4,6
286,21400287,Indiana Pacers,Sacramento Kings,101,102,203,1,Sacramento Kings,1,0.231,0.793,43,18,10,5,0.2,0.7,49,16,6,2
287,21400288,Philadelphia 76ers,Detroit Pistons,108,101,209,7,Philadelphia 76ers,7,0.304,0.7,53,27,12,8,0.261,0.771,47,22,11,6
288,21400289,Golden State Warriors,Chicago Bulls,112,102,214,10,Golden State Warriors,10,0.4,0.8,40,27,14,6,0.333,0.852,50,24,6,3
289,21400290,Phoenix Suns,Houston Rockets,95,100,195,5,Houston Rockets,5,0.25,0.769,40,16,14,8,0.407,0.742,57,16,7,7
290,21400291,Minnesota Timberwolves,San Antonio Spurs,101,123,224,22,San Antonio Spurs,22,0.375,0.781,33,20,10,2,0.389,0.88,43,30,5,6
291,21400292,Orlando Magic,Sacramento Kings,105,96,201,9,Orlando Magic,9,0.346,0.857,40,26,4,5,0.267,0.786,35,22,5,2
292,21400293,New Orleans Pelicans,Los Angeles Clippers,100,120,220,20,Los Angeles Clippers,20,0.348,0.64,45,26,4,2,0.531,0.708,38,34,7,6
293,21400294,Washington Wizards,Boston Celtics,93,101,194,8,Boston Celtics,8,0.407,0.667,52,21,5,8,0.471,0.808,49,20,10,7
294,21400295,Denver Nuggets,Atlanta Hawks,84,96,180,12,Atlanta Hawks,12,0.171,0.769,52,25,9,4,0.37,0.737,43,26,9,4
295,21400296,Miami Heat,Memphis Grizzlies,87,103,190,16,Memphis Grizzlies,16,0.313,0.5,30,21,10,2,0.615,0.818,38,24,7,4
296,21400297,Oklahoma City Thunder,Detroit Pistons,96,94,190,2,Oklahoma City Thunder,2,0.286,0.706,50,20,5,7,0.304,0.679,39,25,5,1
297,21400298,Milwaukee Bucks,Dallas Mavericks,102,125,227,23,Dallas Mavericks,23,0.267,0.824,36,17,7,4,0.387,0.789,36,29,14,8
298,21400299,Portland Trail Blazers,New York Knicks,103,99,202,4,Portland Trail Blazers,4,0.357,0.724,44,21,8,2,0.263,0.857,37,20,6,4
299,21400300,New Orleans Pelicans,Los Angeles Lakers,104,87,191,17,New Orleans Pelicans,17,0.444,0.667,50,28,2,4,0.263,0.667,34,18,4,6
300,21400301,Atlanta Hawks,Indiana Pacers,108,92,200,16,Atlanta Hawks,16,0.429,0.704,47,27,11,7,0.333,0.529,42,23,6,2
301,21400302,Boston Celtics,Washington Wizards,132,133,265,1,Washington Wizards,1,0.409,0.906,46,27,17,4,0.438,0.824,49,32,10,3
302,21400303,Cleveland Cavaliers,Brooklyn Nets,110,88,198,22,Cleveland Cavaliers,22,0.36,0.682,55,25,10,5,0.211,0.632,33,25,6,2
303,21400304,Denver Nuggets,Toronto Raptors,107,112,219,5,Toronto Raptors,5,0.333,0.733,49,21,7,2,0.273,0.724,44,21,4,10
304,21400305,Golden State Warriors,Minnesota Timberwolves,102,86,188,16,Golden State Warriors,16,0.227,0.929,51,24,15,6,0.182,0.69,49,22,12,4
305,21400306,Utah Jazz,Sacramento Kings,92,101,193,9,Sacramento Kings,9,0.176,0.676,35,20,7,7,0.375,0.778,45,18,8,2
306,21400307,Phoenix Suns,Los Angeles Clippers,120,121,241,1,Los Angeles Clippers,1,0.432,0.8,43,32,9,3,0.29,0.8,45,27,7,5
307,21400308,Toronto Raptors,Cleveland Cavaliers,101,105,206,4,Cleveland Cavaliers,4,0.304,1,35,26,4,3,0.346,0.857,31,27,4,5
308,21400309,Portland Trail Blazers,Detroit Pistons,98,86,184,12,Portland Trail Blazers,12,0.429,0.875,47,25,4,7,0.227,0.813,47,23,7,2
309,21400310,Dallas Mavericks,Memphis Grizzlies,105,114,219,9,Memphis Grizzlies,9,0.45,0.786,43,19,4,7,0.5,0.862,41,20,10,1
310,21400311,New York Knicks,New Orleans Pelicans,93,104,197,11,New Orleans Pelicans,11,0.474,0.769,30,19,8,8,0.267,0.769,43,22,7,8
311,21400312,Milwaukee Bucks,Oklahoma City Thunder,101,114,215,13,Oklahoma City Thunder,13,0.19,0.829,31,19,8,2,0.19,0.824,54,23,10,6
312,21400313,Miami Heat,Phoenix Suns,103,97,200,6,Miami Heat,6,0.529,0.667,34,25,14,4,0.486,0.667,37,24,7,5
313,21400314,San Antonio Spurs,Utah Jazz,96,100,196,4,Utah Jazz,4,0.2,0.609,37,23,12,8,0.286,0.727,43,18,5,7
314,21400315,Sacramento Kings,Los Angeles Lakers,95,98,193,3,Los Angeles Lakers,3,0.467,0.649,48,20,3,3,0.2,0.68,45,27,9,6
315,21400316,Boston Celtics,Charlotte Hornets,87,96,183,9,Charlotte Hornets,9,0.217,0.6,45,26,3,1,0.214,0.793,44,18,5,3
316,21400317,Los Angeles Clippers,Indiana Pacers,103,96,199,7,Los Angeles Clippers,7,0.292,0.857,50,25,7,7,0.333,0.773,43,27,6,1
317,21400318,Washington Wizards,Orlando Magic,91,89,180,2,Washington Wizards,2,0.417,0.444,41,26,5,5,0.467,0.667,39,13,7,7
318,21400319,Philadelphia 76ers,Atlanta Hawks,79,95,174,16,Atlanta Hawks,16,0.24,0.591,39,21,10,10,0.333,0.692,52,26,15,1
319,21400320,Brooklyn Nets,Chicago Bulls,80,105,185,25,Chicago Bulls,25,0.214,0.792,44,16,9,5,0.364,0.719,57,21,6,11
320,21400321,Portland Trail Blazers,Minnesota Timberwolves,82,90,172,8,Minnesota Timberwolves,8,0.286,0.833,38,20,7,10,0.083,0.758,56,22,13,3
321,21400322,New York Knicks,San Antonio Spurs,95,109,204,14,San Antonio Spurs,14,0.4,0.882,36,22,4,1,0.526,0.833,35,22,10,4
322,21400323,New Orleans Pelicans,Dallas Mavericks,107,112,219,5,Dallas Mavericks,5,0.389,0.833,45,16,5,3,0.429,0.882,29,17,5,5
323,21400324,Houston Rockets,Golden State Warriors,93,105,198,12,Golden State Warriors,12,0.257,0.667,44,15,9,2,0.348,0.85,43,21,9,5
324,21400325,Miami Heat,Denver Nuggets,82,102,184,20,Denver Nuggets,20,0.318,0.714,42,18,1,6,0.348,0.667,50,21,7,4
325,21400326,Cleveland Cavaliers,Oklahoma City Thunder,94,103,197,9,Oklahoma City Thunder,9,0.321,0.767,48,20,5,4,0.269,0.909,46,22,9,11
326,21400327,Houston Rockets,Sacramento Kings,113,109,222,4,Houston Rockets,4,0.341,0.71,42,18,13,3,0.444,0.676,44,22,8,4
327,21400328,Portland Trail Blazers,Chicago Bulls,106,115,221,9,Chicago Bulls,9,0.5,0.727,37,20,3,5,0.333,0.786,47,18,5,3
328,21400329,Los Angeles Clippers,Washington Wizards,96,104,200,8,Washington Wizards,8,0.3,0.839,37,14,7,2,0.563,0.81,37,28,10,6
329,21400330,Orlando Magic,Atlanta Hawks,81,87,168,6,Atlanta Hawks,6,0.346,0.75,46,14,3,4,0.31,0.741,42,24,12,3
330,21400331,New York Knicks,Boston Celtics,101,95,196,6,New York Knicks,6,0.375,0.833,40,26,13,5,0.318,0.778,41,28,3,3
331,21400332,Philadelphia 76ers,Brooklyn Nets,70,88,158,18,Brooklyn Nets,18,0.393,0.75,37,18,10,4,0.25,0.647,47,25,16,5
332,21400333,Indiana Pacers,Toronto Raptors,94,106,200,12,Toronto Raptors,12,0.364,0.87,39,24,4,7,0.385,0.909,52,21,2,3
333,21400334,Charlotte Hornets,Memphis Grizzlies,107,113,220,6,Memphis Grizzlies,6,0.353,0.704,49,16,8,11,0.462,0.763,47,21,7,9
334,21400335,Oklahoma City Thunder,Minnesota Timberwolves,111,92,203,19,Oklahoma City Thunder,19,0.25,0.75,47,23,11,6,0.143,0.655,31,21,11,9
335,21400336,Cleveland Cavaliers,New Orleans Pelicans,114,119,233,5,New Orleans Pelicans,5,0.364,0.783,40,22,6,6,0.429,0.76,39,21,5,6
336,21400337,Detroit Pistons,Phoenix Suns,105,103,208,2,Detroit Pistons,2,0.267,0.778,47,17,11,3,0.323,0.789,37,16,11,5
337,21400338,Miami Heat,Utah Jazz,100,95,195,5,Miami Heat,5,0.35,0.677,35,19,6,3,0.286,0.864,44,16,4,6
338,21400339,Los Angeles Lakers,San Antonio Spurs,112,110,222,2,Los Angeles Lakers,2,0.5,0.8,49,27,11,4,0.387,0.667,47,23,10,5
339,21400340,Golden State Warriors,Dallas Mavericks,105,98,203,7,Golden State Warriors,7,0.313,0.778,45,21,7,7,0.2,0.7,53,14,11,0
340,21400341,Brooklyn Nets,Charlotte Hornets,114,87,201,27,Brooklyn Nets,27,0.696,0.7,43,29,4,4,0.364,0.63,34,16,3,4
341,21400342,Portland Trail Blazers,Indiana Pacers,95,85,180,10,Portland Trail Blazers,10,0.294,0.833,46,21,9,5,0.267,0.813,49,16,8,2
342,21400343,Atlanta Hawks,Orlando Magic,99,100,199,1,Orlando Magic,1,0.296,0.875,41,24,4,4,0.476,0.762,36,26,6,6
343,21400344,Los Angeles Clippers,Milwaukee Bucks,106,111,217,5,Milwaukee Bucks,5,0.483,0.737,35,24,8,3,0.636,0.75,39,25,3,4
344,21400345,Memphis Grizzlies,Philadelphia 76ers,120,115,235,5,Memphis Grizzlies,5,0.423,0.704,42,33,9,4,0.393,0.706,45,22,11,4
345,21400346,Denver Nuggets,Houston Rockets,96,108,204,12,Houston Rockets,12,0.25,0.654,51,24,7,7,0.294,0.588,52,20,8,7
346,21400347,Detroit Pistons,Sacramento Kings,95,90,185,5,Detroit Pistons,5,0.3,0.826,43,22,10,9,0.379,0.684,55,21,4,7
347,21400348,Golden State Warriors,New Orleans Pelicans,128,122,250,6,Golden State Warriors,6,0.458,0.829,46,22,7,9,0.296,0.8,44,22,14,6
348,21400349,Chicago Bulls,Miami Heat,93,75,168,18,Chicago Bulls,18,0.5,0.857,44,21,4,8,0.182,0.833,40,12,13,5
349,21400350,Utah Jazz,Washington Wizards,84,93,177,9,Washington Wizards,9,0.294,0.679,45,13,8,7,0.308,0.583,41,20,11,9
350,21400351,Los Angeles Lakers,Minnesota Timberwolves,100,94,194,6,Los Angeles Lakers,6,0.294,0.794,45,22,10,5,0.3,0.75,46,25,6,3
351,21400352,Phoenix Suns,Oklahoma City Thunder,88,112,200,24,Oklahoma City Thunder,24,0.226,0.722,40,21,11,3,0.222,0.882,63,20,7,5
352,21400353,Toronto Raptors,New York Knicks,95,90,185,5,Toronto Raptors,5,0.375,0.778,42,24,14,2,0.31,0.821,43,15,11,4
353,21400354,San Antonio Spurs,Denver Nuggets,99,91,190,8,San Antonio Spurs,8,0.313,0.743,43,26,9,11,0.5,0.714,45,20,10,4
354,21400355,Charlotte Hornets,Cleveland Cavaliers,88,97,185,9,Cleveland Cavaliers,9,0.313,0.5,37,22,4,5,0.375,0.706,43,28,10,5
355,21400356,Los Angeles Lakers,Indiana Pacers,91,110,201,19,Indiana Pacers,19,0.385,0.793,38,14,10,5,0.412,0.852,53,21,7,2
356,21400357,Boston Celtics,Philadelphia 76ers,105,87,192,18,Boston Celtics,18,0.24,0.657,52,26,15,5,0.143,0.81,48,19,11,9
357,21400358,Chicago Bulls,Atlanta Hawks,86,93,179,7,Atlanta Hawks,7,0.207,0.714,57,18,3,6,0.333,0.824,40,26,10,7
358,21400359,Orlando Magic,Toronto Raptors,82,95,177,13,Toronto Raptors,13,0.267,0.75,36,13,5,7,0.367,0.667,39,25,8,4
359,21400360,Milwaukee Bucks,Phoenix Suns,96,94,190,2,Milwaukee Bucks,2,0.5,0.818,33,23,10,1,0.316,0.815,42,17,12,5
360,21400361,San Antonio Spurs,Portland Trail Blazers,95,108,203,13,Portland Trail Blazers,13,0.364,0.682,42,19,5,4,0.389,0.864,46,18,8,2
361,21400362,Detroit Pistons,Los Angeles Clippers,91,113,204,22,Los Angeles Clippers,22,0.296,0.591,41,23,10,3,0.5,0.75,41,35,9,3
362,21400363,Minnesota Timberwolves,Washington Wizards,95,109,204,14,Washington Wizards,14,0.375,0.571,41,17,7,5,0.588,0.722,46,29,7,8
363,21400364,Miami Heat,Brooklyn Nets,95,91,186,4,Miami Heat,4,0.375,0.769,41,20,9,2,0.286,0.719,37,25,9,2
364,21400365,Golden State Warriors,Memphis Grizzlies,98,105,203,7,Memphis Grizzlies,7,0.29,0.917,49,18,9,11,0.357,0.842,48,24,9,4
365,21400366,Utah Jazz,New Orleans Pelicans,111,119,230,8,New Orleans Pelicans,8,0.333,0.842,37,19,6,7,0.5,0.944,32,24,9,9
366,21400367,Dallas Mavericks,New York Knicks,107,87,194,20,Dallas Mavericks,20,0.455,1,41,30,9,4,0.238,0.8,35,23,11,5
367,21400368,Oklahoma City Thunder,Sacramento Kings,104,92,196,12,Oklahoma City Thunder,12,0.3,0.667,41,18,9,9,0.278,0.882,48,21,7,3
368,21400369,Phoenix Suns,Charlotte Hornets,111,106,217,5,Phoenix Suns,5,0.36,0.762,43,22,4,7,0.417,0.727,35,22,6,3
369,21400370,Atlanta Hawks,Cleveland Cavaliers,127,98,225,29,Atlanta Hawks,29,0.571,0.813,40,36,3,5,0.267,0.762,33,24,3,0
370,21400371,Orlando Magic,Boston Celtics,92,109,201,17,Boston Celtics,17,0.263,0.867,36,17,8,1,0.368,0.778,42,25,9,8
371,21400372,Dallas Mavericks,Detroit Pistons,117,106,223,11,Dallas Mavericks,11,0.455,0.771,45,29,9,4,0.394,0.684,42,22,9,4
372,21400373,Utah Jazz,Miami Heat,105,87,192,18,Utah Jazz,18,0.56,0.875,38,23,4,5,0.235,0.725,31,10,10,0
373,21400374,Brooklyn Nets,Toronto Raptors,89,105,194,16,Toronto Raptors,16,0.333,0.455,43,20,3,8,0.5,0.684,42,24,6,4
374,21400375,Memphis Grizzlies,San Antonio Spurs,117,116,233,1,Memphis Grizzlies,1,0.37,0.786,58,29,12,6,0.486,0.481,60,31,6,11
375,21400376,Milwaukee Bucks,Portland Trail Blazers,97,104,201,7,Portland Trail Blazers,7,0.368,0.727,32,16,8,0,0.304,0.517,52,25,4,3
376,21400377,Indiana Pacers,Los Angeles Clippers,100,102,202,2,Los Angeles Clippers,2,0.211,0.696,43,27,6,4,0.333,0.622,51,20,7,4
377,21400378,Houston Rockets,Denver Nuggets,115,111,226,4,Houston Rockets,4,0.286,0.771,55,17,7,5,0.433,0.783,51,30,8,1
378,21400379,New York Knicks,Chicago Bulls,97,103,200,6,Chicago Bulls,6,0.667,0.789,41,19,7,6,0.522,0.767,32,23,9,8
379,21400380,New Orleans Pelicans,Houston Rockets,99,90,189,9,New Orleans Pelicans,9,0.278,0.818,45,21,4,8,0.24,0.783,43,19,8,4
380,21400381,Milwaukee Bucks,Sacramento Kings,108,107,215,1,Milwaukee Bucks,1,0.565,0.778,27,24,7,2,0.429,0.758,35,24,5,0
381,21400382,Oklahoma City Thunder,Golden State Warriors,109,114,223,5,Golden State Warriors,5,0.44,0.667,43,17,5,4,0.387,0.6,39,32,9,7
382,21400383,Utah Jazz,Orlando Magic,101,94,195,7,Utah Jazz,7,0.364,0.792,42,24,4,5,0.545,0.667,34,28,6,2
383,21400384,Charlotte Hornets,Philadelphia 76ers,109,91,200,18,Charlotte Hornets,18,0.417,0.765,45,25,10,3,0.462,0.882,35,23,6,12
384,21400385,Minnesota Timberwolves,Boston Celtics,98,114,212,16,Boston Celtics,16,0.5,0.5,37,23,8,5,0.348,0.714,43,29,9,6
385,21400386,Brooklyn Nets,Cleveland Cavaliers,91,95,186,4,Cleveland Cavaliers,4,0.375,0.667,37,23,8,8,0.375,0.828,44,22,7,4
386,21400387,Toronto Raptors,Detroit Pistons,110,100,210,10,Toronto Raptors,10,0.296,0.75,47,24,4,5,0.32,0.667,49,28,5,7
387,21400388,Washington Wizards,Miami Heat,105,103,208,2,Washington Wizards,2,0.214,0.727,36,24,6,3,0.474,0.737,34,22,7,3
388,21400389,Chicago Bulls,Memphis Grizzlies,103,97,200,6,Chicago Bulls,6,0.385,0.879,51,17,2,3,0.154,0.875,45,12,4,6
389,21400390,Portland Trail Blazers,San Antonio Spurs,129,119,248,10,Portland Trail Blazers,10,0.371,0.957,58,18,12,5,0.4,0.808,60,24,8,4
390,21400391,Los Angeles Clippers,Denver Nuggets,106,109,215,3,Denver Nuggets,3,0.167,0.758,39,21,14,4,0.379,0.733,40,30,6,1
391,21400392,Oklahoma City Thunder,Los Angeles Lakers,104,103,207,1,Oklahoma City Thunder,1,0.381,0.759,42,21,5,8,0.4,0.733,43,28,3,5
392,21400393,Phoenix Suns,New York Knicks,99,90,189,9,Phoenix Suns,9,0.4,0.826,43,15,10,3,0.318,0.813,45,17,11,4
393,21400394,Portland Trail Blazers,New Orleans Pelicans,114,88,202,26,Portland Trail Blazers,26,0.36,0.6,45,25,11,3,0.2,0.893,48,15,7,6
394,21400395,Utah Jazz,Charlotte Hornets,86,104,190,18,Charlotte Hornets,18,0.258,0.8,39,18,3,5,0.409,0.688,49,21,8,3
395,21400396,Atlanta Hawks,Houston Rockets,104,97,201,7,Atlanta Hawks,7,0.385,0.75,37,26,7,9,0.349,0.778,43,27,8,4
396,21400397,San Antonio Spurs,Dallas Mavericks,93,99,192,6,Dallas Mavericks,6,0.231,1,48,10,6,2,0.346,0.8,40,18,10,3
397,21400398,Indiana Pacers,Denver Nuggets,73,76,149,3,Denver Nuggets,3,0.304,0.706,50,17,5,2,0.125,0.737,49,14,7,7
398,21400399,Milwaukee Bucks,Los Angeles Clippers,102,106,208,4,Los Angeles Clippers,4,0.333,0.533,46,29,6,1,0.462,0.741,41,29,10,4
399,21400400,New York Knicks,Toronto Raptors,108,118,226,10,Toronto Raptors,10,0.357,0.885,32,27,6,5,0.424,0.741,43,24,7,4
400,21400401,Memphis Grizzlies,Cleveland Cavaliers,91,105,196,14,Cleveland Cavaliers,14,0.063,0.8,38,25,8,3,0.5,0.6,33,34,2,4
401,21400402,Los Angeles Lakers,Sacramento Kings,101,108,209,7,Sacramento Kings,7,0.385,0.833,47,14,8,2,0.304,0.694,44,15,8,7
402,21400403,Detroit Pistons,Brooklyn Nets,105,110,215,5,Brooklyn Nets,5,0.333,0.615,50,26,10,6,0.4,0.759,37,29,9,4
403,21400404,Boston Celtics,Miami Heat,84,100,184,16,Miami Heat,16,0.261,0.8,42,22,6,4,0.286,0.769,38,18,9,3
404,21400405,Philadelphia 76ers,Orlando Magic,96,88,184,8,Philadelphia 76ers,8,0.261,0.8,52,20,8,6,0.304,0.55,43,21,11,6
405,21400406,Phoenix Suns,Washington Wizards,104,92,196,12,Phoenix Suns,12,0.353,0.72,45,13,3,8,0.214,0.724,42,11,11,4
406,21400407,Indiana Pacers,Minnesota Timberwolves,100,96,196,4,Indiana Pacers,4,0.316,0.714,36,25,9,6,0.455,0.792,43,23,8,1
407,21400408,New Orleans Pelicans,Oklahoma City Thunder,101,99,200,2,New Orleans Pelicans,2,0.35,0.8,39,33,11,7,0.25,0.75,47,17,7,5
408,21400409,Denver Nuggets,Charlotte Hornets,82,110,192,28,Charlotte Hornets,28,0.111,0.75,37,11,6,4,0.421,0.667,44,23,6,6
409,21400410,Toronto Raptors,Chicago Bulls,120,129,249,9,Chicago Bulls,9,0.3,0.719,37,15,10,3,0.5,0.915,41,20,4,13
410,21400411,Portland Trail Blazers,Houston Rockets,95,110,205,15,Houston Rockets,15,0.37,0.944,35,19,9,5,0.361,0.75,42,22,14,3
411,21400412,Utah Jazz,Memphis Grizzlies,97,91,188,6,Utah Jazz,6,0.474,0.741,49,20,0,5,0.304,0.889,34,22,4,3
412,21400413,Atlanta Hawks,Dallas Mavericks,105,102,207,3,Atlanta Hawks,3,0.368,0.667,43,26,6,6,0.393,0.65,47,23,12,5
413,21400414,Los Angeles Clippers,San Antonio Spurs,118,125,243,7,San Antonio Spurs,7,0.417,0.759,36,23,10,5,0.565,0.636,33,37,6,2
414,21400415,Sacramento Kings,Golden State Warriors,108,128,236,20,Golden State Warriors,20,0.471,0.667,39,31,5,5,0.36,0.875,45,36,9,6
415,21400416,Minnesota Timberwolves,Cleveland Cavaliers,104,125,229,21,Cleveland Cavaliers,21,0.308,0.759,40,25,13,9,0.5,0.806,38,24,11,6
416,21400417,New Orleans Pelicans,Indiana Pacers,84,96,180,12,Indiana Pacers,12,0.2,0.737,46,15,4,2,0.333,0.722,38,24,9,12
417,21400418,Boston Celtics,Orlando Magic,95,100,195,5,Orlando Magic,5,0.304,0.759,45,22,10,4,0.389,0.652,45,23,7,4
418,21400419,Chicago Bulls,Washington Wizards,99,91,190,8,Chicago Bulls,8,0.294,0.667,52,20,5,7,0.556,0.625,41,21,7,5
419,21400420,Los Angeles Clippers,Atlanta Hawks,104,107,211,3,Atlanta Hawks,3,0.379,0.679,51,26,10,5,0.522,0.771,43,28,6,3
420,21400421,Denver Nuggets,Brooklyn Nets,96,102,198,6,Brooklyn Nets,6,0.28,0.773,51,15,4,4,0.261,0.714,39,21,10,3
421,21400422,Philadelphia 76ers,Miami Heat,91,87,178,4,Philadelphia 76ers,4,0.263,0.741,42,11,13,11,0.308,0.722,39,13,10,6
422,21400423,Charlotte Hornets,Milwaukee Bucks,108,101,209,7,Charlotte Hornets,7,0.381,0.778,43,21,6,5,0.381,0.75,40,25,7,6
423,21400424,Portland Trail Blazers,Oklahoma City Thunder,115,111,226,4,Portland Trail Blazers,4,0.548,0.917,46,22,6,2,0.316,0.867,53,20,8,5
424,21400425,Dallas Mavericks,Phoenix Suns,115,124,239,9,Phoenix Suns,9,0.36,0.828,49,22,4,1,0.394,0.719,44,30,12,3
425,21400426,Golden State Warriors,Los Angeles Lakers,105,115,220,10,Los Angeles Lakers,10,0.462,0.882,39,20,8,2,0.462,0.647,42,28,11,10
426,21400427,Washington Wizards,New York Knicks,102,91,193,11,Washington Wizards,11,0.438,0.7,45,25,4,3,0.182,0.789,36,17,5,4
427,21400428,Oklahoma City Thunder,San Antonio Spurs,114,106,220,8,Oklahoma City Thunder,8,0.6,0.553,47,25,9,6,0.304,0.714,38,33,8,5
428,21400429,Cleveland Cavaliers,Miami Heat,91,101,192,10,Miami Heat,10,0.231,0.636,37,16,8,4,0.333,0.824,43,27,8,3
429,21400430,Los Angeles Lakers,Chicago Bulls,93,113,206,20,Chicago Bulls,20,0.313,0.762,39,18,9,8,0.417,0.76,57,27,1,7
430,21400431,Golden State Warriors,Los Angeles Clippers,86,100,186,14,Los Angeles Clippers,14,0.214,0.545,44,24,11,4,0.281,0.742,50,18,10,4
431,21400432,Brooklyn Nets,Boston Celtics,109,107,216,2,Brooklyn Nets,2,0.333,0.714,43,19,9,3,0.375,0.727,37,32,8,3
432,21400433,Cleveland Cavaliers,Orlando Magic,98,89,187,9,Cleveland Cavaliers,9,0.267,0.923,37,19,10,5,0.429,0.667,36,25,8,4
433,21400434,Milwaukee Bucks,Atlanta Hawks,107,77,184,30,Milwaukee Bucks,30,0.421,0.826,40,28,15,6,0.174,0.786,38,20,8,4
434,21400435,Indiana Pacers,Detroit Pistons,109,119,228,10,Detroit Pistons,10,0.45,0.727,44,25,3,4,0.385,0.517,42,25,11,6
435,21400436,Houston Rockets,Memphis Grizzlies,117,111,228,6,Houston Rockets,6,0.412,0.75,54,25,2,7,0.292,0.783,44,31,8,4
436,21400437,San Antonio Spurs,New Orleans Pelicans,90,97,187,7,New Orleans Pelicans,7,0.429,0.714,39,25,2,4,0.353,0.875,44,25,8,7
437,21400438,Charlotte Hornets,Oklahoma City Thunder,75,98,173,23,Oklahoma City Thunder,23,0.208,0.769,52,12,8,2,0.296,0.857,57,18,6,10
438,21400439,Los Angeles Lakers,Dallas Mavericks,98,102,200,4,Dallas Mavericks,4,0.379,0.75,63,20,8,6,0.278,0.542,40,20,9,6
439,21400440,Minnesota Timberwolves,Denver Nuggets,102,106,208,4,Denver Nuggets,4,0.2,0.708,44,29,5,9,0.158,0.781,62,18,1,6
440,21400441,Philadelphia 76ers,Portland Trail Blazers,93,114,207,21,Portland Trail Blazers,21,0.214,0.545,42,16,13,7,0.419,0.857,48,25,10,8
441,21400442,Phoenix Suns,Sacramento Kings,115,106,221,9,Phoenix Suns,9,0.424,0.75,46,25,6,11,0.35,0.708,48,18,8,2
442,21400443,Toronto Raptors,Los Angeles Clippers,110,98,208,12,Toronto Raptors,12,0.382,0.789,43,25,7,1,0.48,0.8,43,26,4,7
443,21400444,Orlando Magic,Charlotte Hornets,102,94,196,8,Orlando Magic,8,0.4,0.75,40,22,6,4,0.333,0.778,41,18,2,8
444,21400445,Boston Celtics,Washington Wizards,88,101,189,13,Washington Wizards,13,0.25,0.75,36,17,10,2,0.385,0.6,48,28,11,4
445,21400446,Memphis Grizzlies,Miami Heat,103,95,198,8,Memphis Grizzlies,8,0.438,0.757,32,22,10,5,0.3,0.714,33,18,10,4
446,21400447,New Orleans Pelicans,Chicago Bulls,100,107,207,7,Chicago Bulls,7,0.286,0.875,37,18,9,8,0.3,0.864,45,19,8,6
447,21400448,Indiana Pacers,Brooklyn Nets,110,85,195,25,Indiana Pacers,25,0.5,0.722,45,33,11,5,0.28,0.815,35,15,2,4
448,21400449,Atlanta Hawks,Milwaukee Bucks,90,85,175,5,Atlanta Hawks,5,0.31,0.789,51,25,9,4,0.4,0.786,47,21,5,10
449,21400450,Philadelphia 76ers,Utah Jazz,71,88,159,17,Utah Jazz,17,0.192,0.643,44,11,8,5,0.174,0.857,55,17,11,10
450,21400451,New York Knicks,Sacramento Kings,129,135,264,6,Sacramento Kings,6,0.3,0.844,43,30,10,10,0.5,0.879,39,23,9,7
451,21400452,Minnesota Timberwolves,Golden State Warriors,97,110,207,13,Golden State Warriors,13,0.421,0.583,47,29,10,5,0.393,0.81,43,32,17,6
452,21400453,Detroit Pistons,Cleveland Cavaliers,103,80,183,23,Detroit Pistons,23,0.548,0.444,47,21,12,6,0.172,0.765,46,25,4,5
453,21400454,Houston Rockets,San Antonio Spurs,106,110,216,4,San Antonio Spurs,4,0.364,0.581,42,20,15,1,0.367,0.875,38,22,12,6
454,21400455,Oklahoma City Thunder,Dallas Mavericks,107,112,219,5,Dallas Mavericks,5,0.357,0.571,53,21,8,2,0.323,0.857,37,26,8,6
455,21400456,New York Knicks,Portland Trail Blazers,79,101,180,22,Portland Trail Blazers,22,0.259,0.667,49,19,6,1,0.444,0.75,48,25,8,7
456,21400457,Toronto Raptors,Denver Nuggets,116,102,218,14,Toronto Raptors,14,0.435,0.625,44,23,4,5,0.235,0.706,49,18,3,2
457,21400458,Phoenix Suns,Los Angeles Lakers,116,107,223,9,Phoenix Suns,9,0.409,0.792,45,24,12,5,0.6,0.55,35,22,8,6
458,21400459,Milwaukee Bucks,Charlotte Hornets,104,94,198,10,Milwaukee Bucks,10,0.286,0.857,42,21,8,10,0.28,0.808,48,20,13,9
459,21400460,Chicago Bulls,Indiana Pacers,92,90,182,2,Chicago Bulls,2,0.385,0.879,46,17,8,7,0.385,0.619,44,18,5,8
460,21400461,Sacramento Kings,Brooklyn Nets,99,107,206,8,Brooklyn Nets,8,0.45,0.8,44,22,5,3,0.381,0.692,40,20,12,3
461,21400462,Orlando Magic,Miami Heat,102,101,203,1,Orlando Magic,1,0.44,0.692,34,21,9,2,0.5,0.7,36,18,9,3
462,21400463,Washington Wizards,Houston Rockets,104,103,207,1,Washington Wizards,1,0.444,0.929,35,21,11,4,0.31,0.609,38,19,11,1
463,21400464,Utah Jazz,Los Angeles Clippers,97,101,198,4,Los Angeles Clippers,4,0.421,0.591,52,26,7,3,0.435,0.773,41,24,7,12
464,21400465,Detroit Pistons,Orlando Magic,109,86,195,23,Detroit Pistons,23,0.424,0.517,54,22,9,9,0.2,0.6,42,19,7,3
465,21400466,Cleveland Cavaliers,Atlanta Hawks,101,109,210,8,Atlanta Hawks,8,0.419,0.667,42,23,10,2,0.345,0.731,44,23,13,5
466,21400467,Brooklyn Nets,Chicago Bulls,96,82,178,14,Brooklyn Nets,14,0.429,0.857,46,21,9,5,0.32,0.533,48,22,5,11
467,21400468,San Antonio Spurs,Memphis Grizzlies,87,95,182,8,Memphis Grizzlies,8,0.227,0.706,37,17,9,4,0.467,0.818,39,25,10,5
468,21400469,Phoenix Suns,New Orleans Pelicans,106,110,216,4,New Orleans Pelicans,4,0.429,0.789,38,17,7,6,0.444,0.621,49,19,4,2
469,21400470,Washington Wizards,Dallas Mavericks,87,114,201,27,Dallas Mavericks,27,0.333,0.63,48,22,5,3,0.533,0.69,34,21,11,5
470,21400471,Los Angeles Lakers,Denver Nuggets,111,103,214,8,Los Angeles Lakers,8,0.56,0.654,42,31,6,4,0.308,0.63,39,25,13,7
471,21400472,Minnesota Timberwolves,Utah Jazz,94,100,194,6,Utah Jazz,6,0.471,0.714,34,26,7,4,0.368,0.773,43,16,5,3
472,21400473,Toronto Raptors,Portland Trail Blazers,97,102,199,5,Portland Trail Blazers,5,0.182,0.867,49,14,10,2,0.333,0.778,51,21,5,8
473,21400474,Philadelphia 76ers,Golden State Warriors,86,126,212,40,Golden State Warriors,40,0.3,0.609,48,16,11,2,0.429,0.815,42,38,19,11
474,21400475,Sacramento Kings,Boston Celtics,84,106,190,22,Boston Celtics,22,0.133,0.643,46,12,9,5,0.238,0.867,49,32,9,7
475,21400476,Miami Heat,Indiana Pacers,95,106,201,11,Indiana Pacers,11,0.313,0.778,36,20,5,8,0.556,0.867,39,23,4,4
476,21400477,New York Knicks,Los Angeles Clippers,78,99,177,21,Los Angeles Clippers,21,0.235,0.667,40,24,6,2,0.441,0.6,50,28,6,3
477,21400478,Charlotte Hornets,Houston Rockets,83,102,185,19,Houston Rockets,19,0.167,0.846,41,15,6,9,0.395,0.643,41,22,10,7
478,21400479,Milwaukee Bucks,Cleveland Cavaliers,96,80,176,16,Milwaukee Bucks,16,0.44,0.5,54,25,10,6,0.258,0.875,49,19,5,5
479,21400480,Phoenix Suns,Oklahoma City Thunder,134,137,271,3,Oklahoma City Thunder,3,0.481,0.829,39,17,7,3,0.314,0.898,50,22,6,4
480,21400481,New Orleans Pelicans,San Antonio Spurs,93,95,188,2,San Antonio Spurs,2,0.286,0.85,52,15,8,1,0.25,0.611,48,24,5,7
481,21400482,Denver Nuggets,Chicago Bulls,101,106,207,5,Chicago Bulls,5,0.357,0.815,57,19,4,7,0.533,0.88,46,22,7,18
482,21400483,Sacramento Kings,Minnesota Timberwolves,110,107,217,3,Sacramento Kings,3,0.417,0.862,42,23,7,7,0.292,0.727,38,22,12,6
483,21400484,Cleveland Cavaliers,Charlotte Hornets,91,87,178,4,Cleveland Cavaliers,4,0.267,0.7,46,16,8,5,0.214,0.654,50,20,5,6
484,21400485,Brooklyn Nets,Orlando Magic,100,98,198,2,Brooklyn Nets,2,0.35,0.611,45,26,7,5,0.5,0.65,37,22,13,3
485,21400486,Dallas Mavericks,Boston Celtics,119,101,220,18,Dallas Mavericks,18,0.481,0.941,52,24,8,1,0.353,0.684,38,22,6,2
486,21400487,Detroit Pistons,New York Knicks,97,81,178,16,Detroit Pistons,16,0.394,0.571,49,24,10,3,0.417,0.5,47,18,13,4
487,21400488,Houston Rockets,New Orleans Pelicans,83,111,194,28,New Orleans Pelicans,28,0.207,0.636,38,22,13,3,0.467,0.8,49,24,12,8
488,21400489,Washington Wizards,Oklahoma City Thunder,102,109,211,7,Oklahoma City Thunder,7,0.524,0.867,39,27,3,1,0.421,0.684,38,21,8,4
489,21400490,Indiana Pacers,Milwaukee Bucks,94,91,185,3,Indiana Pacers,3,0.4,0.8,45,24,7,3,0.292,0.8,43,28,10,7
490,21400491,Philadelphia 76ers,Phoenix Suns,96,112,208,16,Phoenix Suns,16,0.269,0.6,41,20,12,7,0.438,0.875,48,24,9,12
491,21400492,Atlanta Hawks,Utah Jazz,98,92,190,6,Atlanta Hawks,6,0.261,0.867,47,24,9,3,0.323,0.75,47,18,6,9
492,21400493,Toronto Raptors,Golden State Warriors,105,126,231,21,Golden State Warriors,21,0.4,0.75,37,23,7,1,0.429,0.8,45,35,8,8
493,21400494,Memphis Grizzlies,Los Angeles Lakers,109,106,215,3,Memphis Grizzlies,3,0.429,0.677,46,27,7,4,0.316,0.737,38,24,10,8
494,21400495,Charlotte Hornets,Orlando Magic,98,90,188,8,Charlotte Hornets,8,0.25,0.75,53,16,4,4,0.211,0.952,44,18,9,3
495,21400496,Boston Celtics,Chicago Bulls,104,109,213,5,Chicago Bulls,5,0.294,0.818,45,26,9,6,0.214,0.725,59,19,10,9
496,21400497,Miami Heat,Houston Rockets,79,115,194,36,Houston Rockets,36,0.235,0.6,33,20,6,3,0.419,0.714,48,21,13,1
497,21400498,Utah Jazz,Minnesota Timberwolves,101,89,190,12,Utah Jazz,12,0.55,0.667,47,23,6,10,0.316,0.833,37,17,8,5
498,21400499,Washington Wizards,San Antonio Spurs,92,101,193,9,San Antonio Spurs,9,0.286,0.615,31,23,6,6,0.25,0.611,38,27,4,5
499,21400500,Memphis Grizzlies,Denver Nuggets,85,114,199,29,Denver Nuggets,29,0.143,0.692,37,20,6,8,0.467,0.806,48,21,6,8
500,21400501,Atlanta Hawks,Portland Trail Blazers,115,107,222,8,Atlanta Hawks,8,0.353,0.742,46,17,9,5,0.394,0.833,44,24,6,7
501,21400502,Philadelphia 76ers,Los Angeles Clippers,91,127,218,36,Los Angeles Clippers,36,0.36,0.692,45,17,7,1,0.405,0.769,43,33,13,3
502,21400503,Dallas Mavericks,Cleveland Cavaliers,109,90,199,19,Dallas Mavericks,19,0.462,0.818,36,30,7,8,0.32,0.706,38,26,6,3
503,21400504,Sacramento Kings,Detroit Pistons,95,114,209,19,Detroit Pistons,19,0.2,0.778,41,18,9,4,0.387,0.75,49,21,8,3
504,21400505,Brooklyn Nets,Miami Heat,84,88,172,4,Miami Heat,4,0.292,0.692,38,18,9,6,0.357,0.75,42,21,8,9
505,21400506,Milwaukee Bucks,New York Knicks,95,82,177,13,Milwaukee Bucks,13,0.25,0.778,48,23,10,4,0.36,0.786,36,23,8,2
506,21400507,Toronto Raptors,Phoenix Suns,109,125,234,16,Phoenix Suns,16,0.346,0.828,43,22,9,4,0.348,0.75,41,26,15,2
507,21400508,Indiana Pacers,Los Angeles Lakers,87,88,175,1,Los Angeles Lakers,1,0.286,0.722,50,21,5,2,0.333,0.933,37,14,8,3
508,21400509,Cleveland Cavaliers,Philadelphia 76ers,92,95,187,3,Philadelphia 76ers,3,0.367,0.682,43,23,8,1,0.304,0.8,43,31,5,8
509,21400510,Charlotte Hornets,Boston Celtics,104,95,199,9,Charlotte Hornets,9,0.316,0.957,48,22,2,10,0.389,0.696,33,22,8,7
510,21400511,Dallas Mavericks,Brooklyn Nets,96,88,184,8,Dallas Mavericks,8,0.37,0.632,51,24,8,6,0.12,0.826,52,20,5,7
511,21400512,Houston Rockets,Chicago Bulls,105,114,219,9,Chicago Bulls,9,0.32,0.6,41,25,9,8,0.294,0.9,47,27,10,12
512,21400513,New York Knicks,Memphis Grizzlies,83,105,188,22,Memphis Grizzlies,22,0.308,0.692,37,25,9,5,0.467,0.632,45,25,14,5
513,21400514,Denver Nuggets,Minnesota Timberwolves,110,101,211,9,Denver Nuggets,9,0.368,0.688,41,26,8,6,0.417,0.833,42,21,7,4
514,21400515,Washington Wizards,New Orleans Pelicans,92,85,177,7,Washington Wizards,7,0.2,0.824,40,23,10,7,0.316,0.765,39,19,8,5
515,21400516,Indiana Pacers,Utah Jazz,105,101,206,4,Indiana Pacers,4,0.538,0.933,35,20,8,3,0.174,0.794,41,16,6,6
516,21400517,Los Angeles Lakers,Portland Trail Blazers,94,98,192,4,Portland Trail Blazers,4,0.286,0.8,49,20,5,0,0.423,0.875,45,18,7,4
517,21400518,Oklahoma City Thunder,Golden State Warriors,91,117,208,26,Golden State Warriors,26,0.179,0.765,59,19,10,5,0.536,0.625,54,27,8,4
518,21400519,Atlanta Hawks,Los Angeles Clippers,107,98,205,9,Atlanta Hawks,9,0.481,0.667,41,25,13,2,0.28,0.758,45,23,5,5
519,21400520,Phoenix Suns,Milwaukee Bucks,102,96,198,6,Phoenix Suns,6,0.28,0.778,46,19,7,6,0.15,0.864,44,22,9,5
520,21400521,Detroit Pistons,San Antonio Spurs,105,104,209,1,Detroit Pistons,1,0.158,0.714,45,19,10,3,0.429,0.676,41,24,6,6
521,21400522,New Orleans Pelicans,Charlotte Hornets,94,98,192,4,Charlotte Hornets,4,0.333,0.667,43,19,6,8,0.286,0.769,43,18,9,4
522,21400523,Houston Rockets,Cleveland Cavaliers,105,93,198,12,Houston Rockets,12,0.353,0.625,50,26,9,3,0.345,0.789,37,16,9,4
523,21400524,Milwaukee Bucks,Philadelphia 76ers,97,77,174,20,Milwaukee Bucks,20,0.471,0.636,43,32,14,4,0.08,0.862,44,14,11,6
524,21400525,New York Knicks,Washington Wizards,91,101,192,10,Washington Wizards,10,0.423,0.75,41,18,11,0,0.5,0.714,44,28,9,4
525,21400526,Memphis Grizzlies,Atlanta Hawks,86,96,182,10,Atlanta Hawks,10,0.294,1,39,20,10,4,0.52,0.826,37,21,17,4
526,21400527,Boston Celtics,Brooklyn Nets,89,81,170,8,Boston Celtics,8,0.278,0.824,41,22,8,2,0.214,0.692,50,18,3,6
527,21400528,Utah Jazz,Chicago Bulls,97,77,174,20,Utah Jazz,20,0.313,0.75,48,21,8,8,0.3,0.75,43,17,5,5
528,21400529,Detroit Pistons,Dallas Mavericks,108,95,203,13,Detroit Pistons,13,0.476,0.857,60,22,9,2,0.273,0.722,43,24,9,4
529,21400530,Orlando Magic,Denver Nuggets,90,93,183,3,Denver Nuggets,3,0.364,0.75,42,21,11,2,0.412,0.769,47,22,5,4
530,21400531,Phoenix Suns,Minnesota Timberwolves,113,111,224,2,Phoenix Suns,2,0.192,0.842,41,12,14,8,0.412,0.842,46,30,8,3
531,21400532,Oklahoma City Thunder,Sacramento Kings,83,104,187,21,Sacramento Kings,21,0.3,0.696,54,16,7,13,0.526,0.786,52,18,12,4
532,21400533,Indiana Pacers,Golden State Warriors,102,117,219,15,Golden State Warriors,15,0.231,0.957,41,24,4,2,0.429,0.75,39,30,11,3
533,21400534,Los Angeles Lakers,Los Angeles Clippers,89,114,203,25,Los Angeles Clippers,25,0.25,0.588,46,21,3,1,0.364,0.733,42,29,9,5
534,21400535,Charlotte Hornets,Toronto Raptors,103,95,198,8,Charlotte Hornets,8,0.25,0.682,46,21,5,3,0.323,0.76,42,20,2,7
535,21400536,Houston Rockets,New York Knicks,120,96,216,24,Houston Rockets,24,0.444,0.688,36,25,14,5,0.423,0.524,38,22,12,1
536,21400537,Miami Heat,Portland Trail Blazers,83,99,182,16,Portland Trail Blazers,16,0.214,0.733,42,15,6,7,0.296,0.733,50,19,5,6
537,21400538,Boston Celtics,Indiana Pacers,103,107,210,4,Indiana Pacers,4,0.294,0.688,50,25,10,7,0.391,0.882,56,21,5,9
538,21400539,Philadelphia 76ers,Brooklyn Nets,90,88,178,2,Philadelphia 76ers,2,0.471,0.588,38,22,15,4,0.188,0.704,42,21,8,3
539,21400540,Atlanta Hawks,Detroit Pistons,106,103,209,3,Atlanta Hawks,3,0.435,0.667,49,27,3,3,0.302,0.778,46,24,9,3
540,21400541,Memphis Grizzlies,New Orleans Pelicans,95,106,201,11,New Orleans Pelicans,11,0.353,0.773,44,17,7,4,0.5,0.846,47,21,3,10
541,21400542,Utah Jazz,Oklahoma City Thunder,94,99,193,5,Oklahoma City Thunder,5,0.333,0.682,44,22,12,11,0.333,0.889,38,25,12,5
542,21400543,Chicago Bulls,Washington Wizards,86,102,188,16,Washington Wizards,16,0.385,0.632,46,16,9,8,0.533,0.632,48,27,9,7
543,21400544,Minnesota Timberwolves,Milwaukee Bucks,84,98,182,14,Milwaukee Bucks,14,0.273,0.824,40,22,13,3,0.632,0.8,39,30,13,4
544,21400545,Phoenix Suns,San Antonio Spurs,95,100,195,5,San Antonio Spurs,5,0.269,0.667,48,23,10,6,0.478,0.722,40,28,12,2
545,21400546,Denver Nuggets,Sacramento Kings,118,108,226,10,Denver Nuggets,10,0.294,0.679,39,27,10,6,0.316,0.75,38,19,5,6
546,21400547,Cleveland Cavaliers,Golden State Warriors,94,112,206,18,Golden State Warriors,18,0.304,0.739,45,13,8,1,0.333,0.941,44,35,9,8
547,21400548,Orlando Magic,Los Angeles Lakers,84,101,185,17,Los Angeles Lakers,17,0.429,0.783,36,19,8,7,0.333,0.71,60,16,8,7
548,21400549,Charlotte Hornets,New York Knicks,110,82,192,28,Charlotte Hornets,28,0.438,0.758,51,18,8,5,0.276,0.889,29,17,9,4
549,21400550,Dallas Mavericks,Los Angeles Clippers,100,120,220,20,Los Angeles Clippers,20,0.4,0.706,40,29,4,2,0.419,0.714,47,31,8,5
550,21400551,Brooklyn Nets,Detroit Pistons,93,98,191,5,Detroit Pistons,5,0.29,1,46,25,6,2,0.333,0.731,44,27,8,3
551,21400552,Indiana Pacers,Philadelphia 76ers,92,93,185,1,Philadelphia 76ers,1,0.222,0.714,54,16,9,5,0.458,0.72,44,21,4,12
552,21400553,Boston Celtics,Toronto Raptors,96,109,205,13,Toronto Raptors,13,0.333,0.6,43,23,7,3,0.433,0.737,48,23,8,10
553,21400554,Milwaukee Bucks,Chicago Bulls,87,95,182,8,Chicago Bulls,8,0.273,0.75,37,19,9,10,0.235,0.875,51,24,5,5
554,21400555,Utah Jazz,Houston Rockets,82,97,179,15,Houston Rockets,15,0.294,0.905,41,20,15,6,0.382,0.857,33,24,16,3
555,21400556,San Antonio Spurs,Minnesota Timberwolves,108,93,201,15,San Antonio Spurs,15,0.375,0.85,45,21,9,2,0.2,1,42,17,7,4
556,21400557,Orlando Magic,Portland Trail Blazers,92,103,195,11,Portland Trail Blazers,11,0.143,0.75,49,22,10,0,0.385,0.808,43,22,6,8
557,21400558,Washington Wizards,Atlanta Hawks,89,120,209,31,Atlanta Hawks,31,0.25,0.8,39,25,5,7,0.516,0.833,42,34,14,3
558,21400559,Miami Heat,Los Angeles Clippers,104,90,194,14,Miami Heat,14,0.286,0.833,46,28,8,5,0.346,0.722,27,17,4,2
559,21400560,Phoenix Suns,Memphis Grizzlies,110,122,232,12,Memphis Grizzlies,12,0.229,0.783,46,20,14,7,0.429,0.708,54,24,7,8
560,21400561,Cleveland Cavaliers,Sacramento Kings,84,103,187,19,Sacramento Kings,19,0.344,0.583,41,18,2,6,0.353,0.765,45,20,8,4
561,21400562,Portland Trail Blazers,Los Angeles Lakers,106,94,200,12,Portland Trail Blazers,12,0.419,0.647,43,28,5,0,0.318,0.789,45,29,2,4
562,21400563,New Orleans Pelicans,Boston Celtics,100,108,208,8,Boston Celtics,8,0.4,0.865,45,20,7,6,0.333,0.839,44,24,8,5
563,21400564,Houston Rockets,Brooklyn Nets,113,99,212,14,Houston Rockets,14,0.4,0.75,42,22,9,2,0.238,0.889,41,18,7,4
564,21400565,Detroit Pistons,Toronto Raptors,114,111,225,3,Detroit Pistons,3,0.333,0.806,46,24,10,4,0.259,0.714,42,29,4,7
565,21400566,Orlando Magic,Chicago Bulls,121,114,235,7,Orlando Magic,7,0.389,0.621,34,28,10,3,0.296,0.727,43,25,6,5
566,21400567,Minnesota Timberwolves,Indiana Pacers,110,101,211,9,Minnesota Timberwolves,9,0.5,0.947,34,22,11,3,0.278,0.6,41,22,9,5
567,21400568,Atlanta Hawks,Philadelphia 76ers,105,87,192,18,Atlanta Hawks,18,0.522,0.563,47,34,6,3,0.36,0.64,35,20,8,6
568,21400569,San Antonio Spurs,Washington Wizards,93,101,194,8,Washington Wizards,8,0.31,0.667,34,26,3,4,0.5,0.875,48,20,4,7
569,21400570,Cleveland Cavaliers,Phoenix Suns,100,107,207,7,Phoenix Suns,7,0.371,0.75,42,16,7,1,0.35,0.741,34,23,10,2
570,21400571,Golden State Warriors,Utah Jazz,116,105,221,11,Golden State Warriors,11,0.52,0.846,31,32,10,5,0.333,0.833,44,14,7,7
571,21400572,Dallas Mavericks,Sacramento Kings,108,104,212,4,Dallas Mavericks,4,0.25,0.696,44,23,12,4,0.056,0.794,59,22,7,2
572,21400573,Miami Heat,Los Angeles Lakers,78,75,153,3,Miami Heat,3,0.125,0.667,52,23,7,11,0.174,0.722,46,20,10,3
573,21400574,San Antonio Spurs,Charlotte Hornets,98,93,191,5,San Antonio Spurs,5,0.381,0.8,42,27,7,11,0.308,0.657,48,15,4,10
574,21400575,Houston Rockets,Orlando Magic,113,120,233,7,Orlando Magic,7,0.346,0.87,38,26,11,6,0.346,0.885,39,22,14,1
575,21400576,Memphis Grizzlies,Brooklyn Nets,103,92,195,11,Memphis Grizzlies,11,0.176,0.759,41,18,13,3,0.385,0.833,36,19,5,1
576,21400577,New Orleans Pelicans,Detroit Pistons,105,94,199,11,New Orleans Pelicans,11,0.381,0.826,47,23,4,7,0.364,0.783,30,23,8,10
577,21400578,Philadelphia 76ers,Toronto Raptors,84,100,184,16,Toronto Raptors,16,0.158,0.613,45,13,10,8,0.345,0.636,49,26,7,2
578,21400579,Washington Wizards,Chicago Bulls,105,99,204,6,Washington Wizards,6,0.333,0.8,43,29,4,4,0.481,0.75,33,18,10,5
579,21400580,Atlanta Hawks,Boston Celtics,105,91,196,14,Atlanta Hawks,14,0.345,0.852,35,23,13,7,0.333,0.857,40,22,5,2
580,21400581,Dallas Mavericks,Denver Nuggets,107,114,221,7,Denver Nuggets,7,0.243,0.8,39,24,8,5,0.211,0.8,51,25,6,7
581,21400582,Miami Heat,Golden State Warriors,89,104,193,15,Golden State Warriors,15,0.333,0.852,41,19,5,4,0.448,0.789,36,29,5,5
582,21400583,Los Angeles Clippers,Portland Trail Blazers,100,94,194,6,Los Angeles Clippers,6,0.348,0.947,44,20,9,2,0.231,0.9,48,22,5,1
583,21400584,Oklahoma City Thunder,Houston Rockets,101,112,213,11,Houston Rockets,11,0.379,0.714,43,25,8,9,0.444,0.737,41,25,12,3
584,21400585,New York Knicks,Milwaukee Bucks,79,95,174,16,Milwaukee Bucks,16,0.364,0.75,36,22,5,6,0.444,0.738,44,21,13,2
585,21400586,Cleveland Cavaliers,Los Angeles Lakers,109,102,211,7,Cleveland Cavaliers,7,0.3,0.722,38,14,8,3,0.333,0.696,35,26,4,1
586,21400587,Detroit Pistons,Indiana Pacers,98,96,194,2,Detroit Pistons,2,0.419,0.875,49,17,6,5,0.333,0.833,44,22,8,4
587,21400588,Memphis Grizzlies,Orlando Magic,106,96,202,10,Memphis Grizzlies,10,0.214,0.793,47,27,8,5,0.375,0.75,39,22,5,4
588,21400589,New Orleans Pelicans,Philadelphia 76ers,81,96,177,15,Philadelphia 76ers,15,0.235,0.655,55,17,5,6,0.318,0.63,39,22,12,10
589,21400590,Brooklyn Nets,Washington Wizards,102,80,182,22,Brooklyn Nets,22,0.333,0.774,39,18,12,4,0.235,0.875,37,23,6,5
590,21400591,Chicago Bulls,Boston Celtics,119,103,222,16,Chicago Bulls,16,0.52,0.833,36,28,12,6,0.313,0.875,45,29,5,4
591,21400592,Atlanta Hawks,Toronto Raptors,110,89,199,21,Atlanta Hawks,21,0.522,0.875,32,30,7,6,0.24,0.765,35,20,7,3
592,21400593,Golden State Warriors,Oklahoma City Thunder,115,127,242,12,Oklahoma City Thunder,12,0.375,0.786,43,24,10,2,0.455,0.789,54,27,8,2
593,21400594,Denver Nuggets,Dallas Mavericks,89,97,186,8,Dallas Mavericks,8,0.36,0.48,52,23,6,3,0.32,0.793,52,22,7,2
594,21400595,Portland Trail Blazers,San Antonio Spurs,96,110,206,14,San Antonio Spurs,14,0.316,0.8,32,20,6,6,0.379,0.882,49,34,12,4
595,21400596,Minnesota Timberwolves,Phoenix Suns,99,110,209,11,Phoenix Suns,11,0.364,0.583,36,26,6,3,0.333,0.818,46,18,5,5
596,21400597,Los Angeles Lakers,Utah Jazz,85,94,179,9,Utah Jazz,9,0.429,0.741,42,7,6,5,0.387,1,38,24,11,7
597,21400598,Miami Heat,Sacramento Kings,95,83,178,12,Miami Heat,12,0.471,0.81,38,26,9,6,0.438,0.857,35,20,3,1
598,21400599,Cleveland Cavaliers,Los Angeles Clippers,126,121,247,5,Cleveland Cavaliers,5,0.435,0.774,44,23,9,3,0.345,0.694,43,26,9,1
599,21400600,Indiana Pacers,Charlotte Hornets,71,80,151,9,Charlotte Hornets,9,0.095,0.692,56,18,5,10,0.133,0.64,58,16,7,5
600,21400601,Philadelphia 76ers,Detroit Pistons,89,107,196,18,Detroit Pistons,18,0.25,0.857,42,24,10,5,0.429,0.842,47,27,16,5
601,21400602,Atlanta Hawks,Chicago Bulls,107,99,206,8,Atlanta Hawks,8,0.423,0.762,40,31,10,7,0.346,0.8,43,25,5,5
602,21400603,Golden State Warriors,Houston Rockets,131,106,237,25,Golden State Warriors,25,0.409,0.667,49,32,11,11,0.304,0.735,39,22,10,2
603,21400604,Portland Trail Blazers,Memphis Grizzlies,98,102,200,4,Memphis Grizzlies,4,0.361,0.867,40,20,7,5,0.533,0.667,50,21,4,4
604,21400605,Washington Wizards,Brooklyn Nets,99,90,189,9,Washington Wizards,9,0.313,0.519,49,23,7,5,0.235,0.778,40,17,6,0
605,21400606,Minnesota Timberwolves,Denver Nuggets,113,105,218,8,Minnesota Timberwolves,8,0.421,0.905,43,24,6,5,0.323,0.864,39,21,10,4
606,21400607,Los Angeles Clippers,Sacramento Kings,117,108,225,9,Los Angeles Clippers,9,0.321,0.645,34,24,7,6,0.278,0.808,54,18,3,2
607,21400608,New Orleans Pelicans,Toronto Raptors,95,93,188,2,New Orleans Pelicans,2,0.294,0.6,41,19,8,2,0.28,0.828,37,18,9,5
608,21400609,Oklahoma City Thunder,Orlando Magic,127,99,226,28,Oklahoma City Thunder,28,0.36,0.688,54,28,12,5,0.348,0.778,33,18,9,2
609,21400610,Utah Jazz,San Antonio Spurs,69,89,158,20,San Antonio Spurs,20,0.3,0.625,48,23,7,13,0.471,0.826,49,23,8,6
610,21400611,Minnesota Timberwolves,Charlotte Hornets,80,105,185,25,Charlotte Hornets,25,0.316,0.8,42,16,7,6,0.545,0.684,47,27,8,3
611,21400612,Philadelphia 76ers,Washington Wizards,76,111,187,35,Washington Wizards,35,0.25,0.609,30,19,11,4,0.538,0.778,53,26,8,5
612,21400613,Detroit Pistons,Atlanta Hawks,82,93,175,11,Atlanta Hawks,11,0.257,0.577,61,17,6,2,0.3,0.714,42,31,8,1
613,21400614,Boston Celtics,Los Angeles Clippers,93,102,195,9,Los Angeles Clippers,9,0.414,0.714,43,24,6,2,0.429,0.789,44,27,6,10
614,21400615,Denver Nuggets,Golden State Warriors,79,122,201,43,Golden State Warriors,43,0.292,0.632,39,17,9,3,0.481,0.778,53,30,10,6
615,21400616,Dallas Mavericks,Memphis Grizzlies,103,95,198,8,Dallas Mavericks,8,0.4,0.758,42,17,6,3,0.136,0.909,42,17,8,4
616,21400617,Indiana Pacers,Houston Rockets,98,110,208,12,Houston Rockets,12,0.222,0.778,43,21,12,0,0.387,0.727,39,26,13,2
617,21400618,New Orleans Pelicans,New York Knicks,92,99,191,7,New York Knicks,7,0.296,0.7,50,13,1,1,0.435,0.765,34,22,2,8
618,21400619,Toronto Raptors,Milwaukee Bucks,92,89,181,3,Toronto Raptors,3,0.25,0.583,54,17,9,5,0.278,0.64,43,22,12,5
619,21400620,Chicago Bulls,Cleveland Cavaliers,94,108,202,14,Cleveland Cavaliers,14,0.5,0.813,40,12,5,9,0.444,0.72,54,20,5,4
620,21400621,Sacramento Kings,Portland Trail Blazers,94,98,192,4,Portland Trail Blazers,4,0.333,0.733,53,13,8,5,0.306,0.654,35,21,16,3
621,21400622,Los Angeles Lakers,Phoenix Suns,100,115,215,15,Phoenix Suns,15,0.471,0.686,46,24,9,3,0.406,0.727,41,23,16,7
622,21400623,Oklahoma City Thunder,Miami Heat,94,86,180,8,Oklahoma City Thunder,8,0.231,0.6,42,15,11,3,0.364,0.737,36,20,4,2
623,21400624,San Antonio Spurs,Denver Nuggets,109,99,208,10,San Antonio Spurs,10,0.407,0.815,44,27,10,6,0.357,0.69,42,26,7,0
624,21400625,Miami Heat,Charlotte Hornets,76,78,154,2,Charlotte Hornets,2,0.278,0.867,41,14,7,8,0.211,0.667,56,19,3,8
625,21400626,Utah Jazz,Cleveland Cavaliers,92,106,198,14,Cleveland Cavaliers,14,0.364,0.778,42,24,9,1,0.208,0.68,45,24,15,4
626,21400627,New York Knicks,Philadelphia 76ers,98,91,189,7,New York Knicks,7,0.35,0.85,52,26,6,6,0.348,0.781,43,20,7,13
627,21400628,Indiana Pacers,Atlanta Hawks,91,110,201,19,Atlanta Hawks,19,0.2,0.923,42,22,7,2,0.448,0.731,43,30,12,3
628,21400629,Orlando Magic,Detroit Pistons,118,128,246,10,Detroit Pistons,10,0.4,1,42,29,9,5,0.417,0.833,45,35,10,5
629,21400630,Toronto Raptors,Memphis Grizzlies,86,92,178,6,Memphis Grizzlies,6,0.179,0.844,50,14,6,6,0.143,0.793,45,15,6,8
630,21400631,Dallas Mavericks,Minnesota Timberwolves,98,75,173,23,Dallas Mavericks,23,0.407,0.643,42,26,6,3,0.133,0.733,43,22,6,1
631,21400632,Los Angeles Lakers,New Orleans Pelicans,80,96,176,16,New Orleans Pelicans,16,0.3,0.857,41,16,12,4,0.188,0.81,45,21,8,5
632,21400633,Oklahoma City Thunder,Washington Wizards,105,103,208,2,Oklahoma City Thunder,2,0.207,0.826,57,21,5,5,0.233,0.769,58,23,8,3
633,21400634,Portland Trail Blazers,Phoenix Suns,113,118,231,5,Phoenix Suns,5,0.406,0.786,44,21,8,4,0.333,0.625,50,24,11,1
634,21400635,Brooklyn Nets,Sacramento Kings,103,100,203,3,Brooklyn Nets,3,0.25,0.8,43,22,7,6,0.278,0.708,42,22,5,2
635,21400636,Houston Rockets,Golden State Warriors,113,126,239,13,Golden State Warriors,13,0.406,0.839,46,23,9,3,0.448,0.833,46,26,13,9
636,21400637,San Antonio Spurs,Chicago Bulls,81,104,185,23,Chicago Bulls,23,0.286,0.833,39,17,4,5,0.316,0.813,46,19,7,8
637,21400638,Utah Jazz,Milwaukee Bucks,101,99,200,2,Utah Jazz,2,0.452,0.821,43,25,9,3,0.385,0.833,40,26,11,5
638,21400639,Boston Celtics,Portland Trail Blazers,90,89,179,1,Boston Celtics,1,0.368,0.714,47,23,8,5,0.321,0.737,45,16,8,6
639,21400640,Brooklyn Nets,Los Angeles Clippers,84,123,207,39,Los Angeles Clippers,39,0.19,0.56,40,17,11,3,0.44,0.667,48,41,8,9
640,21400641,Toronto Raptors,Philadelphia 76ers,91,86,177,5,Toronto Raptors,5,0.25,0.792,42,19,11,5,0.31,0.833,48,21,9,6
641,21400642,Oklahoma City Thunder,Atlanta Hawks,93,103,196,10,Atlanta Hawks,10,0.385,0.611,36,23,11,7,0.4,1,47,27,6,5
642,21400643,Charlotte Hornets,Cleveland Cavaliers,90,129,219,39,Cleveland Cavaliers,39,0.125,0.667,42,27,6,5,0.536,0.786,56,29,7,5
643,21400644,Indiana Pacers,Miami Heat,87,89,176,2,Miami Heat,2,0.2,0.87,37,14,9,3,0.235,0.867,36,20,8,0
644,21400645,Orlando Magic,New York Knicks,106,113,219,7,New York Knicks,7,0.259,0.579,39,27,10,4,0.4,0.81,49,29,6,4
645,21400646,Chicago Bulls,Dallas Mavericks,102,98,200,4,Chicago Bulls,4,0.563,0.85,47,22,8,5,0.333,1,30,16,12,8
646,21400647,New Orleans Pelicans,Minnesota Timberwolves,92,84,176,8,New Orleans Pelicans,8,0.75,0.643,37,17,7,9,0.222,0.706,38,27,3,4
647,21400648,Los Angeles Lakers,San Antonio Spurs,85,99,184,14,San Antonio Spurs,14,0.385,0.7,40,18,4,4,0.292,0.741,52,19,5,4
648,21400649,Boston Celtics,Denver Nuggets,100,99,199,1,Boston Celtics,1,0.429,0.63,41,20,8,6,0.286,0.731,48,20,8,2
649,21400650,Houston Rockets,Phoenix Suns,113,111,224,2,Houston Rockets,2,0.37,0.75,41,24,7,6,0.333,0.708,44,21,4,6
650,21400651,Sacramento Kings,Golden State Warriors,101,126,227,25,Golden State Warriors,25,0.235,0.853,43,19,12,3,0.425,0.864,46,32,13,8
651,21400652,New York Knicks,Charlotte Hornets,71,76,147,5,Charlotte Hornets,5,0.4,0.5,54,20,4,6,0.286,0.649,41,9,7,13
652,21400653,Detroit Pistons,Milwaukee Bucks,86,101,187,15,Milwaukee Bucks,15,0.24,0.72,46,14,11,2,0.647,0.8,45,33,6,6
653,21400654,Philadelphia 76ers,Memphis Grizzlies,83,101,184,18,Memphis Grizzlies,18,0.375,0.545,48,18,7,2,0.429,0.84,47,24,10,7
654,21400655,Brooklyn Nets,Utah Jazz,73,108,181,35,Utah Jazz,35,0.333,0.625,29,17,10,9,0.448,0.786,43,23,9,5
655,21400656,Washington Wizards,Portland Trail Blazers,96,103,199,7,Portland Trail Blazers,7,0.333,0.786,41,24,8,3,0.419,1,44,22,8,1
656,21400657,Miami Heat,Chicago Bulls,96,84,180,12,Miami Heat,12,0.077,0.826,54,19,6,13,0.292,0.789,43,15,5,10
657,21400658,Oklahoma City Thunder,Cleveland Cavaliers,98,108,206,10,Cleveland Cavaliers,10,0.333,0.778,42,26,6,6,0.444,0.69,48,17,5,8
658,21400659,Los Angeles Clippers,Phoenix Suns,120,100,220,20,Los Angeles Clippers,20,0.435,0.667,50,28,7,5,0.345,0.815,31,23,5,8
659,21400660,Dallas Mavericks,New Orleans Pelicans,106,109,215,3,New Orleans Pelicans,3,0.375,0.76,38,20,5,6,0.471,0.84,40,27,9,3
660,21400661,Minnesota Timberwolves,Atlanta Hawks,100,112,212,12,Atlanta Hawks,12,0.375,0.8,37,24,4,2,0.357,0.667,29,30,8,5
661,21400662,Indiana Pacers,Orlando Magic,106,99,205,7,Indiana Pacers,7,0.4,0.667,47,27,8,5,0.353,0.739,33,22,7,5
662,21400663,Milwaukee Bucks,San Antonio Spurs,95,101,196,6,San Antonio Spurs,6,0.471,0.692,42,29,12,5,0.227,0.867,41,22,9,6
663,21400664,Detroit Pistons,Toronto Raptors,110,114,224,4,Toronto Raptors,4,0.353,0.696,44,24,5,2,0.333,0.793,37,23,9,5
664,21400665,Boston Celtics,Golden State Warriors,111,114,225,3,Golden State Warriors,3,0.357,0.704,48,23,5,3,0.348,0.88,47,29,9,3
665,21400666,Washington Wizards,Denver Nuggets,117,115,232,2,Washington Wizards,2,0.286,0.739,50,29,5,2,0.414,0.75,45,26,7,3
666,21400667,Houston Rockets,Los Angeles Lakers,99,87,186,12,Houston Rockets,12,0.295,0.762,46,22,13,4,0.077,0.72,53,20,4,2
667,21400668,Portland Trail Blazers,Brooklyn Nets,96,106,202,10,Brooklyn Nets,10,0.423,0.778,50,17,4,3,0.429,0.783,46,25,6,5
668,21400669,Sacramento Kings,New York Knicks,124,86,210,38,Sacramento Kings,38,0.556,0.865,46,26,9,2,0.182,0.733,38,16,8,9
669,21400670,Orlando Magic,Memphis Grizzlies,94,103,197,9,Memphis Grizzlies,9,0.333,0.64,44,14,8,3,0.389,0.923,39,25,11,6
670,21400671,Philadelphia 76ers,New Orleans Pelicans,74,99,173,25,New Orleans Pelicans,25,0.133,0.762,38,15,7,9,0.438,0.737,52,28,10,11
671,21400672,Minnesota Timberwolves,Oklahoma City Thunder,84,92,176,8,Oklahoma City Thunder,8,0.154,0.75,50,13,9,5,0.2,0.667,52,17,9,11
672,21400673,Boston Celtics,Utah Jazz,99,90,189,9,Boston Celtics,9,0.421,0.913,37,18,8,3,0.375,0.579,39,18,9,10
673,21400674,Denver Nuggets,Los Angeles Clippers,98,102,200,4,Los Angeles Clippers,4,0.381,0.667,38,26,7,4,0.368,0.864,45,25,10,8
674,21400675,Toronto Raptors,Indiana Pacers,104,91,195,13,Toronto Raptors,13,0.346,0.794,42,21,9,6,0.389,0.696,43,22,4,3
675,21400676,Cleveland Cavaliers,Detroit Pistons,103,95,198,8,Cleveland Cavaliers,8,0.265,0.941,47,19,9,4,0.333,0.739,51,21,4,8
676,21400677,Milwaukee Bucks,Miami Heat,109,102,211,7,Milwaukee Bucks,7,0.563,0.733,34,25,7,3,0.35,0.731,33,20,5,1
677,21400678,Memphis Grizzlies,Dallas Mavericks,109,90,199,19,Memphis Grizzlies,19,0.476,0.75,40,23,6,0,0.269,0.7,35,20,8,3
678,21400679,Chicago Bulls,Golden State Warriors,113,111,224,2,Chicago Bulls,2,0.276,0.913,61,19,6,6,0.273,0.5,48,31,9,2
679,21400680,Washington Wizards,Los Angeles Lakers,98,92,190,6,Washington Wizards,6,0.25,0.667,51,19,8,2,0.25,0.813,38,17,9,4
680,21400681,Portland Trail Blazers,Cleveland Cavaliers,94,99,193,5,Cleveland Cavaliers,5,0.323,0.824,39,18,5,5,0.405,0.889,46,16,3,1
681,21400682,Detroit Pistons,Philadelphia 76ers,69,89,158,20,Philadelphia 76ers,20,0.1,0.913,38,15,12,5,0.333,0.667,48,27,11,10
682,21400683,Brooklyn Nets,Atlanta Hawks,102,113,215,11,Atlanta Hawks,11,0.375,0.833,35,26,6,5,0.364,0.962,45,29,4,4
683,21400684,Sacramento Kings,Toronto Raptors,102,119,221,17,Toronto Raptors,17,0.412,0.862,31,17,6,4,0.5,0.842,39,29,12,4
684,21400685,Dallas Mavericks,Houston Rockets,94,99,193,5,Houston Rockets,5,0.4,0.875,46,16,10,7,0.4,0.867,39,21,14,7
685,21400686,Boston Celtics,Minnesota Timberwolves,98,110,208,12,Minnesota Timberwolves,12,0.304,0.778,39,22,9,4,0.375,0.875,45,18,6,4
686,21400687,Denver Nuggets,New Orleans Pelicans,93,85,178,8,Denver Nuggets,8,0.588,0.714,39,30,4,7,0.2,0.75,48,15,2,6
687,21400688,Oklahoma City Thunder,New York Knicks,92,100,192,8,New York Knicks,8,0.227,0.864,47,10,7,7,0.471,0.706,51,29,8,6
688,21400689,Charlotte Hornets,San Antonio Spurs,86,95,181,9,San Antonio Spurs,9,0.333,0.857,43,23,7,4,0.345,0.833,49,23,7,8
689,21400690,Los Angeles Clippers,Utah Jazz,94,89,183,5,Los Angeles Clippers,5,0.346,0.68,37,13,7,6,0.208,0.7,47,17,2,6
690,21400691,Washington Wizards,Phoenix Suns,98,106,204,8,Phoenix Suns,8,0.444,0.696,50,13,2,3,0.379,0.833,41,23,10,2
691,21400692,Milwaukee Bucks,Orlando Magic,115,100,215,15,Milwaukee Bucks,15,0.48,0.722,38,29,16,8,0.278,0.7,49,14,8,4
692,21400693,Denver Nuggets,Memphis Grizzlies,69,99,168,30,Memphis Grizzlies,30,0.077,0.9,47,19,6,5,0.188,0.667,57,17,8,4
693,21400694,New York Knicks,Indiana Pacers,82,103,185,21,Indiana Pacers,21,0.313,0.692,33,22,3,6,0.333,0.722,49,25,4,4
694,21400695,Chicago Bulls,Los Angeles Lakers,118,123,241,5,Los Angeles Lakers,5,0.24,0.813,49,26,9,6,0.333,0.8,54,26,5,8
695,21400696,Minnesota Timberwolves,Philadelphia 76ers,94,103,197,9,Philadelphia 76ers,9,0.357,0.84,38,24,8,4,0.348,0.84,34,27,13,9
696,21400697,Portland Trail Blazers,Atlanta Hawks,99,105,204,6,Atlanta Hawks,6,0.367,0.909,46,25,7,3,0.478,0.636,42,26,12,4
697,21400698,Houston Rockets,Boston Celtics,93,87,180,6,Houston Rockets,6,0.267,0.75,50,22,6,4,0.292,0.696,48,14,8,5
698,21400699,Toronto Raptors,Brooklyn Nets,127,122,249,5,Toronto Raptors,5,0.269,0.867,45,22,5,3,0.211,0.769,50,19,7,4
699,21400700,Sacramento Kings,Cleveland Cavaliers,90,101,191,11,Cleveland Cavaliers,11,0.167,0.844,50,15,10,3,0.355,0.636,44,22,11,5
700,21400701,Los Angeles Clippers,New Orleans Pelicans,103,108,211,5,New Orleans Pelicans,5,0.25,0.706,38,20,5,4,0.52,0.885,51,26,5,3
701,21400702,Dallas Mavericks,Miami Heat,93,72,165,21,Dallas Mavericks,21,0.448,0.6,49,24,10,4,0.31,0.5,52,18,6,3
702,21400703,Golden State Warriors,Utah Jazz,100,110,210,10,Utah Jazz,10,0.296,0.72,41,21,8,2,0.36,0.607,55,21,10,6
703,21400704,Chicago Bulls,Phoenix Suns,93,99,192,6,Phoenix Suns,6,0.222,0.63,49,20,6,3,0.273,0.882,50,16,7,5
704,21400705,Sacramento Kings,Indiana Pacers,99,94,193,5,Sacramento Kings,5,0.333,0.897,46,16,8,1,0.2,0.92,40,22,8,5
705,21400706,Dallas Mavericks,Orlando Magic,108,93,201,15,Dallas Mavericks,15,0.524,0.591,36,26,9,4,0.333,0.792,42,21,9,3
706,21400707,Toronto Raptors,Washington Wizards,120,116,236,4,Toronto Raptors,4,0.423,0.7,34,26,7,8,0.417,0.78,40,26,8,6
707,21400708,Philadelphia 76ers,Atlanta Hawks,85,91,176,6,Atlanta Hawks,6,0.4,0.6,44,21,7,4,0.357,0.722,44,20,6,5
708,21400709,Houston Rockets,Detroit Pistons,101,114,215,13,Detroit Pistons,13,0.344,0.632,39,23,10,3,0.4,0.629,44,28,8,8
709,21400710,Oklahoma City Thunder,Memphis Grizzlies,74,85,159,11,Memphis Grizzlies,11,0.3,0.778,47,15,5,4,0.273,0.824,54,22,11,5
710,21400711,Cleveland Cavaliers,Minnesota Timberwolves,106,90,196,16,Cleveland Cavaliers,16,0.313,0.632,52,16,8,6,0.462,0.762,35,19,6,1
711,21400712,Portland Trail Blazers,Milwaukee Bucks,88,95,183,7,Milwaukee Bucks,7,0.29,0.722,44,19,11,3,0.381,0.929,50,22,12,8
712,21400713,Charlotte Hornets,Denver Nuggets,104,86,190,18,Charlotte Hornets,18,0,0.64,57,32,10,11,0.208,0.75,44,21,2,8
713,21400714,Los Angeles Clippers,San Antonio Spurs,105,85,190,20,Los Angeles Clippers,20,0.364,0.944,56,20,12,7,0.333,0.679,36,18,11,3
714,21400715,Phoenix Suns,Golden State Warriors,87,106,193,19,Golden State Warriors,19,0.346,0.706,52,22,10,5,0.375,0.778,44,27,11,8
715,21400716,Miami Heat,Boston Celtics,83,75,158,8,Miami Heat,8,0.19,0.714,46,18,7,9,0.211,0.611,40,24,7,3
716,21400717,Los Angeles Lakers,New York Knicks,80,92,172,12,New York Knicks,12,0.438,0.826,46,15,7,3,0.455,0.615,41,18,7,3
717,21400718,Philadelphia 76ers,Cleveland Cavaliers,84,97,181,13,Cleveland Cavaliers,13,0.364,0.714,37,23,16,7,0.444,0.682,43,22,8,6
718,21400719,Charlotte Hornets,Washington Wizards,92,88,180,4,Charlotte Hornets,4,0.267,0.737,42,21,6,3,0.4,0.842,43,19,7,3
719,21400720,Los Angeles Clippers,Brooklyn Nets,100,102,202,2,Brooklyn Nets,2,0.348,0.32,52,23,6,1,0.444,0.444,45,21,4,0
720,21400721,Milwaukee Bucks,Toronto Raptors,82,75,157,7,Milwaukee Bucks,7,0.438,0.529,44,24,8,6,0.259,0.818,46,14,7,3
721,21400722,Atlanta Hawks,New Orleans Pelicans,100,115,215,15,New Orleans Pelicans,15,0.318,0.765,32,19,6,3,0.391,0.87,52,30,5,10
722,21400723,Orlando Magic,Oklahoma City Thunder,97,104,201,7,Oklahoma City Thunder,7,0.261,0.833,44,23,5,1,0.4,0.846,40,25,10,5
723,21400724,Minnesota Timberwolves,Dallas Mavericks,94,100,194,6,Dallas Mavericks,6,0.231,0.885,47,18,10,2,0.323,0.667,43,27,11,10
724,21400725,Memphis Grizzlies,Phoenix Suns,102,101,203,1,Memphis Grizzlies,1,0.273,0.794,46,19,12,4,0.375,0.611,38,18,12,6
725,21400726,Denver Nuggets,Philadelphia 76ers,98,105,203,7,Philadelphia 76ers,7,0.387,0.714,37,26,13,3,0.407,0.762,49,26,10,9
726,21400727,Miami Heat,Detroit Pistons,91,108,199,17,Detroit Pistons,17,0.429,0.652,35,23,1,6,0.45,0.833,45,27,7,5
727,21400728,Boston Celtics,New York Knicks,108,97,205,11,Boston Celtics,11,0.25,0.783,39,23,6,0,0.35,0.727,35,22,7,2
728,21400729,Utah Jazz,Portland Trail Blazers,102,103,205,1,Portland Trail Blazers,1,0.462,0.692,41,18,8,4,0.304,0.706,45,18,8,6
729,21400730,Golden State Warriors,Sacramento Kings,121,96,217,25,Golden State Warriors,25,0.435,0.731,49,33,13,5,0.438,0.792,34,17,7,4
730,21400731,Detroit Pistons,Indiana Pacers,109,114,223,5,Indiana Pacers,5,0.5,0.733,35,23,7,2,0.571,0.556,37,28,5,4
731,21400732,Washington Wizards,Atlanta Hawks,96,105,201,9,Atlanta Hawks,9,0.25,0.8,41,19,7,2,0.44,0.667,46,24,7,2
732,21400733,Denver Nuggets,Boston Celtics,100,104,204,4,Boston Celtics,4,0.167,0.909,48,18,9,6,0.429,0.706,51,27,10,3
733,21400734,Brooklyn Nets,Toronto Raptors,109,93,202,16,Brooklyn Nets,16,0.474,0.87,39,24,7,1,0.303,0.722,38,22,3,4
734,21400735,Chicago Bulls,Houston Rockets,90,101,191,11,Houston Rockets,11,0.32,0.769,60,16,3,5,0.296,0.739,47,18,6,8
735,21400736,Los Angeles Lakers,Milwaukee Bucks,105,113,218,8,Milwaukee Bucks,8,0.321,0.72,53,22,3,2,0.423,0.909,35,25,10,7
736,21400737,Miami Heat,Minnesota Timberwolves,101,102,203,1,Minnesota Timberwolves,1,0.438,0.667,47,18,11,3,0.545,0.815,32,27,10,3
737,21400738,Oklahoma City Thunder,New Orleans Pelicans,102,91,193,11,Oklahoma City Thunder,11,0.333,0.636,48,21,3,11,0.28,0.769,48,23,7,3
738,21400739,Orlando Magic,San Antonio Spurs,103,110,213,7,San Antonio Spurs,7,0.476,0.643,39,27,6,1,0.438,0.571,41,32,7,4
739,21400740,Memphis Grizzlies,Utah Jazz,100,90,190,10,Memphis Grizzlies,10,0.462,0.818,38,26,7,4,0.304,0.654,40,15,6,3
740,21400741,Dallas Mavericks,Golden State Warriors,114,128,242,14,Golden State Warriors,14,0.333,0.786,42,24,8,1,0.5,0.76,46,29,5,5
741,21400742,Washington Wizards,Charlotte Hornets,87,94,181,7,Charlotte Hornets,7,0.5,0.706,37,20,2,5,0.24,0.815,50,15,5,15
742,21400743,Los Angeles Clippers,Cleveland Cavaliers,94,105,199,11,Cleveland Cavaliers,11,0.227,0.65,43,24,9,1,0.267,0.795,52,23,10,4
743,21400744,Dallas Mavericks,Sacramento Kings,101,78,179,23,Dallas Mavericks,23,0.353,0.7,48,25,9,7,0.143,0.773,49,13,5,8
744,21400745,Phoenix Suns,Portland Trail Blazers,87,108,195,21,Portland Trail Blazers,21,0.261,0.765,42,20,11,2,0.258,0.87,57,21,7,7
745,21400746,New York Knicks,Brooklyn Nets,88,92,180,4,Brooklyn Nets,4,0.25,0.824,40,23,8,3,0.273,0.682,47,23,1,10
746,21400747,Cleveland Cavaliers,Indiana Pacers,99,103,202,4,Indiana Pacers,4,0.314,0.667,43,18,6,3,0.381,0.808,41,26,9,2
747,21400748,Los Angeles Lakers,Orlando Magic,97,103,200,6,Orlando Magic,6,0.423,0.615,43,27,12,8,0.333,0.857,48,26,9,6
748,21400749,Golden State Warriors,Atlanta Hawks,116,124,240,8,Atlanta Hawks,8,0.364,0.667,51,31,7,7,0.556,0.892,38,28,13,4
749,21400750,Philadelphia 76ers,Boston Celtics,96,107,203,11,Boston Celtics,11,0.44,0.484,44,22,6,3,0.37,0.76,53,27,8,4
750,21400751,Denver Nuggets,Detroit Pistons,88,98,186,10,Detroit Pistons,10,0.227,0.773,43,22,7,5,0.167,0.769,51,23,4,4
751,21400752,Los Angeles Clippers,Toronto Raptors,107,123,230,16,Toronto Raptors,16,0.261,0.806,30,21,8,4,0.433,0.811,42,25,7,1
752,21400753,Milwaukee Bucks,Houston Rockets,111,117,228,6,Houston Rockets,6,0.235,0.733,41,29,10,3,0.469,0.69,42,32,11,5
753,21400754,Memphis Grizzlies,Minnesota Timberwolves,89,90,179,1,Minnesota Timberwolves,1,0.167,0.75,30,19,11,5,0.294,0.882,43,17,8,1
754,21400755,New Orleans Pelicans,Oklahoma City Thunder,116,113,229,3,New Orleans Pelicans,3,0.55,0.833,46,26,5,5,0.333,0.893,40,19,11,8
755,21400756,Utah Jazz,Phoenix Suns,93,100,193,7,Phoenix Suns,7,0.35,0.667,43,23,8,4,0.519,0.714,44,20,10,5
756,21400757,Miami Heat,San Antonio Spurs,85,98,183,13,San Antonio Spurs,13,0.313,0.889,37,23,7,3,0.379,0.778,43,31,12,4
757,21400758,Chicago Bulls,New Orleans Pelicans,107,72,179,35,Chicago Bulls,35,0.455,0.846,45,18,6,4,0.235,0.571,38,16,8,6
758,21400759,Brooklyn Nets,Washington Wizards,77,114,191,37,Washington Wizards,37,0.222,0.677,38,17,8,4,0.45,0.739,51,31,9,3
759,21400760,Golden State Warriors,New York Knicks,106,92,198,14,Golden State Warriors,14,0.48,0.833,48,21,8,5,0.444,0.824,44,23,7,1
760,21400761,Charlotte Hornets,Philadelphia 76ers,81,89,170,8,Philadelphia 76ers,8,0.261,0.85,43,24,9,5,0.391,0.733,47,19,6,5
761,21400762,Portland Trail Blazers,Dallas Mavericks,101,111,212,10,Dallas Mavericks,10,0.313,0.708,58,24,11,4,0.389,0.688,55,21,11,7
762,21400763,Boston Celtics,Milwaukee Bucks,93,96,189,3,Milwaukee Bucks,3,0.241,0.7,44,20,7,1,0.4,0.737,40,21,6,6
763,21400764,Sacramento Kings,Utah Jazz,90,102,192,12,Utah Jazz,12,0.231,0.697,40,15,3,5,0.263,0.647,43,21,6,6
764,21400765,Los Angeles Clippers,Oklahoma City Thunder,108,131,239,23,Oklahoma City Thunder,23,0.375,0.706,29,28,9,2,0.4,0.816,54,26,8,6
765,21400766,Los Angeles Lakers,Cleveland Cavaliers,105,120,225,15,Cleveland Cavaliers,15,0.304,0.842,46,22,11,5,0.545,0.6,46,31,6,7
766,21400767,Atlanta Hawks,Memphis Grizzlies,88,94,182,6,Memphis Grizzlies,6,0.4,0.909,37,17,6,5,0.231,0.905,55,18,8,4
767,21400768,Indiana Pacers,Charlotte Hornets,103,102,205,1,Indiana Pacers,1,0.368,0.88,40,19,4,2,0.571,0.786,35,24,5,4
768,21400769,Minnesota Timberwolves,Detroit Pistons,112,101,213,11,Minnesota Timberwolves,11,0.417,0.853,40,26,6,1,0.323,0.773,35,18,8,4
769,21400770,Chicago Bulls,Orlando Magic,98,97,195,1,Chicago Bulls,1,0.364,0.889,35,27,11,1,0.36,0.769,45,21,9,4
770,21400771,Portland Trail Blazers,Houston Rockets,109,98,207,11,Portland Trail Blazers,11,0.31,0.87,39,20,8,5,0.371,0.676,40,24,7,1
771,21400772,San Antonio Spurs,Toronto Raptors,82,87,169,5,Toronto Raptors,5,0.25,0.813,52,23,10,6,0.308,0.792,48,18,11,7
772,21400773,Phoenix Suns,Sacramento Kings,83,85,168,2,Sacramento Kings,2,0.179,0.706,43,17,9,4,0.333,0.619,43,20,1,5
773,21400774,San Antonio Spurs,Indiana Pacers,95,93,188,2,San Antonio Spurs,2,0.24,0.882,42,18,8,7,0.381,1,50,24,4,6
774,21400775,Golden State Warriors,Philadelphia 76ers,89,84,173,5,Golden State Warriors,5,0.241,0.737,40,26,15,5,0.292,0.786,52,21,9,4
775,21400776,Orlando Magic,Washington Wizards,80,96,176,16,Washington Wizards,16,0.182,0.667,33,18,13,6,0.28,0.852,53,25,7,3
776,21400777,New York Knicks,Miami Heat,95,109,204,14,Miami Heat,14,0.35,0.842,35,22,8,8,0.545,0.862,35,28,9,5
777,21400778,Brooklyn Nets,Milwaukee Bucks,97,103,200,6,Milwaukee Bucks,6,0.36,0.632,38,25,3,8,0.389,0.88,44,25,14,4
778,21400779,Atlanta Hawks,Minnesota Timberwolves,117,105,222,12,Atlanta Hawks,12,0.476,0.95,36,26,14,6,0.313,0.727,50,24,6,8
779,21400780,Utah Jazz,New Orleans Pelicans,100,96,196,4,Utah Jazz,4,0.429,0.684,47,23,11,9,0.591,0.85,40,20,5,17
780,21400781,Los Angeles Clippers,Dallas Mavericks,115,98,213,17,Los Angeles Clippers,17,0.333,0.828,53,21,8,3,0.294,0.733,47,19,2,3
781,21400782,Oklahoma City Thunder,Denver Nuggets,124,114,238,10,Oklahoma City Thunder,10,0.5,0.743,40,24,4,5,0.321,0.724,38,20,7,4
782,21400783,Detroit Pistons,Charlotte Hornets,106,78,184,28,Detroit Pistons,28,0.263,0.9,48,21,8,5,0.375,0.786,38,21,1,9
783,21400784,Houston Rockets,Phoenix Suns,127,118,245,9,Houston Rockets,9,0.405,0.696,47,28,9,3,0.462,0.8,39,18,9,5
784,21400785,Sacramento Kings,Chicago Bulls,86,104,190,18,Chicago Bulls,18,0.167,0.519,45,23,3,3,0.35,0.867,33,26,8,3
785,21400786,Brooklyn Nets,Memphis Grizzlies,86,95,181,9,Memphis Grizzlies,9,0.25,0.765,46,14,7,5,0.316,0.68,45,24,14,9
786,21400787,Denver Nuggets,Los Angeles Lakers,106,96,202,10,Denver Nuggets,10,0.25,0.696,35,25,9,8,0.333,0.593,43,23,3,2
787,21400788,New York Knicks,Orlando Magic,83,89,172,6,Orlando Magic,6,0.333,0.778,39,19,7,4,0.364,0.821,44,13,6,9
788,21400789,Atlanta Hawks,Boston Celtics,88,89,177,1,Boston Celtics,1,0.241,0.652,44,23,6,5,0.323,0.95,56,21,7,4
789,21400790,San Antonio Spurs,Detroit Pistons,104,87,191,17,San Antonio Spurs,17,0.37,0.909,45,26,8,6,0.429,0.706,36,17,4,4
790,21400791,Washington Wizards,Toronto Raptors,93,95,188,2,Toronto Raptors,2,0.238,0.625,50,25,7,6,0.423,0.846,37,17,9,5
791,21400792,Sacramento Kings,Milwaukee Bucks,103,111,214,8,Milwaukee Bucks,8,0.364,0.767,48,24,7,5,0.467,0.813,45,23,11,5
792,21400793,Golden State Warriors,Minnesota Timberwolves,94,91,185,3,Golden State Warriors,3,0.259,0.778,49,26,7,6,0.357,0.741,50,18,7,2
793,21400794,Indiana Pacers,New Orleans Pelicans,106,93,199,13,Indiana Pacers,13,0.45,0.944,37,28,7,2,0.467,0.72,32,22,5,3
794,21400795,Memphis Grizzlies,Oklahoma City Thunder,89,105,194,16,Oklahoma City Thunder,16,0.167,0.767,42,13,7,2,0.35,0.96,49,24,7,9
795,21400796,Miami Heat,Cleveland Cavaliers,93,113,206,20,Cleveland Cavaliers,20,0.375,0.8,36,21,10,4,0.4,0.789,43,32,9,3
796,21400797,Utah Jazz,Dallas Mavericks,82,87,169,5,Dallas Mavericks,5,0.379,0.524,52,19,9,7,0.357,0.808,38,18,11,3
797,21400798,Los Angeles Lakers,Portland Trail Blazers,86,102,188,16,Portland Trail Blazers,16,0.438,1,48,17,4,5,0.333,0.957,52,27,5,5
798,21400799,Houston Rockets,Los Angeles Clippers,95,110,205,15,Los Angeles Clippers,15,0.2,0.818,41,26,6,6,0.182,0.622,49,25,13,3
799,21400800,Cleveland Cavaliers,Chicago Bulls,98,113,211,15,Chicago Bulls,15,0.258,0.727,43,20,5,3,0.391,0.769,47,29,10,3
800,21400801,Dallas Mavericks,Oklahoma City Thunder,89,104,193,15,Oklahoma City Thunder,15,0.333,0.824,39,16,14,3,0.318,0.808,62,20,8,0
801,21400802,San Antonio Spurs,Los Angeles Clippers,115,119,234,4,Los Angeles Clippers,4,0.357,0.826,38,34,6,2,0.421,0.519,43,26,10,4
802,21400803,New Orleans Pelicans,Orlando Magic,84,95,179,11,Orlando Magic,11,0.263,0.75,40,21,6,6,0.222,0.5,42,22,4,3
803,21400804,Indiana Pacers,Philadelphia 76ers,106,95,201,11,Indiana Pacers,11,0.364,0.818,44,24,13,1,0.32,0.655,47,18,11,11
804,21400805,Toronto Raptors,Atlanta Hawks,105,80,185,25,Toronto Raptors,25,0.433,0.75,52,27,15,9,0.211,0.667,52,19,6,8
805,21400806,Chicago Bulls,Detroit Pistons,91,100,191,9,Detroit Pistons,9,0.313,0.909,43,16,2,7,0.273,0.545,42,19,12,1
806,21400807,Miami Heat,New York Knicks,111,87,198,24,Miami Heat,24,0.45,0.743,50,28,12,4,0.333,0.688,32,28,10,6
807,21400808,Phoenix Suns,Minnesota Timberwolves,109,111,220,2,Minnesota Timberwolves,2,0.412,0.71,48,23,8,9,0.267,0.711,51,24,7,7
808,21400809,Cleveland Cavaliers,Washington Wizards,127,89,216,38,Cleveland Cavaliers,38,0.424,0.75,42,28,12,4,0.063,0.75,43,22,7,7
809,21400810,Houston Rockets,Dallas Mavericks,100,111,211,11,Dallas Mavericks,11,0.324,0.615,47,20,8,9,0.375,0.778,50,26,10,2
810,21400811,Denver Nuggets,Milwaukee Bucks,81,89,170,8,Milwaukee Bucks,8,0.269,0.667,45,18,11,7,0.333,0.818,46,22,6,5
811,21400812,Portland Trail Blazers,Utah Jazz,76,92,168,16,Utah Jazz,16,0.182,0.909,37,12,5,5,0.4,0.471,48,18,11,7
812,21400813,Boston Celtics,Sacramento Kings,101,109,210,8,Sacramento Kings,8,0.273,0.577,40,24,14,3,0.364,0.808,57,26,6,5
813,21400814,San Antonio Spurs,Golden State Warriors,99,110,209,11,Golden State Warriors,11,0.316,0.75,44,25,6,4,0.515,0.611,40,29,10,5
814,21400815,Brooklyn Nets,Los Angeles Lakers,114,105,219,9,Brooklyn Nets,9,0.476,0.833,46,29,7,2,0.174,0.655,46,22,10,4
815,21400816,Oklahoma City Thunder,Charlotte Hornets,110,103,213,7,Oklahoma City Thunder,7,0.278,0.808,59,21,7,7,0.292,0.8,41,28,9,10
816,21400817,New Orleans Pelicans,Miami Heat,105,91,196,14,New Orleans Pelicans,14,0.381,0.871,41,22,8,3,0.294,0.741,45,15,5,7
817,21400818,Phoenix Suns,Chicago Bulls,107,112,219,5,Chicago Bulls,5,0.4,0.375,36,25,10,2,0.5,0.875,47,27,5,3
818,21400819,Toronto Raptors,Houston Rockets,76,98,174,22,Houston Rockets,22,0.222,0.786,39,12,17,5,0.207,0.71,52,22,17,9
819,21400820,Sacramento Kings,Los Angeles Clippers,99,126,225,27,Los Angeles Clippers,27,0.25,0.761,55,18,4,7,0.4,0.714,54,31,9,11
820,21400821,Cleveland Cavaliers,New York Knicks,101,83,184,18,Cleveland Cavaliers,18,0.364,0.6,47,22,5,3,0.158,0.857,50,16,8,2
821,21400822,Atlanta Hawks,Milwaukee Bucks,97,86,183,11,Atlanta Hawks,11,0.3,0.857,43,23,10,7,0.25,1,38,19,10,7
822,21400823,Washington Wizards,Detroit Pistons,89,106,195,17,Detroit Pistons,17,0.353,0.643,43,28,4,2,0.406,0.76,51,22,8,1
823,21400824,Golden State Warriors,Indiana Pacers,98,104,202,6,Indiana Pacers,6,0.346,0.955,45,19,9,5,0.421,0.783,46,20,3,4
824,21400825,Philadelphia 76ers,Orlando Magic,98,103,201,5,Orlando Magic,5,0.382,0.765,41,21,8,5,0.261,0.731,38,19,9,2
825,21400826,Denver Nuggets,Oklahoma City Thunder,94,119,213,25,Oklahoma City Thunder,25,0.259,0.85,42,19,13,5,0.4,0.652,60,31,8,10
826,21400827,Charlotte Hornets,Dallas Mavericks,81,92,173,11,Dallas Mavericks,11,0.316,0.692,47,20,10,2,0.278,0.789,49,20,7,6
827,21400828,Memphis Grizzlies,Portland Trail Blazers,98,92,190,6,Memphis Grizzlies,6,0.333,0.846,44,20,13,4,0.394,0.813,46,24,4,4
828,21400829,Boston Celtics,Los Angeles Lakers,111,118,229,7,Los Angeles Lakers,7,0.242,0.704,48,27,9,5,0.389,0.658,46,22,8,4
829,21400830,Philadelphia 76ers,Miami Heat,108,119,227,11,Miami Heat,11,0.419,0.536,33,27,10,8,0.524,0.727,45,27,6,3
830,21400831,Milwaukee Bucks,Chicago Bulls,71,87,158,16,Chicago Bulls,16,0.222,0.538,41,16,9,4,0.308,0.781,62,20,4,7
831,21400832,Minnesota Timberwolves,Houston Rockets,102,113,215,11,Houston Rockets,11,0.278,0.897,58,17,9,3,0.316,0.676,56,23,11,8
832,21400833,Toronto Raptors,New Orleans Pelicans,97,100,197,3,New Orleans Pelicans,3,0.217,0.71,40,13,12,2,0.455,0.625,48,27,6,7
833,21400834,Brooklyn Nets,Denver Nuggets,110,82,192,28,Brooklyn Nets,28,0.19,0.87,57,21,7,9,0.259,0.591,49,18,6,3
834,21400835,Boston Celtics,Phoenix Suns,115,110,225,5,Boston Celtics,5,0.483,0.767,42,26,13,1,0.281,0.813,50,25,9,7
835,21400836,San Antonio Spurs,Utah Jazz,81,90,171,9,Utah Jazz,9,0.263,0.571,44,17,7,7,0.267,0.783,49,14,14,5
836,21400837,Memphis Grizzlies,Los Angeles Clippers,90,87,177,3,Memphis Grizzlies,3,0.333,0.731,42,22,10,4,0.333,0.667,40,21,6,10
837,21400838,Golden State Warriors,Washington Wizards,114,107,221,7,Golden State Warriors,7,0.522,0.706,29,27,12,1,0.278,0.857,45,23,4,4
838,21400839,Cleveland Cavaliers,Detroit Pistons,102,93,195,9,Cleveland Cavaliers,9,0.378,0.833,40,22,9,5,0.375,0.6,46,16,5,3
839,21400840,Indiana Pacers,Oklahoma City Thunder,92,105,197,13,Oklahoma City Thunder,13,0.346,0.636,48,26,5,3,0.375,0.889,57,23,10,8
840,21400841,Toronto Raptors,Dallas Mavericks,92,99,191,7,Dallas Mavericks,7,0.346,0.636,37,17,10,4,0.421,0.833,40,17,13,4
841,21400842,Miami Heat,Orlando Magic,93,90,183,3,Miami Heat,3,0.194,0.719,42,17,8,5,0.273,0.581,50,17,4,1
842,21400843,Dallas Mavericks,Atlanta Hawks,87,104,191,17,Atlanta Hawks,17,0.161,0.778,44,20,0,3,0.371,0.813,41,28,7,2
843,21400844,New York Knicks,Boston Celtics,94,115,209,21,Boston Celtics,21,0.095,0.774,41,19,6,4,0.452,0.85,46,29,6,1
844,21400845,Charlotte Hornets,Chicago Bulls,98,86,184,12,Charlotte Hornets,12,0.286,0.762,45,16,8,3,0.176,0.652,43,24,6,11
845,21400846,Los Angeles Clippers,Houston Rockets,105,110,215,5,Houston Rockets,5,0.344,0.737,49,18,1,4,0.386,0.7,46,27,7,9
846,21400847,Philadelphia 76ers,Milwaukee Bucks,88,104,192,16,Milwaukee Bucks,16,0.44,0.789,38,21,13,3,0.333,0.688,43,32,16,5
847,21400848,Washington Wizards,Minnesota Timberwolves,77,97,174,20,Minnesota Timberwolves,20,0.222,0.875,43,21,5,3,0.308,0.821,53,17,10,4
848,21400849,Brooklyn Nets,New Orleans Pelicans,96,102,198,6,New Orleans Pelicans,6,0.333,0.733,37,13,6,6,0.44,0.789,43,26,6,6
849,21400850,Phoenix Suns,Denver Nuggets,110,96,206,14,Phoenix Suns,14,0.333,0.75,65,19,9,7,0.353,0.667,40,22,11,5
850,21400851,Los Angeles Lakers,Utah Jazz,100,97,197,3,Los Angeles Lakers,3,0.182,0.857,42,17,12,8,0.583,0.647,47,18,3,5
851,21400852,Memphis Grizzlies,Sacramento Kings,90,102,192,12,Sacramento Kings,12,0.25,0.783,38,22,12,5,0.375,0.72,47,24,10,6
852,21400853,San Antonio Spurs,Portland Trail Blazers,95,111,206,16,Portland Trail Blazers,16,0.381,0.929,37,20,8,5,0.5,0.8,45,25,9,4
853,21400854,Golden State Warriors,Cleveland Cavaliers,99,110,209,11,Cleveland Cavaliers,11,0.379,0.526,44,32,10,6,0.321,0.829,51,15,10,2
854,21400855,Oklahoma City Thunder,Phoenix Suns,113,117,230,4,Phoenix Suns,4,0.333,0.9,50,17,6,4,0.346,0.571,52,21,4,9
855,21400856,Cleveland Cavaliers,Indiana Pacers,86,93,179,7,Indiana Pacers,7,0.31,0.786,49,20,3,7,0.353,0.655,48,23,8,7
856,21400857,Washington Wizards,Philadelphia 76ers,81,89,170,8,Philadelphia 76ers,8,0.235,0.773,51,20,4,5,0.364,0.618,53,21,7,4
857,21400858,Orlando Magic,Atlanta Hawks,88,95,183,7,Atlanta Hawks,7,0.346,0.538,40,22,10,7,0.452,0.75,42,27,11,5
858,21400859,Charlotte Hornets,Boston Celtics,98,106,204,8,Boston Celtics,8,0.476,0.824,48,19,8,7,0.4,0.8,47,24,8,5
859,21400860,New York Knicks,Detroit Pistons,121,115,236,6,New York Knicks,6,0.333,0.962,58,28,6,9,0.258,0.725,54,22,3,10
860,21400861,Golden State Warriors,Toronto Raptors,113,89,202,24,Golden State Warriors,24,0.464,0.842,47,31,11,5,0.182,0.821,42,15,6,3
861,21400862,Minnesota Timberwolves,Chicago Bulls,89,96,185,7,Chicago Bulls,7,0.143,0.677,45,17,7,2,0.29,0.813,53,24,5,5
862,21400863,Brooklyn Nets,Houston Rockets,98,102,200,4,Houston Rockets,4,0.235,0.9,44,17,8,4,0.281,0.882,41,26,9,5
863,21400864,Los Angeles Clippers,Memphis Grizzlies,97,79,176,18,Los Angeles Clippers,18,0.346,0.571,47,20,9,10,0.25,0.667,41,19,6,4
864,21400865,Miami Heat,New Orleans Pelicans,102,104,206,2,New Orleans Pelicans,2,0.381,0.75,31,21,3,7,0.375,0.741,37,26,3,6
865,21400866,Utah Jazz,Denver Nuggets,104,82,186,22,Utah Jazz,22,0.429,0.81,43,24,13,15,0.25,0.621,36,22,9,3
866,21400867,San Antonio Spurs,Sacramento Kings,107,96,203,11,San Antonio Spurs,11,0.348,0.906,42,18,8,7,0.25,0.826,47,15,3,2
867,21400868,Milwaukee Bucks,Los Angeles Lakers,93,101,194,8,Los Angeles Lakers,8,0.235,0.724,49,18,7,6,0.333,0.682,50,23,7,5
868,21400869,Oklahoma City Thunder,Portland Trail Blazers,112,115,227,3,Portland Trail Blazers,3,0.286,0.818,47,24,5,4,0.385,0.871,43,20,7,4
869,21400870,Detroit Pistons,Washington Wizards,95,99,194,4,Washington Wizards,4,0.308,0.524,40,18,8,2,0.35,0.72,43,21,14,2
870,21400871,Atlanta Hawks,Miami Heat,93,91,184,2,Atlanta Hawks,2,0.4,0.75,37,23,12,5,0.269,0.952,47,17,12,3
871,21400872,Toronto Raptors,New York Knicks,98,103,201,5,New York Knicks,5,0.276,0.786,40,16,7,4,0.368,0.789,44,21,8,5
872,21400873,Memphis Grizzlies,Minnesota Timberwolves,101,97,198,4,Memphis Grizzlies,4,0.364,0.724,43,21,7,7,0.368,0.815,35,22,12,1
873,21400874,Brooklyn Nets,Dallas Mavericks,104,94,198,10,Brooklyn Nets,10,0.435,0.609,48,20,5,4,0.321,0.833,37,23,10,3
874,21400875,San Antonio Spurs,Phoenix Suns,101,74,175,27,San Antonio Spurs,27,0.211,0.882,56,18,7,6,0.313,0.792,42,13,7,4
875,21400876,Milwaukee Bucks,Utah Jazz,75,82,157,7,Utah Jazz,7,0.333,0.857,39,18,15,4,0.273,0.783,46,18,16,7
876,21400877,Los Angeles Clippers,Chicago Bulls,96,86,182,10,Los Angeles Clippers,10,0.259,0.542,55,15,6,12,0.385,0.733,51,18,2,1
877,21400878,Oklahoma City Thunder,Los Angeles Lakers,108,101,209,7,Oklahoma City Thunder,7,0.344,0.739,55,21,5,6,0.36,0.667,49,25,6,6
878,21400879,Portland Trail Blazers,Sacramento Kings,110,99,209,11,Portland Trail Blazers,11,0.417,0.9,43,19,5,3,0.25,0.783,33,24,8,2
879,21400880,Golden State Warriors,Boston Celtics,106,101,207,5,Golden State Warriors,5,0.353,0.824,55,19,4,8,0.258,0.765,60,21,4,3
880,21400881,Philadelphia 76ers,Indiana Pacers,74,94,168,20,Indiana Pacers,20,0.208,0.647,47,10,8,6,0.167,0.76,53,17,11,9
881,21400882,Charlotte Hornets,Orlando Magic,98,83,181,15,Charlotte Hornets,15,0.444,0.714,47,22,5,4,0.4,0.75,44,16,8,3
882,21400883,Cleveland Cavaliers,Houston Rockets,103,105,208,2,Houston Rockets,2,0.3,0.524,53,19,11,5,0.367,0.788,36,21,11,5
883,21400884,New Orleans Pelicans,Denver Nuggets,99,92,191,7,New Orleans Pelicans,7,0.227,0.733,44,22,7,4,0.273,0.529,44,17,10,3
884,21400885,Toronto Raptors,Philadelphia 76ers,114,103,217,11,Toronto Raptors,11,0.407,0.875,36,24,6,6,0.4,0.684,36,32,6,6
885,21400886,Golden State Warriors,Brooklyn Nets,108,110,218,2,Brooklyn Nets,2,0.367,0.722,50,26,11,7,0.476,0.75,38,20,7,1
886,21400887,Phoenix Suns,Miami Heat,98,115,213,17,Miami Heat,17,0.226,0.658,43,17,7,2,0.5,0.733,45,19,14,4
887,21400888,Los Angeles Clippers,Minnesota Timberwolves,110,105,215,5,Los Angeles Clippers,5,0.364,0.526,43,24,7,3,0.267,0.829,47,25,6,4
888,21400889,New Orleans Pelicans,Dallas Mavericks,93,102,195,9,Dallas Mavericks,9,0.476,0.813,37,19,4,4,0.375,0.909,38,11,7,6
889,21400890,Los Angeles Lakers,Charlotte Hornets,103,104,207,1,Charlotte Hornets,1,0.353,0.905,41,24,6,4,0.385,0.677,42,30,10,5
890,21400891,Boston Celtics,Cleveland Cavaliers,79,110,189,31,Cleveland Cavaliers,31,0.25,0.769,42,23,4,3,0.357,1,52,28,10,6
891,21400892,Houston Rockets,Atlanta Hawks,96,104,200,8,Atlanta Hawks,8,0.341,0.444,41,30,6,6,0.276,0.857,49,23,3,6
892,21400893,Washington Wizards,Chicago Bulls,92,97,189,5,Chicago Bulls,5,0.364,0.737,39,23,10,11,0.31,0.733,47,20,5,7
893,21400894,Utah Jazz,Memphis Grizzlies,93,82,175,11,Utah Jazz,11,0.2,0.842,55,22,7,7,0.273,0.684,37,15,7,4
894,21400895,Milwaukee Bucks,Denver Nuggets,95,106,201,11,Denver Nuggets,11,0.417,0.682,41,21,6,7,0.353,0.8,43,26,8,5
895,21400896,New York Knicks,Indiana Pacers,82,105,187,23,Indiana Pacers,23,0.375,0.696,45,16,6,4,0.455,0.792,40,21,8,8
896,21400897,Phoenix Suns,Orlando Magic,105,100,205,5,Phoenix Suns,5,0.381,0.852,34,22,10,3,0.25,0.867,42,21,13,5
897,21400898,Utah Jazz,Boston Celtics,84,85,169,1,Boston Celtics,1,0.158,0.619,51,21,1,4,0.296,0.55,39,21,5,3
898,21400899,Charlotte Hornets,Brooklyn Nets,115,91,206,24,Charlotte Hornets,24,0.421,0.821,49,24,5,2,0.188,0.75,38,15,6,1
899,21400900,Cleveland Cavaliers,Toronto Raptors,120,112,232,8,Cleveland Cavaliers,8,0.417,0.735,35,27,7,3,0.476,0.941,34,24,5,3
900,21400901,Memphis Grizzlies,Houston Rockets,102,100,202,2,Memphis Grizzlies,2,0.25,0.824,38,27,11,3,0.393,1,40,24,7,5
901,21400902,Denver Nuggets,Minnesota Timberwolves,100,85,185,15,Denver Nuggets,15,0.4,0.8,51,27,8,3,0.167,0.72,43,18,7,5
902,21400903,Detroit Pistons,New Orleans Pelicans,85,88,173,3,New Orleans Pelicans,3,0.143,0.778,52,25,8,7,0.167,0.75,46,18,7,12
903,21400904,Philadelphia 76ers,Oklahoma City Thunder,118,123,241,5,Oklahoma City Thunder,5,0.429,0.795,58,20,8,8,0.333,0.824,54,19,9,9
904,21400905,Los Angeles Lakers,Miami Heat,94,100,194,6,Miami Heat,6,0.389,0.647,42,23,11,1,0.188,0.767,55,16,8,7
905,21400906,Sacramento Kings,San Antonio Spurs,85,112,197,27,San Antonio Spurs,27,0.333,0.706,35,15,14,4,0.435,0.75,44,23,13,10
906,21400907,Milwaukee Bucks,Golden State Warriors,93,102,195,9,Golden State Warriors,9,0.357,0.8,47,17,11,1,0.412,0.56,34,30,16,8
907,21400908,Portland Trail Blazers,Los Angeles Clippers,98,93,191,5,Portland Trail Blazers,5,0.25,0.759,61,19,3,4,0.355,0.444,51,25,6,4
908,21400909,Oklahoma City Thunder,Chicago Bulls,105,108,213,3,Chicago Bulls,3,0.4,0.789,41,20,8,4,0.28,0.808,48,26,4,3
909,21400910,Dallas Mavericks,Portland Trail Blazers,75,94,169,19,Portland Trail Blazers,19,0.125,0.875,41,17,10,3,0.318,0.905,56,20,7,5
910,21400911,Toronto Raptors,Charlotte Hornets,94,103,197,9,Charlotte Hornets,9,0.318,0.867,32,21,5,5,0.25,0.9,56,26,3,5
911,21400912,Chicago Bulls,Indiana Pacers,84,98,182,14,Indiana Pacers,14,0.217,0.895,44,20,5,3,0.3,0.727,51,23,7,4
912,21400913,Sacramento Kings,Orlando Magic,114,119,233,5,Orlando Magic,5,0.37,0.737,43,18,6,6,0.542,0.833,37,29,10,5
913,21400914,Utah Jazz,Philadelphia 76ers,89,83,172,6,Utah Jazz,6,0.5,0.707,49,17,9,5,0.313,0.5,43,22,13,4
914,21400915,Cleveland Cavaliers,Atlanta Hawks,97,106,203,9,Atlanta Hawks,9,0.342,0.788,37,18,7,6,0.286,0.824,38,27,10,4
915,21400916,Phoenix Suns,Brooklyn Nets,108,100,208,8,Phoenix Suns,8,0.115,0.771,51,19,13,2,0.364,0.828,57,21,5,1
916,21400917,Detroit Pistons,Houston Rockets,93,103,196,10,Houston Rockets,10,0.207,0.765,50,20,12,5,0.214,0.84,55,23,6,6
917,21400918,Los Angeles Lakers,Memphis Grizzlies,90,97,187,7,Memphis Grizzlies,7,0.417,0.778,44,22,6,9,0.091,0.848,42,18,7,1
918,21400919,Boston Celtics,New Orleans Pelicans,104,98,202,6,Boston Celtics,6,0.435,0.88,37,19,8,1,0.381,0.933,45,22,5,6
919,21400920,Miami Heat,Washington Wizards,97,99,196,2,Washington Wizards,2,0.37,0.684,37,18,5,2,0.304,0.889,43,24,6,4
920,21400921,Denver Nuggets,San Antonio Spurs,111,120,231,9,San Antonio Spurs,9,0.353,0.652,38,21,7,3,0.375,0.758,36,24,8,8
921,21400922,Dallas Mavericks,Golden State Warriors,89,104,193,15,Golden State Warriors,15,0.3,0.731,34,17,15,1,0.478,0.895,51,28,5,11
922,21400923,Memphis Grizzlies,New Orleans Pelicans,89,95,184,6,New Orleans Pelicans,6,0.375,0.655,39,26,15,7,0.348,0.846,41,24,8,13
923,21400924,Phoenix Suns,Cleveland Cavaliers,79,89,168,10,Cleveland Cavaliers,10,0.36,0.714,43,20,6,4,0.4,0.826,46,22,5,1
924,21400925,Sacramento Kings,Miami Heat,109,114,223,5,Miami Heat,5,0.4,0.792,46,26,7,4,0.292,0.758,34,23,13,8
925,21400926,Indiana Pacers,New York Knicks,92,86,178,6,Indiana Pacers,6,0.389,0.833,45,16,5,3,0.2,0.767,41,13,4,4
926,21400927,Atlanta Hawks,Philadelphia 76ers,84,92,176,8,Philadelphia 76ers,8,0.44,0.813,42,20,8,9,0.351,0.529,55,24,14,3
927,21400928,Portland Trail Blazers,Minnesota Timberwolves,113,121,234,8,Minnesota Timberwolves,8,0.519,0.765,36,18,3,3,0.571,0.806,45,26,7,3
928,21400929,Washington Wizards,Milwaukee Bucks,85,91,176,6,Milwaukee Bucks,6,0.321,0.636,49,19,9,3,0.5,0.6,44,25,7,6
929,21400930,Houston Rockets,Denver Nuggets,114,100,214,14,Houston Rockets,14,0.357,0.75,48,25,11,2,0.3,0.789,44,23,16,8
930,21400931,Chicago Bulls,San Antonio Spurs,105,116,221,11,San Antonio Spurs,11,0.333,0.897,44,20,6,6,0.409,0.792,35,14,15,4
931,21400932,Los Angeles Clippers,Golden State Warriors,98,106,204,8,Golden State Warriors,8,0.32,0.714,39,25,8,3,0.455,0.696,37,23,13,3
932,21400933,Utah Jazz,Brooklyn Nets,95,88,183,7,Utah Jazz,7,0.455,0.81,43,24,6,4,0.533,0.364,30,21,9,2
933,21400934,Charlotte Hornets,Detroit Pistons,108,101,209,7,Charlotte Hornets,7,0.353,0.87,39,32,6,5,0.214,0.8,42,21,8,3
934,21400935,Boston Celtics,Orlando Magic,98,103,201,5,Orlando Magic,5,0.441,0.813,48,24,9,3,0.318,0.667,56,20,8,8
935,21400936,Toronto Raptors,Oklahoma City Thunder,104,108,212,4,Oklahoma City Thunder,4,0.407,1,33,24,12,3,0.286,0.72,49,30,6,10
936,21400937,Dallas Mavericks,Los Angeles Lakers,100,93,193,7,Dallas Mavericks,7,0.346,0.682,33,21,10,7,0.143,0.714,47,23,5,5
937,21400938,Washington Wizards,Charlotte Hornets,95,69,164,26,Washington Wizards,26,0.143,1,49,21,10,4,0.182,0.75,37,13,4,8
938,21400939,Sacramento Kings,Atlanta Hawks,105,130,235,25,Atlanta Hawks,25,0.4,0.95,40,21,10,2,0.556,0.571,33,42,8,6
939,21400940,Boston Celtics,Miami Heat,100,90,190,10,Boston Celtics,10,0.24,0.941,43,17,7,2,0.235,0.824,32,15,5,2
940,21400941,Memphis Grizzlies,Chicago Bulls,101,91,192,10,Memphis Grizzlies,10,0.357,0.706,40,25,13,5,0.455,0.786,44,18,7,2
941,21400942,New Orleans Pelicans,Milwaukee Bucks,114,103,217,11,New Orleans Pelicans,11,0.6,0.81,34,26,7,4,0.267,0.806,25,20,11,5
942,21400943,New York Knicks,Denver Nuggets,78,106,184,28,Denver Nuggets,28,0.385,0.6,45,21,3,10,0.333,0.759,48,21,6,4
943,21400944,Golden State Warriors,Phoenix Suns,98,80,178,18,Golden State Warriors,18,0.419,0.789,48,17,11,8,0.364,0.783,37,13,11,1
944,21400945,Minnesota Timberwolves,Los Angeles Clippers,76,89,165,13,Los Angeles Clippers,13,0.25,0.571,50,25,12,2,0.355,0.533,42,30,11,2
945,21400946,Orlando Magic,Indiana Pacers,86,118,204,32,Indiana Pacers,32,0.235,0.7,45,15,9,7,0.5,0.917,49,37,6,5
946,21400947,New Orleans Pelicans,Brooklyn Nets,111,91,202,20,New Orleans Pelicans,20,0.571,0.818,41,31,10,4,0.375,0.652,41,19,5,5
947,21400948,Cleveland Cavaliers,Dallas Mavericks,127,94,221,33,Cleveland Cavaliers,33,0.469,0.828,50,25,11,5,0.25,0.697,42,18,6,6
948,21400949,Toronto Raptors,San Antonio Spurs,107,117,224,10,San Antonio Spurs,10,0.308,0.722,46,19,6,5,0.611,0.8,45,24,7,3
949,21400950,New York Knicks,Utah Jazz,82,87,169,5,Utah Jazz,5,0.385,0.882,38,17,5,5,0.333,0.724,40,16,8,5
950,21400951,Detroit Pistons,Los Angeles Lakers,85,93,178,8,Los Angeles Lakers,8,0.229,0.684,42,20,10,8,0.231,0.867,46,23,8,1
951,21400952,Sacramento Kings,Charlotte Hornets,113,106,219,7,Sacramento Kings,7,0.4,0.833,43,25,4,3,0.333,0.615,44,28,5,12
952,21400953,Chicago Bulls,Philadelphia 76ers,104,95,199,9,Chicago Bulls,9,0.417,0.7,58,24,6,2,0.268,0.48,55,16,12,5
953,21400954,Memphis Grizzlies,Boston Celtics,92,95,187,3,Boston Celtics,3,0.417,1,41,21,11,4,0.296,0.765,36,28,11,5
954,21400955,Brooklyn Nets,Miami Heat,98,104,202,6,Miami Heat,6,0.353,0.718,44,15,8,2,0.286,0.632,39,23,14,3
955,21400956,Orlando Magic,Milwaukee Bucks,91,97,188,6,Milwaukee Bucks,6,0.556,1,33,21,14,4,0.444,0.688,51,30,7,7
956,21400957,Los Angeles Clippers,Oklahoma City Thunder,120,108,228,12,Los Angeles Clippers,12,0.5,0.745,38,22,11,2,0.48,0.833,39,19,5,3
957,21400958,Atlanta Hawks,Denver Nuggets,102,115,217,13,Denver Nuggets,13,0.333,0.926,32,18,11,3,0.419,0.9,44,28,8,9
958,21400959,Minnesota Timberwolves,Phoenix Suns,97,106,203,9,Phoenix Suns,9,0.077,0.923,34,19,5,2,0.25,0.769,45,25,7,2
959,21400960,Detroit Pistons,Golden State Warriors,98,105,203,7,Golden State Warriors,7,0.333,0.833,49,18,6,5,0.35,0.769,42,29,5,6
960,21400961,Houston Rockets,Portland Trail Blazers,100,105,205,5,Portland Trail Blazers,5,0.355,0.565,40,21,12,5,0.303,0.786,60,25,5,2
961,21400962,Milwaukee Bucks,Indiana Pacers,103,109,212,6,Indiana Pacers,6,0.286,0.806,48,17,11,3,0.409,0.786,48,24,7,7
962,21400963,Memphis Grizzlies,Washington Wizards,87,107,194,20,Washington Wizards,20,0.158,0.733,41,18,9,3,0.294,0.71,42,25,11,5
963,21400964,Cleveland Cavaliers,San Antonio Spurs,128,125,253,3,Cleveland Cavaliers,3,0.538,0.867,37,19,8,2,0.308,0.704,41,28,6,9
964,21400965,Houston Rockets,Utah Jazz,91,109,200,18,Utah Jazz,18,0.219,0.667,37,19,8,2,0.333,0.588,57,23,5,10
965,21400966,New York Knicks,Los Angeles Lakers,101,94,195,7,New York Knicks,7,0.5,0.769,33,27,5,9,0.278,0.619,51,18,6,4
966,21400967,Chicago Bulls,Charlotte Hornets,91,101,192,10,Charlotte Hornets,10,0.469,0.737,36,18,4,6,0.368,0.848,55,15,4,7
967,21400968,Sacramento Kings,Philadelphia 76ers,107,114,221,7,Philadelphia 76ers,7,0.286,0.825,50,22,9,4,0.281,0.652,46,30,11,9
968,21400969,Orlando Magic,Boston Celtics,88,95,183,7,Boston Celtics,7,0.3,0.5,50,20,9,4,0.385,0.55,47,19,7,4
969,21400970,Miami Heat,Toronto Raptors,92,102,194,10,Toronto Raptors,10,0.217,0.708,44,21,11,5,0.364,0.71,43,26,12,5
970,21400971,Minnesota Timberwolves,Oklahoma City Thunder,99,113,212,14,Oklahoma City Thunder,14,0.25,0.903,42,20,8,6,0.458,1,48,28,10,4
971,21400972,Los Angeles Clippers,Dallas Mavericks,99,129,228,30,Dallas Mavericks,30,0.375,0.417,32,27,9,2,0.571,0.688,43,31,11,2
972,21400973,Golden State Warriors,Denver Nuggets,103,114,217,11,Denver Nuggets,11,0.421,0.773,35,29,5,10,0.471,0.649,52,23,4,3
973,21400974,Atlanta Hawks,Phoenix Suns,96,87,183,9,Atlanta Hawks,9,0.444,0.833,38,22,11,6,0.385,0.619,45,19,7,6
974,21400975,Detroit Pistons,Portland Trail Blazers,99,118,217,19,Portland Trail Blazers,19,0.28,0.833,36,23,5,2,0.524,0.882,43,28,2,2
975,21400976,Boston Celtics,Indiana Pacers,93,89,182,4,Boston Celtics,4,0.286,0.714,47,28,7,4,0.375,0.8,42,16,4,3
976,21400977,Sacramento Kings,Washington Wizards,97,113,210,16,Washington Wizards,16,0.316,0.75,36,24,4,3,0.5,0.824,41,28,8,6
977,21400978,Brooklyn Nets,Philadelphia 76ers,94,87,181,7,Brooklyn Nets,7,0.118,0.692,45,20,9,5,0.216,0.643,48,21,7,8
978,21400979,Milwaukee Bucks,Memphis Grizzlies,83,96,179,13,Memphis Grizzlies,13,0.263,0.667,37,17,6,3,0.571,0.875,36,23,10,3
979,21400980,Detroit Pistons,Utah Jazz,85,88,173,3,Utah Jazz,3,0.348,0.591,44,18,8,3,0.429,0.667,45,17,8,8
980,21400981,New York Knicks,Golden State Warriors,94,125,219,31,Golden State Warriors,31,0.36,0.563,51,25,6,10,0.559,0.941,42,34,13,6
981,21400982,Chicago Bulls,Oklahoma City Thunder,100,109,209,9,Oklahoma City Thunder,9,0.31,0.708,33,20,5,3,0.381,0.7,52,16,4,4
982,21400983,Houston Rockets,Los Angeles Clippers,100,98,198,2,Houston Rockets,2,0.233,0.806,43,17,7,3,0.462,0.583,50,24,8,8
983,21400984,Denver Nuggets,New Orleans Pelicans,118,111,229,7,Denver Nuggets,7,0.323,0.8,52,25,9,4,0.273,0.619,58,32,3,14
984,21400985,Cleveland Cavaliers,Orlando Magic,123,108,231,15,Cleveland Cavaliers,15,0.514,0.789,34,26,9,6,0.474,0.556,44,24,10,1
985,21400986,Minnesota Timberwolves,San Antonio Spurs,97,123,220,26,San Antonio Spurs,26,0.467,0.778,40,25,8,2,0.545,0.867,42,38,13,6
986,21400987,Portland Trail Blazers,Toronto Raptors,113,97,210,16,Portland Trail Blazers,16,0.448,0.625,37,27,6,5,0.278,0.783,42,20,5,3
987,21400988,New York Knicks,Phoenix Suns,89,102,191,13,Phoenix Suns,13,0.357,0.667,35,22,10,2,0.333,0.609,51,24,9,1
988,21400989,Atlanta Hawks,Los Angeles Lakers,91,86,177,5,Atlanta Hawks,5,0.217,0.667,34,25,9,6,0.389,0.733,54,21,6,4
989,21400990,Toronto Raptors,Indiana Pacers,117,98,215,19,Toronto Raptors,19,0.522,0.818,51,19,3,4,0.105,0.8,36,21,7,4
990,21400991,Portland Trail Blazers,Washington Wizards,97,105,202,8,Washington Wizards,8,0.286,0.85,48,19,2,3,0.583,0.615,43,25,5,4
991,21400992,Philadelphia 76ers,Boston Celtics,89,108,197,19,Boston Celtics,19,0.333,0.542,40,20,7,4,0.4,0.8,42,27,7,3
992,21400993,Denver Nuggets,Memphis Grizzlies,81,92,173,11,Memphis Grizzlies,11,0.444,0.619,37,14,13,5,0.222,0.857,57,14,9,5
993,21400994,Brooklyn Nets,Minnesota Timberwolves,122,106,228,16,Brooklyn Nets,16,0.385,0.765,43,21,8,2,0.6,0.882,36,27,6,7
994,21400995,Cleveland Cavaliers,Miami Heat,92,106,198,14,Miami Heat,14,0.333,0.778,32,17,8,4,0.267,0.818,45,21,8,5
995,21400996,Oklahoma City Thunder,Dallas Mavericks,115,119,234,4,Dallas Mavericks,4,0.269,0.8,59,19,8,4,0.4,0.714,37,27,9,2
996,21400997,Charlotte Hornets,Utah Jazz,66,94,160,28,Utah Jazz,28,0.263,0.833,36,9,5,4,0.625,0.684,61,19,3,5
997,21400998,Atlanta Hawks,Sacramento Kings,110,103,213,7,Atlanta Hawks,7,0.387,0.733,39,25,11,5,0.35,0.8,45,23,7,5
998,21400999,Los Angeles Lakers,Golden State Warriors,105,108,213,3,Golden State Warriors,3,0.533,0.905,45,24,11,5,0.259,0.913,37,28,16,7
999,21401000,Memphis Grizzlies,Detroit Pistons,95,105,200,10,Detroit Pistons,10,0.556,0.882,42,28,9,2,0.364,0.682,38,26,5,5
1000,21401001,San Antonio Spurs,New York Knicks,100,104,204,4,New York Knicks,4,0.214,0.833,49,17,7,5,0.214,0.704,50,22,7,10
1001,21401002,Orlando Magic,Houston Rockets,94,107,201,13,Houston Rockets,13,0.273,0.706,40,19,8,6,0.407,0.667,47,27,7,6
1002,21401003,Milwaukee Bucks,New Orleans Pelicans,84,85,169,1,New Orleans Pelicans,1,0.2,0.762,49,20,4,12,0.32,0.731,50,26,6,6
1003,21401004,Charlotte Hornets,Los Angeles Clippers,92,99,191,7,Los Angeles Clippers,7,0.357,0.793,43,20,6,4,0.375,0.714,44,24,7,4
1004,21401005,Brooklyn Nets,Cleveland Cavaliers,92,117,209,25,Cleveland Cavaliers,25,0.25,0.714,32,23,7,5,0.517,0.6,43,32,2,3
1005,21401006,Detroit Pistons,Philadelphia 76ers,83,94,177,11,Philadelphia 76ers,11,0.308,0.895,51,18,8,7,0.407,0.611,42,25,12,10
1006,21401007,Portland Trail Blazers,Miami Heat,104,108,212,4,Miami Heat,4,0.385,0.571,45,22,3,2,0.7,0.643,35,21,7,7
1007,21401008,Minnesota Timberwolves,Toronto Raptors,100,105,205,5,Toronto Raptors,5,0.353,0.667,45,21,7,4,0.414,0.852,39,25,6,3
1008,21401009,Indiana Pacers,Chicago Bulls,86,103,189,17,Chicago Bulls,17,0.316,0.762,38,16,3,8,0.417,0.893,52,22,6,4
1009,21401010,San Antonio Spurs,Milwaukee Bucks,114,103,217,11,San Antonio Spurs,11,0.4,0.789,34,27,9,6,0.5,0.75,43,28,5,4
1010,21401011,Boston Celtics,Oklahoma City Thunder,118,122,240,4,Oklahoma City Thunder,4,0.382,0.607,39,32,10,5,0.263,0.846,46,19,12,2
1011,21401012,Orlando Magic,Dallas Mavericks,102,107,209,5,Dallas Mavericks,5,0.321,0.929,41,28,12,5,0.419,0.667,40,28,7,6
1012,21401013,Los Angeles Clippers,Sacramento Kings,116,105,221,11,Los Angeles Clippers,11,0.459,0.692,36,27,5,6,0.176,0.813,44,18,7,0
1013,21401014,Atlanta Hawks,Golden State Warriors,95,114,209,19,Golden State Warriors,19,0.364,0.833,44,24,14,4,0.467,0.6,44,39,8,7
1014,21401015,Washington Wizards,Utah Jazz,88,84,172,4,Washington Wizards,4,0.545,0.696,41,16,4,3,0.182,0.5,36,21,9,5
1015,21401016,Minnesota Timberwolves,New York Knicks,95,92,187,3,Minnesota Timberwolves,3,0.167,0.833,43,12,10,8,0.2,0.8,49,22,9,5
1016,21401017,Denver Nuggets,Houston Rockets,108,118,226,10,Houston Rockets,10,0.361,0.579,42,23,8,3,0.4,0.8,49,27,8,4
1017,21401018,New Orleans Pelicans,Phoenix Suns,72,74,146,2,Phoenix Suns,2,0.278,0.5,45,19,4,4,0.091,0.667,57,11,5,8
1018,21401019,Utah Jazz,Los Angeles Lakers,80,73,153,7,Utah Jazz,7,0.36,0.677,36,19,11,8,0.273,0.471,43,20,9,3
1019,21401020,Portland Trail Blazers,Orlando Magic,104,111,215,7,Orlando Magic,7,0.292,0.875,44,13,4,2,0.417,0.833,50,22,9,1
1020,21401021,New York Knicks,Philadelphia 76ers,81,97,178,16,Philadelphia 76ers,16,0.5,0.885,37,16,7,8,0.367,0.8,49,23,11,7
1021,21401022,Milwaukee Bucks,Brooklyn Nets,127,129,256,2,Brooklyn Nets,2,0.5,0.724,81,23,11,9,0.44,0.765,53,31,9,7
1022,21401023,Indiana Pacers,Cleveland Cavaliers,92,95,187,3,Cleveland Cavaliers,3,0.4,0.923,42,23,5,6,0.346,0.762,45,18,4,6
1023,21401024,Denver Nuggets,Miami Heat,91,108,199,17,Miami Heat,17,0.259,0.526,35,21,11,7,0.438,0.789,44,23,8,7
1024,21401025,Toronto Raptors,Chicago Bulls,92,108,200,16,Chicago Bulls,16,0.4,0.846,36,20,6,4,0.321,0.882,47,32,4,7
1025,21401026,Atlanta Hawks,Oklahoma City Thunder,115,123,238,8,Oklahoma City Thunder,8,0.448,0.8,34,20,9,4,0.433,0.923,44,26,6,6
1026,21401027,Memphis Grizzlies,Dallas Mavericks,112,101,213,11,Memphis Grizzlies,11,0.444,0.688,38,19,7,3,0.364,0.694,41,14,6,3
1027,21401028,Boston Celtics,San Antonio Spurs,89,101,190,12,San Antonio Spurs,12,0.25,0.7,47,19,10,2,0.217,0.87,45,31,11,4
1028,21401029,Charlotte Hornets,Sacramento Kings,91,101,192,10,Sacramento Kings,10,0.333,0.813,36,16,10,3,0.429,0.72,48,21,4,3
1029,21401030,New Orleans Pelicans,Golden State Warriors,96,112,208,16,Golden State Warriors,16,0.5,0.864,42,22,4,3,0.263,0.826,42,29,9,6
1030,21401031,Washington Wizards,Los Angeles Clippers,99,113,212,14,Los Angeles Clippers,14,0.316,0.826,36,27,6,2,0.522,0.647,46,33,5,6
1031,21401032,Brooklyn Nets,Indiana Pacers,123,111,234,12,Brooklyn Nets,12,0.5,0.806,35,21,4,4,0.348,0.722,39,22,3,2
1032,21401033,Chicago Bulls,Detroit Pistons,91,107,198,16,Detroit Pistons,16,0.286,0.792,45,22,2,1,0.423,0.8,44,28,9,6
1033,21401034,Phoenix Suns,Houston Rockets,117,102,219,15,Phoenix Suns,15,0.533,0.708,49,20,10,5,0.294,0.833,36,28,7,5
1034,21401035,Portland Trail Blazers,Memphis Grizzlies,86,97,183,11,Memphis Grizzlies,11,0.273,0.933,44,15,6,3,0.611,0.75,45,21,10,1
1035,21401036,Utah Jazz,Golden State Warriors,91,106,197,15,Golden State Warriors,15,0.455,0.81,35,19,5,2,0.444,0.846,37,25,11,3
1036,21401037,Cleveland Cavaliers,Milwaukee Bucks,108,90,198,18,Cleveland Cavaliers,18,0.419,0.688,36,22,14,1,0.25,0.786,39,23,10,5
1037,21401038,Miami Heat,Oklahoma City Thunder,75,93,168,18,Oklahoma City Thunder,18,0.167,0.533,41,13,7,6,0.333,0.538,51,25,11,7
1038,21401039,San Antonio Spurs,Atlanta Hawks,114,95,209,19,San Antonio Spurs,19,0.412,0.882,43,30,8,4,0.5,1,29,25,13,2
1039,21401040,New Orleans Pelicans,Los Angeles Clippers,100,107,207,7,Los Angeles Clippers,7,0.545,0.75,41,21,7,4,0.304,0.696,42,25,10,7
1040,21401041,New York Knicks,Toronto Raptors,89,106,195,17,Toronto Raptors,17,0.421,0.688,38,24,9,4,0.364,0.828,44,22,4,1
1041,21401042,Washington Wizards,Sacramento Kings,86,109,195,23,Sacramento Kings,23,0.176,0.722,44,21,7,3,0.471,0.913,34,24,12,2
1042,21401043,Detroit Pistons,Boston Celtics,105,97,202,8,Detroit Pistons,8,0.346,0.6,56,24,5,10,0.296,0.765,59,24,7,5
1043,21401044,Denver Nuggets,Orlando Magic,119,100,219,19,Denver Nuggets,19,0.429,0.767,49,30,11,6,0.235,0.824,40,26,7,4
1044,21401045,Charlotte Hornets,Minnesota Timberwolves,109,98,207,11,Charlotte Hornets,11,0.333,0.813,42,21,8,3,0.364,0.75,32,24,5,1
1045,21401046,Dallas Mavericks,Phoenix Suns,92,98,190,6,Phoenix Suns,6,0.263,0.591,40,21,9,1,0.286,0.609,49,22,10,7
1046,21401047,Philadelphia 76ers,Los Angeles Lakers,87,101,188,14,Los Angeles Lakers,14,0.333,0.667,39,22,4,6,0.357,0.818,52,21,4,9
1047,21401048,Houston Rockets,Indiana Pacers,110,100,210,10,Houston Rockets,10,0.542,0.946,35,16,11,5,0.333,0.632,40,21,7,5
1048,21401049,Boston Celtics,Brooklyn Nets,110,91,201,19,Boston Celtics,19,0.273,0.714,47,25,7,4,0.059,0.867,48,15,7,5
1049,21401050,Memphis Grizzlies,New York Knicks,103,82,185,21,Memphis Grizzlies,21,0.583,0.737,39,22,4,2,0.222,0.824,37,22,4,6
1050,21401051,Charlotte Hornets,Chicago Bulls,86,98,184,12,Chicago Bulls,12,0.4,0.786,51,11,2,8,0.188,0.724,46,21,5,7
1051,21401052,Minnesota Timberwolves,Utah Jazz,106,104,210,2,Minnesota Timberwolves,2,0.632,0.8,37,19,10,4,0.321,0.613,46,21,11,11
1052,21401053,Washington Wizards,Golden State Warriors,76,107,183,31,Golden State Warriors,31,0.273,0.731,38,15,5,2,0.394,0.762,62,23,9,6
1053,21401054,Toronto Raptors,Detroit Pistons,104,108,212,4,Detroit Pistons,4,0.304,0.931,43,19,2,4,0.414,0.667,42,26,5,3
1054,21401055,Miami Heat,Milwaukee Bucks,88,89,177,1,Milwaukee Bucks,1,0.421,0.778,34,18,11,4,0.235,0.765,53,25,8,9
1055,21401056,Los Angeles Lakers,Oklahoma City Thunder,117,127,244,10,Oklahoma City Thunder,10,0.474,0.741,28,22,10,7,0.524,0.87,49,29,7,2
1056,21401057,San Antonio Spurs,Dallas Mavericks,94,101,195,7,Dallas Mavericks,7,0.286,0.778,43,16,12,5,0.318,0.769,49,21,6,2
1057,21401058,Philadelphia 76ers,Sacramento Kings,106,107,213,1,Sacramento Kings,1,0.464,0.619,44,18,6,11,0.35,0.789,50,21,10,9
1058,21401059,Golden State Warriors,Portland Trail Blazers,122,108,230,14,Golden State Warriors,14,0.462,0.909,46,37,4,5,0.441,0.789,35,23,9,2
1059,21401060,Brooklyn Nets,Charlotte Hornets,91,88,179,3,Brooklyn Nets,3,0.214,0.909,46,28,6,8,0.25,0.65,51,23,4,7
1060,21401061,Los Angeles Clippers,New York Knicks,111,80,191,31,Los Angeles Clippers,31,0.393,0.667,39,31,12,7,0.217,0.895,34,14,8,3
1061,21401062,Atlanta Hawks,Orlando Magic,95,83,178,12,Atlanta Hawks,12,0.323,0.7,45,21,9,8,0.188,0.8,42,19,7,3
1062,21401063,Indiana Pacers,Washington Wizards,103,101,204,2,Indiana Pacers,2,0.346,0.643,43,21,7,2,0.357,0.789,46,13,6,4
1063,21401064,Miami Heat,Boston Celtics,93,86,179,7,Miami Heat,7,0.375,0.696,38,23,7,6,0.263,0.676,43,16,8,4
1064,21401065,Chicago Bulls,Toronto Raptors,116,103,219,13,Chicago Bulls,13,0.522,0.824,31,26,4,6,0.429,0.842,35,16,6,1
1065,21401066,Cleveland Cavaliers,Memphis Grizzlies,111,89,200,22,Cleveland Cavaliers,22,0.412,0.846,49,30,6,5,0.235,0.688,32,18,9,6
1066,21401067,Los Angeles Lakers,Minnesota Timberwolves,101,99,200,2,Los Angeles Lakers,2,0.231,0.944,48,21,8,4,0.273,0.9,40,14,8,5
1067,21401068,Houston Rockets,New Orleans Pelicans,95,93,188,2,Houston Rockets,2,0.273,0.75,43,29,7,4,0.333,0.625,37,20,8,9
1068,21401069,Philadelphia 76ers,Denver Nuggets,99,85,184,14,Philadelphia 76ers,14,0.412,0.682,49,17,14,12,0.276,0.704,49,13,8,4
1069,21401070,Portland Trail Blazers,Utah Jazz,92,89,181,3,Portland Trail Blazers,3,0.259,0.85,45,19,4,5,0.25,0.652,43,12,11,2
1070,21401071,Oklahoma City Thunder,San Antonio Spurs,91,130,221,39,San Antonio Spurs,39,0.333,0.929,37,16,7,1,0.619,0.789,49,28,7,4
1071,21401072,Sacramento Kings,Phoenix Suns,108,99,207,9,Sacramento Kings,9,0.381,0.87,43,27,8,3,0.24,0.654,46,16,10,6
1072,21401073,Indiana Pacers,Milwaukee Bucks,107,111,218,4,Milwaukee Bucks,4,0.467,0.767,41,18,7,4,0.474,0.706,30,26,10,3
1073,21401074,Detroit Pistons,Orlando Magic,111,97,208,14,Detroit Pistons,14,0.389,0.741,41,22,10,6,0.2,1,40,31,3,2
1074,21401075,Los Angeles Clippers,Philadelphia 76ers,119,98,217,21,Los Angeles Clippers,21,0.414,0.613,56,28,8,2,0.355,0.556,40,17,11,1
1075,21401076,Charlotte Hornets,Washington Wizards,107,110,217,3,Washington Wizards,3,0.32,0.771,61,25,11,11,0.36,0.591,72,25,9,9
1076,21401077,Miami Heat,Atlanta Hawks,86,99,185,13,Atlanta Hawks,13,0.314,0.733,41,20,9,6,0.333,0.792,38,31,12,4
1077,21401078,Cleveland Cavaliers,Brooklyn Nets,98,106,204,8,Brooklyn Nets,8,0.267,0.8,40,17,10,4,0.391,0.895,46,21,6,1
1078,21401079,Boston Celtics,New York Knicks,96,92,188,4,Boston Celtics,4,0.2,0.791,44,18,6,1,0.292,0.643,36,23,9,2
1079,21401080,Los Angeles Lakers,Toronto Raptors,83,94,177,11,Toronto Raptors,11,0.235,0.724,46,14,6,2,0.389,0.714,40,25,8,4
1080,21401081,Minnesota Timberwolves,Houston Rockets,110,120,230,10,Houston Rockets,10,0.429,0.882,31,26,6,1,0.455,0.706,41,34,10,6
1081,21401082,Golden State Warriors,Memphis Grizzlies,107,84,191,23,Golden State Warriors,23,0.516,0.765,43,28,15,5,0.385,0.733,40,19,9,2
1082,21401083,Sacramento Kings,New Orleans Pelicans,88,102,190,14,New Orleans Pelicans,14,0.467,0.611,37,14,5,4,0.45,0.583,47,25,5,9
1083,21401084,Dallas Mavericks,San Antonio Spurs,76,94,170,18,San Antonio Spurs,18,0.222,0.667,47,15,9,4,0.346,0.786,50,28,8,4
1084,21401085,Utah Jazz,Denver Nuggets,91,107,198,16,Denver Nuggets,16,0.185,0.71,42,20,12,7,0.542,0.696,41,23,8,4
1085,21401086,Portland Trail Blazers,Phoenix Suns,87,81,168,6,Portland Trail Blazers,6,0.269,0.444,54,15,4,4,0.3,0.917,48,14,5,1
1086,21401087,Atlanta Hawks,Charlotte Hornets,100,115,215,15,Charlotte Hornets,15,0.5,0.786,36,32,6,4,0.462,0.864,42,28,4,6
1087,21401088,New York Knicks,Chicago Bulls,80,111,191,31,Chicago Bulls,31,0.235,0.842,35,22,7,7,0.353,0.864,51,28,8,5
1088,21401089,Golden State Warriors,Milwaukee Bucks,108,95,203,13,Golden State Warriors,13,0.48,0.857,45,27,7,8,0.133,0.844,42,24,14,5
1089,21401090,Oklahoma City Thunder,Utah Jazz,89,94,183,5,Utah Jazz,5,0.375,0.656,48,14,5,4,0.207,0.686,42,12,14,8
1090,21401091,Denver Nuggets,Portland Trail Blazers,114,120,234,6,Portland Trail Blazers,6,0.375,0.864,39,24,12,1,0.444,0.889,45,29,8,5
1091,21401092,Philadelphia 76ers,Cleveland Cavaliers,86,87,173,1,Cleveland Cavaliers,1,0.333,0.533,45,18,11,0,0.391,0.667,53,17,7,2
1092,21401093,Los Angeles Lakers,Brooklyn Nets,99,107,206,8,Brooklyn Nets,8,0.333,0.818,43,25,7,4,0.286,0.714,43,29,11,6
1093,21401094,Minnesota Timberwolves,New Orleans Pelicans,88,110,198,22,New Orleans Pelicans,22,0.167,0.917,39,17,5,4,0.462,0.75,35,29,12,9
1094,21401095,Los Angeles Clippers,Boston Celtics,119,106,225,13,Los Angeles Clippers,13,0.406,0.6,53,28,5,5,0.258,0.87,40,29,8,1
1095,21401096,Detroit Pistons,Miami Heat,102,109,211,7,Miami Heat,7,0.32,0.636,37,24,5,5,0.389,0.828,46,20,4,1
1096,21401097,Houston Rockets,Washington Wizards,99,91,190,8,Houston Rockets,8,0.31,0.667,53,18,12,6,0.267,0.784,43,17,14,5
1097,21401098,Memphis Grizzlies,San Antonio Spurs,89,103,192,14,San Antonio Spurs,14,0.429,0.917,34,22,5,1,0.235,0.833,48,25,9,6
1098,21401099,Dallas Mavericks,Indiana Pacers,99,104,203,5,Indiana Pacers,5,0.4,0.684,41,20,5,3,0.588,0.692,43,23,6,6
1099,21401100,Oklahoma City Thunder,Phoenix Suns,109,97,206,12,Oklahoma City Thunder,12,0.385,0.731,48,16,9,4,0.227,0.75,40,23,9,4
1100,21401101,Boston Celtics,Charlotte Hornets,116,104,220,12,Boston Celtics,12,0.346,0.739,42,28,7,1,0.269,0.895,40,20,3,6
1101,21401102,Los Angeles Lakers,Philadelphia 76ers,113,111,224,2,Los Angeles Lakers,2,0.476,0.767,45,27,7,10,0.333,0.605,51,27,11,1
1102,21401103,Milwaukee Bucks,Atlanta Hawks,88,101,189,13,Atlanta Hawks,13,0.235,0.696,39,26,4,2,0.31,0.833,42,29,5,4
1103,21401104,Houston Rockets,Toronto Raptors,96,99,195,3,Toronto Raptors,3,0.296,0.581,41,21,7,3,0.364,0.778,48,20,9,7
1104,21401105,Sacramento Kings,Memphis Grizzlies,83,97,180,14,Memphis Grizzlies,14,0.313,0.6,41,16,4,3,0.348,0.765,45,23,7,11
1105,21401106,Utah Jazz,Minnesota Timberwolves,104,84,188,20,Utah Jazz,20,0.303,0.889,47,18,8,6,0.375,0.815,34,21,5,4
1106,21401107,Phoenix Suns,Portland Trail Blazers,86,109,195,23,Portland Trail Blazers,23,0.188,0.7,38,18,6,2,0.444,0.9,47,26,6,5
1107,21401108,Indiana Pacers,Brooklyn Nets,106,111,217,5,Brooklyn Nets,5,0.522,0.833,37,23,3,6,0.5,0.786,41,25,5,3
1108,21401109,Atlanta Hawks,Detroit Pistons,95,105,200,10,Detroit Pistons,10,0.32,0.7,43,25,8,0,0.379,0.706,38,26,11,6
1109,21401110,San Antonio Spurs,Miami Heat,95,81,176,14,San Antonio Spurs,14,0.444,0.765,38,21,11,6,0.333,1,33,11,9,4
1110,21401111,Golden State Warriors,Los Angeles Clippers,110,106,216,4,Golden State Warriors,4,0.381,0.765,43,28,6,1,0.273,0.848,41,19,4,8
1111,21401112,Detroit Pistons,Charlotte Hornets,78,102,180,24,Charlotte Hornets,24,0.227,0.611,51,24,6,4,0.409,0.708,55,21,10,7
1112,21401113,San Antonio Spurs,Orlando Magic,103,91,194,12,San Antonio Spurs,12,0.448,0.87,49,20,8,3,0.294,0.889,50,24,7,7
1113,21401114,Philadelphia 76ers,Washington Wizards,93,106,199,13,Washington Wizards,13,0.294,0.647,34,18,10,3,0.333,0.636,47,33,7,4
1114,21401115,Indiana Pacers,Boston Celtics,87,100,187,13,Boston Celtics,13,0.4,0.565,39,17,5,3,0.222,0.889,46,29,9,2
1115,21401116,Brooklyn Nets,New York Knicks,100,98,198,2,Brooklyn Nets,2,0.563,0.75,37,24,8,7,0.478,0.867,40,20,6,4
1116,21401117,Sacramento Kings,Houston Rockets,111,115,226,4,Houston Rockets,4,0.5,0.5,57,30,9,9,0.45,0.6,42,24,14,13
1117,21401118,Chicago Bulls,Milwaukee Bucks,91,95,186,4,Milwaukee Bucks,4,0.192,0.649,40,18,11,3,0.381,0.722,48,15,11,5
1118,21401119,Toronto Raptors,Minnesota Timberwolves,113,99,212,14,Toronto Raptors,14,0.433,0.696,34,25,8,3,0.357,0.632,32,21,7,5
1119,21401120,Dallas Mavericks,Oklahoma City Thunder,135,131,266,4,Dallas Mavericks,4,0.267,0.792,34,35,8,1,0.452,0.818,46,23,4,1
1120,21401121,Denver Nuggets,Utah Jazz,84,98,182,14,Utah Jazz,14,0.212,0.917,39,13,7,5,0.391,0.625,49,24,5,8
1121,21401122,Los Angeles Clippers,Portland Trail Blazers,126,122,248,4,Los Angeles Clippers,4,0.536,0.792,40,30,6,3,0.52,0.76,43,25,4,3
1122,21401123,New Orleans Pelicans,Los Angeles Lakers,113,92,205,21,New Orleans Pelicans,21,0.563,0.762,40,31,3,7,0.313,0.619,35,22,4,2
1123,21401124,Miami Heat,Cleveland Cavaliers,88,114,202,26,Cleveland Cavaliers,26,0.333,0.81,36,25,8,2,0.429,0.76,43,23,12,7
1124,21401125,Houston Rockets,Dallas Mavericks,108,101,209,7,Houston Rockets,7,0.355,0.725,55,24,9,2,0.308,0.704,41,23,6,5
1125,21401126,Phoenix Suns,Golden State Warriors,106,107,213,1,Golden State Warriors,1,0.263,0.654,47,25,6,3,0.385,0.647,50,29,6,5
1126,21401127,Charlotte Hornets,Indiana Pacers,74,93,167,19,Indiana Pacers,19,0.222,0.7,42,15,10,5,0.5,0.722,55,20,13,4
1127,21401128,New York Knicks,Washington Wizards,87,101,188,14,Washington Wizards,14,0.333,0.9,42,17,6,5,0.438,0.667,48,32,8,8
1128,21401129,Milwaukee Bucks,Boston Celtics,110,101,211,9,Milwaukee Bucks,9,0.375,0.611,45,31,10,6,0.333,0.938,41,19,7,2
1129,21401130,Toronto Raptors,Brooklyn Nets,109,114,223,5,Brooklyn Nets,5,0.308,0.739,40,24,5,1,0.313,0.739,41,21,10,1
1130,21401131,Detroit Pistons,Chicago Bulls,82,88,170,6,Chicago Bulls,6,0.316,0.8,42,14,9,12,0.235,0.857,44,18,9,5
1131,21401132,Oklahoma City Thunder,Memphis Grizzlies,92,100,192,8,Memphis Grizzlies,8,0.235,0.615,47,18,7,3,0.19,0.714,45,16,7,7
1132,21401133,Orlando Magic,Minnesota Timberwolves,97,84,181,13,Orlando Magic,13,0.286,0.647,53,23,12,1,0.091,0.781,30,15,8,6
1133,21401134,Denver Nuggets,San Antonio Spurs,93,123,216,30,San Antonio Spurs,30,0.353,0.636,34,17,8,3,0.412,0.882,45,33,11,8
1134,21401135,New Orleans Pelicans,Sacramento Kings,101,95,196,6,New Orleans Pelicans,6,0.483,0.679,50,20,4,5,0.353,0.6,38,21,4,6
1135,21401136,Portland Trail Blazers,Los Angeles Lakers,107,77,184,30,Portland Trail Blazers,30,0.385,1,53,21,7,6,0.357,0.588,43,13,4,6
1136,21401137,Philadelphia 76ers,Charlotte Hornets,91,92,183,1,Charlotte Hornets,1,0.423,0.727,40,13,4,14,0.077,0.913,44,13,5,5
1137,21401138,Brooklyn Nets,Atlanta Hawks,99,131,230,32,Atlanta Hawks,32,0.435,0.647,39,22,7,2,0.515,0.842,34,40,15,4
1138,21401139,Miami Heat,Detroit Pistons,98,99,197,1,Detroit Pistons,1,0.25,0.731,37,19,6,7,0.462,0.652,33,20,6,3
1139,21401140,Boston Celtics,Toronto Raptors,117,116,233,1,Boston Celtics,1,0.308,0.682,44,26,10,4,0.261,0.789,46,15,7,4
1140,21401141,Washington Wizards,Memphis Grizzlies,92,83,175,9,Washington Wizards,9,0.364,0.8,40,24,9,0,0.067,0.778,41,23,2,3
1141,21401142,Golden State Warriors,Dallas Mavericks,123,110,233,13,Golden State Warriors,13,0.389,0.719,55,28,12,4,0.188,0.722,44,14,6,2
1142,21401143,Orlando Magic,Milwaukee Bucks,97,90,187,7,Orlando Magic,7,0.381,0.692,45,23,7,10,0.313,0.538,45,26,8,6
1143,21401144,Los Angeles Clippers,Denver Nuggets,107,92,199,15,Los Angeles Clippers,15,0.382,0.619,47,24,9,7,0.273,0.71,44,21,7,1
1144,21401145,Utah Jazz,Phoenix Suns,85,87,172,2,Phoenix Suns,2,0.333,0.833,47,17,10,2,0.357,0.759,32,12,11,7
1145,21401146,New Orleans Pelicans,Portland Trail Blazers,90,99,189,9,Portland Trail Blazers,9,0.438,0.5,35,18,8,5,0.375,0.913,51,17,4,3
1146,21401147,Houston Rockets,Oklahoma City Thunder,115,112,227,3,Houston Rockets,3,0.286,0.62,42,18,14,4,0.467,0.692,51,21,4,2
1147,21401148,Chicago Bulls,Cleveland Cavaliers,94,99,193,5,Cleveland Cavaliers,5,0.407,0.714,45,28,7,2,0.432,0.591,40,24,9,4
1148,21401149,Miami Heat,Indiana Pacers,89,112,201,23,Indiana Pacers,23,0.1,0.684,37,15,7,7,0.467,0.667,55,23,6,7
1149,21401150,Golden State Warriors,San Antonio Spurs,92,107,199,15,San Antonio Spurs,15,0.321,0.5,39,25,4,2,0.333,0.8,47,27,8,4
1150,21401151,Philadelphia 76ers,New York Knicks,91,101,192,10,New York Knicks,10,0.313,0.625,36,22,8,5,0.231,0.828,49,24,6,14
1151,21401152,Utah Jazz,Sacramento Kings,101,95,196,6,Utah Jazz,6,0.333,0.722,47,18,11,6,0.333,0.583,43,20,13,3
1152,21401153,Los Angeles Clippers,Los Angeles Lakers,106,78,184,28,Los Angeles Clippers,28,0.556,0.611,40,27,10,1,0.412,0.591,41,17,3,3
1153,21401154,Phoenix Suns,Atlanta Hawks,69,96,165,27,Atlanta Hawks,27,0.2,0.722,37,16,5,6,0.16,0.714,54,21,9,4
1154,21401155,Charlotte Hornets,Miami Heat,100,105,205,5,Miami Heat,5,0.278,0.81,45,12,8,5,0.2,0.786,42,20,4,6
1155,21401156,Golden State Warriors,New Orleans Pelicans,100,103,203,3,New Orleans Pelicans,3,0.409,0.7,50,25,6,12,0.474,0.733,45,25,8,8
1156,21401157,San Antonio Spurs,Oklahoma City Thunder,113,88,201,25,San Antonio Spurs,25,0.417,0.692,46,27,7,7,0.263,0.536,39,14,13,3
1157,21401158,Minnesota Timberwolves,Sacramento Kings,111,116,227,5,Sacramento Kings,5,0.316,0.714,36,29,6,4,0.375,0.676,49,25,5,7
1158,21401159,Los Angeles Lakers,Los Angeles Clippers,100,105,205,5,Los Angeles Clippers,5,0.36,0.778,43,24,2,1,0.292,0.667,46,25,6,6
1159,21401160,Toronto Raptors,Charlotte Hornets,92,74,166,18,Toronto Raptors,18,0.444,0.737,47,20,5,9,0.455,0.727,35,15,4,5
1160,21401161,Chicago Bulls,Orlando Magic,103,105,208,2,Orlando Magic,2,0.462,0.742,41,25,9,4,0.348,0.875,44,21,8,3
1161,21401162,Washington Wizards,Philadelphia 76ers,119,90,209,29,Washington Wizards,29,0.533,0.739,45,35,4,8,0.333,0.704,36,17,11,1
1162,21401163,Atlanta Hawks,Brooklyn Nets,114,111,225,3,Atlanta Hawks,3,0.393,0.68,40,35,11,4,0.269,0.88,47,27,7,4
1163,21401164,Boston Celtics,Detroit Pistons,113,103,216,10,Boston Celtics,10,0.286,0.971,37,20,12,2,0.389,0.6,41,29,7,5
1164,21401165,Indiana Pacers,New York Knicks,102,86,188,16,Indiana Pacers,16,0.182,0.815,54,23,7,4,0.412,0.808,34,13,8,2
1165,21401166,New Orleans Pelicans,Memphis Grizzlies,74,110,184,36,Memphis Grizzlies,36,0.286,0.667,39,13,8,3,0.471,0.857,52,27,7,3
1166,21401167,Cleveland Cavaliers,Milwaukee Bucks,104,99,203,5,Cleveland Cavaliers,5,0.324,0.808,44,23,8,5,0.333,0.692,32,30,13,3
1167,21401168,Houston Rockets,San Antonio Spurs,98,110,208,12,San Antonio Spurs,12,0.4,0.625,39,25,7,3,0.333,0.778,47,21,11,7
1168,21401169,Los Angeles Lakers,Denver Nuggets,101,119,220,18,Denver Nuggets,18,0.313,0.686,39,15,7,2,0.433,0.75,45,26,7,6
1169,21401170,Sacramento Kings,Utah Jazz,91,103,194,12,Utah Jazz,12,0.438,0.643,31,19,9,1,0.419,0.72,47,23,5,8
1170,21401171,Phoenix Suns,Dallas Mavericks,104,107,211,3,Dallas Mavericks,3,0.32,0.842,37,22,6,5,0.222,0.813,47,18,3,3
1171,21401172,Minnesota Timberwolves,Portland Trail Blazers,91,116,207,25,Portland Trail Blazers,25,0.273,0.828,35,16,12,2,0.364,0.87,53,25,8,2
1172,21401173,Chicago Bulls,Miami Heat,89,78,167,11,Chicago Bulls,11,0.261,0.765,51,17,10,2,0.278,0.714,46,14,2,7
1173,21401174,Portland Trail Blazers,Golden State Warriors,105,116,221,11,Golden State Warriors,11,0.292,0.75,41,28,6,5,0.462,0.889,44,27,6,5
1174,21401175,Toronto Raptors,Orlando Magic,101,99,200,2,Toronto Raptors,2,0.3,0.933,46,22,8,1,0.35,1,46,21,11,4
1175,21401176,Charlotte Hornets,Atlanta Hawks,80,104,184,24,Atlanta Hawks,24,0.267,0.667,46,21,8,3,0.357,0.75,44,31,10,4
1176,21401177,Washington Wizards,Brooklyn Nets,80,117,197,37,Brooklyn Nets,37,0.333,0.647,50,23,3,4,0.6,0.652,44,29,10,1
1177,21401178,Boston Celtics,Cleveland Cavaliers,99,90,189,9,Boston Celtics,9,0.364,0.714,43,30,11,2,0.265,0.68,42,25,4,2
1178,21401179,Indiana Pacers,Detroit Pistons,107,103,210,4,Indiana Pacers,4,0.579,0.909,42,29,6,1,0.478,0.522,45,25,5,5
1179,21401180,Milwaukee Bucks,New York Knicks,99,91,190,8,Milwaukee Bucks,8,0.353,0.655,33,18,17,3,0.385,0.75,42,22,7,5
1180,21401181,San Antonio Spurs,Houston Rockets,104,103,207,1,San Antonio Spurs,1,0.235,0.75,40,23,12,3,0.429,0.604,39,19,9,5
1181,21401182,Phoenix Suns,New Orleans Pelicans,75,90,165,15,New Orleans Pelicans,15,0.28,0.8,43,18,9,4,0.263,0.579,56,29,4,13
1182,21401183,Sacramento Kings,Oklahoma City Thunder,103,116,219,13,Oklahoma City Thunder,13,0.375,0.714,50,19,4,6,0.323,0.75,47,21,8,4
1183,21401184,Dallas Mavericks,Denver Nuggets,144,143,287,1,Dallas Mavericks,1,0.379,0.792,49,39,8,6,0.349,0.88,61,29,10,1
1184,21401185,Memphis Grizzlies,Utah Jazz,89,88,177,1,Memphis Grizzlies,1,0.333,0.632,36,22,8,1,0.478,0.682,39,16,4,3
1185,21401186,Minnesota Timberwolves,Los Angeles Lakers,98,106,204,8,Los Angeles Lakers,8,0.2,0.912,39,17,7,3,0.391,0.625,46,35,6,2
1186,21401187,New York Knicks,Orlando Magic,80,79,159,1,New York Knicks,1,0.3,0.923,46,22,3,6,0.273,0.722,49,15,10,4
1187,21401188,Toronto Raptors,Miami Heat,107,104,211,3,Toronto Raptors,3,0.346,0.757,47,12,7,3,0.3,0.545,47,14,3,8
1188,21401189,Philadelphia 76ers,Chicago Bulls,107,114,221,7,Chicago Bulls,7,0.317,0.8,47,19,5,3,0.346,0.694,48,20,8,5
1189,21401190,Memphis Grizzlies,Los Angeles Clippers,86,94,180,8,Los Angeles Clippers,8,0.222,0.667,43,24,8,4,0.222,0.818,43,25,10,6
1190,21401191,Utah Jazz,Portland Trail Blazers,111,105,216,6,Utah Jazz,6,0.353,0.786,48,20,9,4,0.2,0.773,39,22,11,4
1191,21401192,Minnesota Timberwolves,Golden State Warriors,101,110,211,9,Golden State Warriors,9,0.458,0.769,40,27,9,4,0.355,0.714,50,28,10,5
1192,21401193,Brooklyn Nets,Milwaukee Bucks,73,96,169,23,Milwaukee Bucks,23,0.167,0.727,49,17,9,5,0.3,0.667,47,30,13,7
1193,21401194,Cleveland Cavaliers,Boston Celtics,78,117,195,39,Boston Celtics,39,0.136,0.684,44,18,1,5,0.417,0.682,38,29,20,1
1194,21401195,Charlotte Hornets,Detroit Pistons,77,116,193,39,Detroit Pistons,39,0.267,0.655,33,16,8,2,0.571,0.783,56,33,6,4
1195,21401196,Sacramento Kings,Denver Nuggets,111,122,233,11,Denver Nuggets,11,0.278,0.714,32,28,13,0,0.346,0.767,42,32,15,1
1196,21401197,Oklahoma City Thunder,Indiana Pacers,104,116,220,12,Indiana Pacers,12,0.393,0.393,43,18,5,4,0.5,0.629,52,25,4,3
1197,21401198,Atlanta Hawks,Washington Wizards,99,108,207,9,Washington Wizards,9,0.31,0.75,38,24,10,2,0.429,0.778,51,22,8,6
1198,21401199,New Orleans Pelicans,Houston Rockets,114,121,235,7,Houston Rockets,7,0.407,0.682,39,22,6,2,0.375,0.708,40,16,6,6
1199,21401200,Phoenix Suns,San Antonio Spurs,91,107,198,16,San Antonio Spurs,16,0.25,0.739,41,17,6,3,0.421,0.853,43,22,7,6
1200,21401201,Dallas Mavericks,Los Angeles Lakers,120,106,226,14,Dallas Mavericks,14,0.476,0.769,42,31,7,9,0.375,0.806,37,20,4,4
1201,21401202,Houston Rockets,Charlotte Hornets,100,90,190,10,Houston Rockets,10,0.257,0.808,49,19,9,10,0.406,0.529,43,23,8,5
1202,21401203,Detroit Pistons,Cleveland Cavaliers,97,109,206,12,Cleveland Cavaliers,12,0.36,0.6,31,21,4,4,0.531,0.5,45,30,5,7
1203,21401204,Milwaukee Bucks,Philadelphia 76ers,107,97,204,10,Milwaukee Bucks,10,0.444,0.639,39,23,13,7,0.214,0.794,40,22,11,6
1204,21401205,New York Knicks,Atlanta Hawks,112,108,220,4,New York Knicks,4,0.52,0.684,39,33,7,7,0.344,0.826,37,27,10,3
1205,21401206,Chicago Bulls,Brooklyn Nets,113,86,199,27,Chicago Bulls,27,0.4,0.765,46,26,7,8,0.25,0.864,42,12,2,3
1206,21401207,Orlando Magic,Miami Heat,93,100,193,7,Miami Heat,7,0.286,0.607,41,14,10,4,0.3,0.826,50,21,2,9
1207,21401208,New Orleans Pelicans,Minnesota Timberwolves,100,88,188,12,New Orleans Pelicans,12,0.286,0.833,39,15,6,9,0.286,0.786,43,19,1,10
1208,21401209,Portland Trail Blazers,Oklahoma City Thunder,90,101,191,11,Oklahoma City Thunder,11,0.348,0.667,35,22,1,4,0.19,0.704,58,14,8,6
1209,21401210,Dallas Mavericks,Utah Jazz,92,109,201,17,Utah Jazz,17,0.45,0.652,41,18,4,4,0.393,0.615,48,24,10,6
1210,21401211,Los Angeles Lakers,Sacramento Kings,92,102,194,10,Sacramento Kings,10,0.267,0.615,49,19,8,3,0.25,0.778,41,22,4,6
1211,21401212,Memphis Grizzlies,Golden State Warriors,107,111,218,4,Golden State Warriors,4,0.333,0.8,44,24,11,4,0.542,0.741,39,30,9,7
1212,21401213,Denver Nuggets,Los Angeles Clippers,103,110,213,7,Los Angeles Clippers,7,0.364,0.682,58,18,7,0,0.333,0.784,47,25,7,8
1213,21401214,Toronto Raptors,Boston Celtics,93,95,188,2,Boston Celtics,2,0.375,0.7,43,17,9,9,0.222,0.867,50,24,7,6
1214,21401215,Washington Wizards,Indiana Pacers,95,99,194,4,Indiana Pacers,4,0.292,0.824,59,22,8,2,0.3,0.588,56,22,5,9
1215,21401216,Los Angeles Clippers,Phoenix Suns,112,101,213,11,Los Angeles Clippers,11,0.395,0.722,44,26,10,5,0.423,0.6,39,25,8,3
1216,21401217,Atlanta Hawks,Chicago Bulls,85,91,176,6,Chicago Bulls,6,0.276,0.714,42,15,10,10,0.292,0.846,50,14,11,9
1217,21401218,Portland Trail Blazers,Dallas Mavericks,98,114,212,16,Dallas Mavericks,16,0.28,0.833,45,20,7,4,0.36,0.794,54,18,9,5
1218,21401219,Utah Jazz,Houston Rockets,91,117,208,26,Houston Rockets,26,0.185,0.556,44,23,12,6,0.429,0.676,49,28,9,13
1219,21401220,Indiana Pacers,Memphis Grizzlies,83,95,178,12,Memphis Grizzlies,12,0.333,0.733,36,15,7,8,0.222,0.808,48,12,10,3
1220,21401221,Boston Celtics,Milwaukee Bucks,105,100,205,5,Boston Celtics,5,0.433,0.571,38,37,9,5,0.333,0.688,48,35,7,2
1221,21401222,Oklahoma City Thunder,Minnesota Timberwolves,138,113,251,25,Oklahoma City Thunder,25,0.429,0.71,46,22,10,6,0.316,0.829,39,22,12,4
1222,21401223,San Antonio Spurs,New Orleans Pelicans,103,108,211,5,New Orleans Pelicans,5,0.3,0.769,36,33,2,3,0.5,0.68,35,23,11,7
1223,21401224,Orlando Magic,Brooklyn Nets,88,101,189,13,Brooklyn Nets,13,0.35,0.385,42,18,6,4,0.375,0.609,40,25,8,5
1224,21401225,Washington Wizards,Cleveland Cavaliers,108,113,221,5,Cleveland Cavaliers,5,0.364,0.762,50,26,8,5,0.533,0.647,44,29,7,4
1225,21401226,Detroit Pistons,New York Knicks,112,90,202,22,Detroit Pistons,22,0.385,0.741,44,20,14,3,0.368,0.63,40,19,6,3
1226,21401227,Miami Heat,Philadelphia 76ers,105,101,206,4,Miami Heat,4,0.387,0.75,42,22,10,2,0.172,0.8,45,26,7,5
1227,21401228,Charlotte Hornets,Toronto Raptors,87,92,179,5,Toronto Raptors,5,0.364,0.938,36,15,8,3,0.364,1,32,27,8,3
1228,21401229,Denver Nuggets,Golden State Warriors,126,133,259,7,Golden State Warriors,7,0.333,0.833,40,28,10,4,0.464,0.765,41,30,11,6
1229,21401230,Sacramento Kings,Los Angeles Lakers,122,99,221,23,Sacramento Kings,23,0.471,0.537,42,30,10,4,0.292,0.8,46,22,6,8
1230,21500001,Detroit Pistons,Atlanta Hawks,106,94,200,12,Detroit Pistons,12,0.414,0.769,59,23,5,3,0.296,0.8,40,22,9,4
1231,21500002,Cleveland Cavaliers,Chicago Bulls,95,97,192,2,Chicago Bulls,2,0.31,0.588,50,26,5,7,0.368,0.696,47,13,6,10
1232,21500003,New Orleans Pelicans,Golden State Warriors,95,111,206,16,Golden State Warriors,16,0.333,0.704,33,21,9,3,0.3,0.909,56,29,8,7
1233,21500004,Washington Wizards,Orlando Magic,88,87,175,1,Washington Wizards,1,0.25,0.6,49,17,8,9,0.192,0.667,56,20,9,6
1234,21500005,Philadelphia 76ers,Boston Celtics,95,112,207,17,Boston Celtics,17,0.318,0.87,46,12,11,6,0.333,0.963,41,31,10,7
1235,21500006,Chicago Bulls,Brooklyn Nets,115,100,215,15,Chicago Bulls,15,0.5,0.85,39,20,9,3,0,0.786,45,19,11,5
1236,21500007,Utah Jazz,Detroit Pistons,87,92,179,5,Detroit Pistons,5,0.167,0.714,38,15,4,5,0.368,0.735,43,16,2,4
1237,21500008,Charlotte Hornets,Miami Heat,94,104,198,10,Miami Heat,10,0.25,0.759,43,16,4,1,0.6,0.952,41,23,5,7
1238,21500009,Indiana Pacers,Toronto Raptors,99,106,205,7,Toronto Raptors,7,0.391,0.839,40,23,14,3,0.389,0.692,50,19,8,2
1239,21500010,Denver Nuggets,Houston Rockets,105,85,190,20,Denver Nuggets,20,0.481,0.667,49,26,9,10,0.229,0.654,44,17,13,8
1240,21500011,Cleveland Cavaliers,Memphis Grizzlies,106,76,182,30,Cleveland Cavaliers,30,0.448,0.647,54,29,7,2,0.125,0.727,40,15,8,3
1241,21500012,New York Knicks,Milwaukee Bucks,122,97,219,25,New York Knicks,25,0.391,0.829,49,24,11,7,0.5,0.903,47,17,7,4
1242,21500013,San Antonio Spurs,Oklahoma City Thunder,106,112,218,6,Oklahoma City Thunder,6,0.333,0.846,36,22,11,9,0.368,0.955,45,21,7,4
1243,21500014,Dallas Mavericks,Phoenix Suns,111,95,206,16,Dallas Mavericks,16,0.476,0.677,48,24,7,3,0.25,0.636,53,15,3,3
1244,21500015,New Orleans Pelicans,Portland Trail Blazers,94,112,206,18,Portland Trail Blazers,18,0.333,0.611,39,19,7,2,0.375,0.857,51,22,7,4
1245,21500016,Los Angeles Clippers,Sacramento Kings,111,104,215,7,Los Angeles Clippers,7,0.316,0.677,42,20,8,9,0.458,0.611,49,24,8,3
1246,21500017,Minnesota Timberwolves,Los Angeles Lakers,112,111,223,1,Minnesota Timberwolves,1,0.25,0.838,39,24,3,4,0.265,0.914,48,18,2,4
1247,21500018,Memphis Grizzlies,Indiana Pacers,112,103,215,9,Memphis Grizzlies,9,0.438,0.793,42,26,12,5,0.4,0.708,38,23,7,4
1248,21500019,Atlanta Hawks,New York Knicks,112,101,213,11,Atlanta Hawks,11,0.417,0.692,39,26,11,4,0.207,0.905,48,21,10,4
1249,21500020,Dallas Mavericks,Los Angeles Clippers,88,104,192,16,Los Angeles Clippers,16,0.2,0.8,55,22,4,2,0.258,0.606,53,21,6,8
1250,21500021,Miami Heat,Cleveland Cavaliers,92,102,194,10,Cleveland Cavaliers,10,0.286,0.909,38,21,5,7,0.24,0.857,49,25,4,4
1251,21500022,Oklahoma City Thunder,Orlando Magic,139,136,275,3,Oklahoma City Thunder,3,0.296,0.816,62,19,8,9,0.364,0.789,49,25,10,10
1252,21500023,Utah Jazz,Philadelphia 76ers,99,71,170,28,Utah Jazz,28,0.538,0.8,51,19,10,9,0.4,0.73,39,15,4,5
1253,21500024,Toronto Raptors,Boston Celtics,113,103,216,10,Toronto Raptors,10,0.423,0.857,53,23,11,3,0.269,0.78,38,23,14,3
1254,21500025,Chicago Bulls,Detroit Pistons,94,98,192,4,Detroit Pistons,4,0.318,0.731,50,18,8,8,0.214,0.5,61,18,9,2
1255,21500026,Charlotte Hornets,Atlanta Hawks,94,97,191,3,Atlanta Hawks,3,0.4,0.769,54,23,7,6,0.348,0.773,45,23,9,4
1256,21500027,Washington Wizards,Milwaukee Bucks,118,113,231,5,Washington Wizards,5,0.571,0.818,37,25,7,5,0.292,0.786,32,33,9,2
1257,21500028,Brooklyn Nets,San Antonio Spurs,75,102,177,27,San Antonio Spurs,27,0.313,0.533,32,17,6,6,0.409,1,56,23,7,4
1258,21500029,Minnesota Timberwolves,Denver Nuggets,95,78,173,17,Minnesota Timberwolves,17,0.182,0.805,49,18,7,6,0.2,0.75,51,15,7,4
1259,21500030,Golden State Warriors,Houston Rockets,112,92,204,20,Golden State Warriors,20,0.346,0.68,47,26,9,4,0.217,0.75,49,19,3,9
1260,21500031,Los Angeles Lakers,Sacramento Kings,114,132,246,18,Sacramento Kings,18,0.324,0.778,37,20,7,9,0.273,0.733,56,26,6,7
1261,21500032,Portland Trail Blazers,Phoenix Suns,92,110,202,18,Phoenix Suns,18,0.375,0.789,42,17,9,5,0.222,0.762,55,17,13,7
1262,21500033,Utah Jazz,Indiana Pacers,97,76,173,21,Utah Jazz,21,0.4,0.722,47,15,13,4,0.235,0.762,34,10,8,7
1263,21500034,New York Knicks,Washington Wizards,117,110,227,7,New York Knicks,7,0.474,0.813,40,21,8,5,0.273,0.848,43,17,9,3
1264,21500035,Golden State Warriors,New Orleans Pelicans,134,120,254,14,Golden State Warriors,14,0.567,0.714,38,26,10,4,0.364,0.87,48,22,4,4
1265,21500036,Brooklyn Nets,Memphis Grizzlies,91,101,192,10,Memphis Grizzlies,10,0.231,0.667,43,21,3,3,0.391,0.857,42,26,6,2
1266,21500037,Phoenix Suns,Portland Trail Blazers,101,90,191,11,Phoenix Suns,11,0.344,0.75,48,16,11,6,0.267,0.571,45,20,7,5
1267,21500038,Sacramento Kings,Los Angeles Clippers,109,114,223,5,Los Angeles Clippers,5,0.333,0.68,49,20,9,2,0.235,0.696,41,25,4,9
1268,21500039,Atlanta Hawks,Charlotte Hornets,94,92,186,2,Atlanta Hawks,2,0.241,0.929,48,22,9,6,0.378,0.933,45,27,7,13
1269,21500040,San Antonio Spurs,Boston Celtics,95,87,182,8,San Antonio Spurs,8,0.263,0.72,51,22,10,6,0.207,0.786,45,21,10,5
1270,21500041,Houston Rockets,Miami Heat,89,109,198,20,Miami Heat,20,0.278,0.833,34,20,9,3,0.409,0.762,48,24,11,5
1271,21500042,Milwaukee Bucks,Toronto Raptors,87,106,193,19,Toronto Raptors,19,0.263,1,33,21,6,8,0.44,0.65,46,22,12,3
1272,21500043,Orlando Magic,Chicago Bulls,87,92,179,5,Chicago Bulls,5,0.304,0.588,43,21,7,11,0.25,0.864,47,23,7,8
1273,21500044,Denver Nuggets,Oklahoma City Thunder,93,117,210,24,Oklahoma City Thunder,24,0.346,0.737,35,20,8,3,0.52,0.778,50,32,9,10
1274,21500045,Dallas Mavericks,Los Angeles Lakers,103,93,196,10,Dallas Mavericks,10,0.367,0.75,49,28,5,4,0.294,0.75,42,18,8,9
1275,21500046,Cleveland Cavaliers,Philadelphia 76ers,107,100,207,7,Cleveland Cavaliers,7,0.364,0.75,43,28,5,9,0.292,0.739,37,22,7,5
1276,21500047,Milwaukee Bucks,Brooklyn Nets,103,96,199,7,Milwaukee Bucks,7,0.391,0.692,36,24,6,7,0.316,0.818,35,21,3,4
1277,21500048,San Antonio Spurs,New York Knicks,94,84,178,10,San Antonio Spurs,10,0.308,0.706,45,21,6,7,0.308,0.762,49,17,8,3
1278,21500049,Oklahoma City Thunder,Houston Rockets,105,110,215,5,Houston Rockets,5,0.435,0.682,55,17,7,9,0.31,0.655,34,22,18,7
1279,21500050,Portland Trail Blazers,Minnesota Timberwolves,106,101,207,5,Portland Trail Blazers,5,0.3,0.75,46,18,5,6,0.231,0.769,41,22,10,4
1280,21500051,Memphis Grizzlies,Golden State Warriors,69,119,188,50,Golden State Warriors,50,0.13,0.7,44,21,8,7,0.44,0.733,65,32,8,13
1281,21500052,Phoenix Suns,Los Angeles Clippers,96,102,198,6,Los Angeles Clippers,6,0.3,0.714,55,23,8,1,0.308,0.87,46,20,4,5
1282,21500053,Chicago Bulls,Charlotte Hornets,105,130,235,25,Charlotte Hornets,25,0.467,0.375,33,26,5,0,0.609,0.957,52,26,6,4
1283,21500054,Indiana Pacers,Detroit Pistons,94,82,176,12,Indiana Pacers,12,0.304,0.917,42,21,15,5,0.227,0.647,50,14,8,5
1284,21500055,Atlanta Hawks,Miami Heat,98,92,190,6,Atlanta Hawks,6,0.333,0.773,51,25,10,1,0.179,0.688,49,13,10,9
1285,21500056,Orlando Magic,New Orleans Pelicans,103,94,197,9,Orlando Magic,9,0.389,1,55,24,5,3,0.333,0.72,46,23,12,9
1286,21500057,Toronto Raptors,Dallas Mavericks,102,91,193,11,Toronto Raptors,11,0.294,0.885,47,18,8,6,0.304,0.72,44,20,5,3
1287,21500058,Memphis Grizzlies,Sacramento Kings,103,89,192,14,Memphis Grizzlies,14,0.15,0.8,50,23,5,7,0.35,0.6,35,17,8,1
1288,21500059,Denver Nuggets,Los Angeles Lakers,120,109,229,11,Denver Nuggets,11,0.35,0.871,49,30,5,7,0.231,0.816,40,18,9,4
1289,21500060,Boston Celtics,Indiana Pacers,98,100,198,2,Indiana Pacers,2,0.37,0.818,49,20,7,5,0.348,0.759,53,18,10,1
1290,21500061,San Antonio Spurs,Washington Wizards,99,102,201,3,Washington Wizards,3,0.318,0.9,49,21,5,3,0.348,0.714,33,27,11,3
1291,21500062,Brooklyn Nets,Atlanta Hawks,87,101,188,14,Atlanta Hawks,14,0.238,0.769,43,24,9,4,0.364,0.792,34,27,15,10
1292,21500063,New York Knicks,Cleveland Cavaliers,86,96,182,10,Cleveland Cavaliers,10,0.333,0.8,40,16,6,7,0.259,0.719,48,21,5,2
1293,21500064,Orlando Magic,Houston Rockets,114,119,233,5,Houston Rockets,5,0.35,0.789,38,28,12,6,0.324,0.706,48,28,8,1
1294,21500065,Philadelphia 76ers,Milwaukee Bucks,87,91,178,4,Milwaukee Bucks,4,0.214,0.867,51,23,4,9,0.348,0.765,36,24,6,4
1295,21500066,Toronto Raptors,Oklahoma City Thunder,103,98,201,5,Toronto Raptors,5,0.357,0.821,45,12,14,3,0.348,0.857,41,26,8,10
1296,21500067,Sacramento Kings,Phoenix Suns,97,118,215,21,Phoenix Suns,21,0.458,0.5,33,25,9,4,0.609,0.636,41,27,14,4
1297,21500068,Portland Trail Blazers,Utah Jazz,108,92,200,16,Portland Trail Blazers,16,0.44,0.469,48,11,5,7,0.208,0.636,40,9,12,8
1298,21500069,Los Angeles Clippers,Golden State Warriors,108,112,220,4,Golden State Warriors,4,0.364,0.636,41,24,6,4,0.385,0.774,42,28,6,5
1299,21500070,Oklahoma City Thunder,Chicago Bulls,98,104,202,6,Chicago Bulls,6,0.385,0.85,44,21,2,8,0.389,0.81,47,20,3,7
1300,21500071,Miami Heat,Minnesota Timberwolves,96,84,180,12,Miami Heat,12,0.286,0.72,42,14,6,6,0.333,0.909,44,16,7,6
1301,21500072,Charlotte Hornets,Dallas Mavericks,108,94,202,14,Charlotte Hornets,14,0.222,0.824,48,19,8,6,0.207,0.889,44,17,8,2
1302,21500073,Utah Jazz,Denver Nuggets,96,84,180,12,Utah Jazz,12,0.458,0.647,43,23,6,6,0.25,0.676,45,16,4,6
1303,21500074,Memphis Grizzlies,Portland Trail Blazers,96,115,211,19,Portland Trail Blazers,19,0.35,0.714,36,20,4,5,0.5,0.6,47,29,3,3
1304,21500075,Toronto Raptors,Orlando Magic,87,92,179,5,Orlando Magic,5,0.217,0.759,44,13,5,5,0.36,0.773,40,22,4,4
1305,21500076,Washington Wizards,Boston Celtics,98,118,216,20,Boston Celtics,20,0.32,0.783,45,23,10,8,0.4,0.783,53,24,18,5
1306,21500077,Los Angeles Lakers,Brooklyn Nets,104,98,202,6,Los Angeles Lakers,6,0.304,0.775,40,14,9,6,0.158,0.75,46,21,6,6
1307,21500078,Philadelphia 76ers,Cleveland Cavaliers,102,108,210,6,Cleveland Cavaliers,6,0.435,0.667,38,23,9,4,0.385,0.667,45,29,9,0
1308,21500079,Milwaukee Bucks,New York Knicks,99,92,191,7,Milwaukee Bucks,7,0.214,0.897,41,21,6,5,0.167,0.786,43,20,3,5
1309,21500080,Miami Heat,Indiana Pacers,87,90,177,3,Indiana Pacers,3,0.3,0.692,40,21,5,6,0.333,0.542,43,21,4,5
1310,21500081,Atlanta Hawks,New Orleans Pelicans,121,115,236,6,Atlanta Hawks,6,0.429,0.857,41,30,10,6,0.333,0.875,32,30,9,7
1311,21500082,Detroit Pistons,Phoenix Suns,100,92,192,8,Detroit Pistons,8,0.364,0.5,47,15,8,3,0.333,0.615,46,14,8,3
1312,21500083,Denver Nuggets,Golden State Warriors,104,119,223,15,Golden State Warriors,15,0.333,0.818,44,23,13,5,0.459,0.556,53,40,10,6
1313,21500084,Houston Rockets,Sacramento Kings,116,110,226,6,Houston Rockets,6,0.417,0.778,49,23,8,4,0.321,0.724,43,26,14,3
1314,21500085,Minnesota Timberwolves,Chicago Bulls,102,93,195,9,Minnesota Timberwolves,9,0.438,0.63,58,26,8,7,0.344,0.696,50,20,7,6
1315,21500086,Washington Wizards,Atlanta Hawks,99,114,213,15,Atlanta Hawks,15,0.333,0.882,41,27,11,3,0.394,1,39,37,12,4
1316,21500087,Orlando Magic,Philadelphia 76ers,105,97,202,8,Orlando Magic,8,0.462,0.875,41,24,10,7,0.333,0.538,38,24,6,10
1317,21500088,New Orleans Pelicans,Dallas Mavericks,98,107,205,9,Dallas Mavericks,9,0.321,0.846,42,21,7,6,0.375,0.818,42,20,5,2
1318,21500089,Brooklyn Nets,Milwaukee Bucks,86,94,180,8,Milwaukee Bucks,8,0.333,0.789,52,18,11,3,0.4,0.75,41,27,9,6
1319,21500090,Charlotte Hornets,San Antonio Spurs,94,114,208,20,San Antonio Spurs,20,0.316,0.645,33,15,7,0,0.429,0.652,42,35,11,3
1320,21500091,Memphis Grizzlies,Utah Jazz,79,89,168,10,Utah Jazz,10,0.316,0.929,44,16,8,1,0.444,0.833,49,18,7,10
1321,21500092,Golden State Warriors,Sacramento Kings,103,94,197,9,Golden State Warriors,9,0.205,0.864,46,27,13,2,0.316,0.75,45,26,9,3
1322,21500093,Houston Rockets,Los Angeles Clippers,109,105,214,4,Houston Rockets,4,0.233,0.897,47,16,7,3,0.182,0.68,41,29,8,5
1323,21500094,Indiana Pacers,Cleveland Cavaliers,97,101,198,4,Cleveland Cavaliers,4,0.333,0.684,47,22,5,4,0.333,0.68,48,25,5,4
1324,21500095,Los Angeles Lakers,New York Knicks,95,99,194,4,New York Knicks,4,0.333,0.609,46,19,7,3,0.333,0.828,52,22,5,5
1325,21500096,Toronto Raptors,Miami Heat,76,96,172,20,Miami Heat,20,0.158,0.773,38,17,8,5,0.4,0.72,48,18,8,8
1326,21500097,Phoenix Suns,Oklahoma City Thunder,103,124,227,21,Oklahoma City Thunder,21,0.438,0.769,33,18,7,1,0.2,0.733,52,26,14,8
1327,21500098,Detroit Pistons,Portland Trail Blazers,120,103,223,17,Detroit Pistons,17,0.367,0.682,46,16,13,5,0.36,0.667,40,24,5,2
1328,21500099,Orlando Magic,Indiana Pacers,84,97,181,13,Indiana Pacers,13,0.303,0.706,44,16,9,3,0.44,0.818,42,25,12,4
1329,21500100,Chicago Bulls,Philadelphia 76ers,111,88,199,23,Chicago Bulls,23,0.4,0.826,58,28,6,10,0.2,0.565,52,19,6,9
1330,21500101,Minnesota Timberwolves,Atlanta Hawks,117,107,224,10,Minnesota Timberwolves,10,0.467,0.818,40,27,10,5,0.419,0.857,27,30,13,6
1331,21500102,Portland Trail Blazers,Denver Nuggets,104,108,212,4,Denver Nuggets,4,0.345,0.815,39,20,6,3,0.368,0.656,47,20,5,7
1332,21500103,San Antonio Spurs,Sacramento Kings,106,88,194,18,San Antonio Spurs,18,0.261,0.727,46,34,11,7,0.368,0.684,42,25,10,5
1333,21500104,Detroit Pistons,Golden State Warriors,95,109,204,14,Golden State Warriors,14,0.316,0.6,41,15,9,3,0.571,0.846,41,29,13,4
1334,21500105,Memphis Grizzlies,Los Angeles Clippers,92,94,186,2,Los Angeles Clippers,2,0.182,0.69,40,21,11,3,0.263,0.892,40,14,5,8
1335,21500106,Utah Jazz,Cleveland Cavaliers,114,118,232,4,Cleveland Cavaliers,4,0.455,0.857,37,30,11,0,0.458,0.767,35,24,9,6
1336,21500107,Oklahoma City Thunder,Washington Wizards,125,101,226,24,Oklahoma City Thunder,24,0.652,0.759,53,27,4,2,0.208,0.769,41,17,8,5
1337,21500108,Los Angeles Lakers,Miami Heat,88,101,189,13,Miami Heat,13,0.5,0.75,36,21,7,7,0.25,0.741,47,23,7,7
1338,21500109,New York Knicks,Toronto Raptors,111,109,220,2,New York Knicks,2,0.478,0.889,44,22,8,7,0.235,0.795,49,25,7,6
1339,21500110,Boston Celtics,Milwaukee Bucks,99,83,182,16,Boston Celtics,16,0.233,0.842,45,21,11,6,0.353,0.739,41,14,10,2
1340,21500111,Charlotte Hornets,Minnesota Timberwolves,104,95,199,9,Charlotte Hornets,9,0.308,0.741,34,18,8,5,0.474,0.737,48,25,6,4
1341,21500112,Dallas Mavericks,New Orleans Pelicans,105,120,225,15,New Orleans Pelicans,15,0.25,0.846,44,20,4,4,0.424,0.778,48,25,9,5
1342,21500113,New York Knicks,Charlotte Hornets,93,95,188,2,Charlotte Hornets,2,0.19,0.714,52,20,5,5,0.348,0.607,33,21,11,5
1343,21500114,Los Angeles Lakers,Orlando Magic,99,101,200,2,Orlando Magic,2,0.318,0.778,43,25,5,7,0.464,0.667,54,22,7,4
1344,21500115,Toronto Raptors,Philadelphia 76ers,119,103,222,16,Toronto Raptors,16,0.278,0.903,56,22,7,7,0.414,0.647,37,28,2,7
1345,21500116,Indiana Pacers,Boston Celtics,102,91,193,11,Indiana Pacers,11,0.353,0.645,41,20,9,6,0.167,0.719,36,18,10,3
1346,21500117,New Orleans Pelicans,Atlanta Hawks,98,106,204,8,Atlanta Hawks,8,0.483,0.667,40,21,6,0,0.385,0.75,44,26,10,7
1347,21500118,Los Angeles Clippers,Dallas Mavericks,108,118,226,10,Dallas Mavericks,10,0.444,0.667,41,21,4,2,0.458,0.767,44,23,8,3
1348,21500119,Brooklyn Nets,Houston Rockets,106,98,204,8,Brooklyn Nets,8,0.471,0.824,60,25,5,11,0.235,0.5,45,25,9,9
1349,21500120,Golden State Warriors,Memphis Grizzlies,100,84,184,16,Golden State Warriors,16,0.407,0.739,36,22,12,8,0.2,0.917,41,15,14,5
1350,21500121,Milwaukee Bucks,Denver Nuggets,102,103,205,1,Denver Nuggets,1,0.455,0.889,33,26,8,4,0.333,0.708,36,27,10,6
1351,21500122,Detroit Pistons,Sacramento Kings,92,101,193,9,Sacramento Kings,9,0.281,0.75,45,16,10,3,0.563,0.75,46,20,7,2
1352,21500123,San Antonio Spurs,Portland Trail Blazers,113,101,214,12,San Antonio Spurs,12,0.467,0.778,42,27,4,4,0.409,0.609,36,26,6,3
1353,21500124,Utah Jazz,Miami Heat,91,92,183,1,Miami Heat,1,0.235,0.76,42,13,10,9,0.308,0.64,47,14,6,11
1354,21500125,Golden State Warriors,Minnesota Timberwolves,129,116,245,13,Golden State Warriors,13,0.474,0.938,33,34,8,7,0.333,0.75,47,21,4,1
1355,21500126,Los Angeles Clippers,Phoenix Suns,104,118,222,14,Phoenix Suns,14,0.346,0.536,37,17,13,3,0.467,0.762,46,22,10,3
1356,21500127,Minnesota Timberwolves,Indiana Pacers,103,107,210,4,Indiana Pacers,4,0.35,0.923,39,16,5,0,0.4,0.652,40,23,9,5
1357,21500128,Utah Jazz,Orlando Magic,93,102,195,9,Orlando Magic,9,0.32,0.739,41,24,14,6,0.37,0.903,45,20,11,11
1358,21500129,Atlanta Hawks,Boston Celtics,93,106,199,13,Boston Celtics,13,0.3,0.75,35,26,3,2,0.333,0.917,50,27,10,7
1359,21500130,Cleveland Cavaliers,New York Knicks,90,84,174,6,Cleveland Cavaliers,6,0.214,0.581,49,12,6,1,0.333,0.81,46,16,7,4
1360,21500131,New Orleans Pelicans,Toronto Raptors,81,100,181,19,Toronto Raptors,19,0.304,0.7,38,15,10,4,0.429,0.852,48,19,8,5
1361,21500132,Charlotte Hornets,Chicago Bulls,97,102,199,5,Chicago Bulls,5,0.455,0.833,45,21,9,4,0.25,0.774,57,27,4,6
1362,21500133,Portland Trail Blazers,Memphis Grizzlies,100,101,201,1,Memphis Grizzlies,1,0.364,0.897,43,17,5,10,0.375,0.852,35,22,10,0
1363,21500134,Philadelphia 76ers,Oklahoma City Thunder,85,102,187,17,Oklahoma City Thunder,17,0.294,0.714,43,16,11,7,0.32,0.762,55,20,9,13
1364,21500135,Los Angeles Lakers,Dallas Mavericks,82,90,172,8,Dallas Mavericks,8,0.333,0.833,57,18,10,7,0.259,0.793,48,19,9,4
1365,21500136,Houston Rockets,Denver Nuggets,98,107,205,9,Denver Nuggets,9,0.31,0.742,40,19,10,8,0.45,0.75,46,25,10,4
1366,21500137,Brooklyn Nets,Sacramento Kings,109,111,220,2,Sacramento Kings,2,0.381,0.81,44,24,7,4,0.407,0.769,50,25,11,3
1367,21500138,Detroit Pistons,Los Angeles Clippers,96,101,197,5,Los Angeles Clippers,5,0.259,0.657,42,15,8,2,0.368,0.769,42,23,6,4
1368,21500139,Orlando Magic,Washington Wizards,99,108,207,9,Washington Wizards,9,0.222,0.792,45,19,7,2,0.414,0.692,49,29,6,6
1369,21500140,Dallas Mavericks,Houston Rockets,110,98,208,12,Dallas Mavericks,12,0.286,0.762,45,24,6,7,0.265,0.781,43,22,9,5
1370,21500141,Cleveland Cavaliers,Milwaukee Bucks,105,108,213,3,Milwaukee Bucks,3,0.368,0.63,54,21,6,8,0.375,0.727,51,20,6,9
1371,21500142,Philadelphia 76ers,San Antonio Spurs,83,92,175,9,San Antonio Spurs,9,0.364,0.818,41,15,7,3,0.313,0.84,54,23,10,7
1372,21500143,Denver Nuggets,Phoenix Suns,81,105,186,24,Phoenix Suns,24,0.171,0.875,42,13,8,6,0.458,0.769,57,19,4,1
1373,21500144,Brooklyn Nets,Golden State Warriors,99,107,206,8,Golden State Warriors,8,0.111,0.938,50,22,12,4,0.353,0.9,50,31,9,10
1374,21500145,New Orleans Pelicans,New York Knicks,87,95,182,8,New York Knicks,8,0.286,0.895,36,16,5,5,0.222,0.789,41,18,8,4
1375,21500146,Memphis Grizzlies,Minnesota Timberwolves,114,106,220,8,Memphis Grizzlies,8,0.529,0.926,34,21,7,6,0.313,0.905,33,20,10,2
1376,21500147,Portland Trail Blazers,Charlotte Hornets,94,106,200,12,Charlotte Hornets,12,0.238,0.905,46,20,5,3,0.29,0.789,37,29,6,9
1377,21500148,Utah Jazz,Atlanta Hawks,97,96,193,1,Utah Jazz,1,0.333,0.706,40,21,7,7,0.364,0.824,33,26,9,5
1378,21500149,Boston Celtics,Oklahoma City Thunder,100,85,185,15,Boston Celtics,15,0.391,0.65,47,25,12,7,0.24,0.793,34,18,10,6
1379,21500150,Toronto Raptors,Sacramento Kings,101,107,208,6,Sacramento Kings,6,0.484,0.714,36,18,13,1,0.4,0.792,42,23,8,5
1380,21500151,Detroit Pistons,Los Angeles Lakers,85,97,182,12,Los Angeles Lakers,12,0.259,0.533,46,16,7,2,0.316,0.744,46,24,5,5
1381,21500152,Dallas Mavericks,Philadelphia 76ers,92,86,178,6,Dallas Mavericks,6,0.292,0.833,39,16,12,2,0.227,0.65,46,16,9,4
1382,21500153,Indiana Pacers,Chicago Bulls,95,96,191,1,Chicago Bulls,1,0.429,0.667,50,19,4,5,0.4,0.625,48,26,9,9
1383,21500154,Boston Celtics,Houston Rockets,111,95,206,16,Boston Celtics,16,0.306,0.706,49,27,16,3,0.344,0.522,46,23,10,6
1384,21500155,Oklahoma City Thunder,Memphis Grizzlies,114,122,236,8,Memphis Grizzlies,8,0.417,0.71,44,22,7,6,0.706,0.923,34,23,11,4
1385,21500156,Portland Trail Blazers,San Antonio Spurs,80,93,173,13,San Antonio Spurs,13,0.368,0.846,39,15,4,3,0.304,0.769,47,29,9,10
1386,21500157,Los Angeles Lakers,Phoenix Suns,101,120,221,19,Phoenix Suns,19,0.45,0.9,37,12,5,2,0.367,0.76,50,23,13,6
1387,21500158,Milwaukee Bucks,Washington Wizards,86,115,201,29,Washington Wizards,29,0.476,0.583,34,22,5,3,0.545,0.707,42,25,8,3
1388,21500159,Atlanta Hawks,Brooklyn Nets,88,90,178,2,Brooklyn Nets,2,0.414,0.714,44,22,7,7,0.45,0.538,44,22,14,3
1389,21500160,Cleveland Cavaliers,Detroit Pistons,99,104,203,5,Detroit Pistons,5,0.333,0.6,40,21,8,2,0.333,0.806,48,20,11,1
1390,21500161,Minnesota Timberwolves,Miami Heat,103,91,194,12,Minnesota Timberwolves,12,0.19,0.771,54,14,12,5,0.208,0.467,51,20,3,12
1391,21500162,Charlotte Hornets,New York Knicks,94,102,196,8,New York Knicks,8,0.25,0.68,42,13,7,7,0.5,0.952,45,22,4,6
1392,21500163,Denver Nuggets,New Orleans Pelicans,115,98,213,17,Denver Nuggets,17,0.5,0.769,43,27,5,6,0.304,0.818,33,25,4,8
1393,21500164,Toronto Raptors,Golden State Warriors,110,115,225,5,Golden State Warriors,5,0.333,0.769,40,18,11,2,0.379,0.667,34,31,10,6
1394,21500165,Brooklyn Nets,Charlotte Hornets,111,116,227,5,Charlotte Hornets,5,0.333,0.818,37,25,5,4,0.44,0.75,49,27,5,8
1395,21500166,Minnesota Timberwolves,Orlando Magic,101,104,205,3,Orlando Magic,3,0.222,0.833,57,21,4,13,0.429,0.619,54,20,10,4
1396,21500167,Indiana Pacers,Philadelphia 76ers,112,85,197,27,Indiana Pacers,27,0.444,0.8,48,28,18,8,0.2,0.625,43,14,9,8
1397,21500168,Dallas Mavericks,Boston Celtics,106,102,208,4,Dallas Mavericks,4,0.35,0.714,39,22,7,7,0.308,0.75,43,22,12,1
1398,21500169,Sacramento Kings,Atlanta Hawks,97,103,200,6,Atlanta Hawks,6,0.313,0.889,52,26,7,1,0.3,0.75,45,23,9,6
1399,21500170,Portland Trail Blazers,Houston Rockets,103,108,211,5,Houston Rockets,5,0.3,0.828,48,18,11,7,0.318,0.857,51,22,11,6
1400,21500171,New Orleans Pelicans,Oklahoma City Thunder,103,110,213,7,Oklahoma City Thunder,7,0.25,1,40,21,8,4,0.412,0.675,50,19,6,4
1401,21500172,Denver Nuggets,San Antonio Spurs,98,109,207,11,San Antonio Spurs,11,0.333,0.944,50,25,7,5,0.5,0.8,50,33,5,13
1402,21500173,Toronto Raptors,Utah Jazz,89,93,182,4,Utah Jazz,4,0.25,0.889,37,14,10,4,0.318,0.727,41,15,9,5
1403,21500174,Chicago Bulls,Phoenix Suns,103,97,200,6,Chicago Bulls,6,0.474,0.857,47,24,7,2,0.296,0.714,43,16,12,4
1404,21500175,Sacramento Kings,Miami Heat,109,116,225,7,Miami Heat,7,0.522,0.55,42,25,3,3,0.292,0.758,41,25,11,7
1405,21500176,Milwaukee Bucks,Cleveland Cavaliers,100,115,215,15,Cleveland Cavaliers,15,0.375,0.808,22,22,8,2,0.458,0.8,43,29,3,2
1406,21500177,Golden State Warriors,Los Angeles Clippers,124,117,241,7,Golden State Warriors,7,0.567,0.861,44,31,4,4,0.448,0.667,35,21,11,2
1407,21500178,Philadelphia 76ers,Charlotte Hornets,88,113,201,25,Charlotte Hornets,25,0.308,0.727,42,21,5,6,0.48,0.955,41,25,7,10
1408,21500179,Brooklyn Nets,Boston Celtics,95,120,215,25,Boston Celtics,25,0.421,0.708,44,17,10,0,0.345,0.8,41,39,10,4
1409,21500180,Houston Rockets,Memphis Grizzlies,84,96,180,12,Memphis Grizzlies,12,0.207,0.595,49,15,11,9,0.333,0.842,47,26,16,4
1410,21500181,Detroit Pistons,Minnesota Timberwolves,96,86,182,10,Detroit Pistons,10,0.214,0.769,45,13,11,5,0.231,0.68,40,17,7,4
1411,21500182,San Antonio Spurs,New Orleans Pelicans,90,104,194,14,New Orleans Pelicans,14,0.529,0.813,43,22,5,8,0.364,0.941,53,26,3,3
1412,21500183,New York Knicks,Oklahoma City Thunder,93,90,183,3,New York Knicks,3,0.6,0.652,36,23,10,5,0.103,0.739,49,12,9,4
1413,21500184,Utah Jazz,Dallas Mavericks,93,102,195,9,Dallas Mavericks,9,0.3,0.81,48,14,4,2,0.286,0.941,34,24,10,5
1414,21500185,Phoenix Suns,Denver Nuggets,114,107,221,7,Phoenix Suns,7,0.556,0.76,42,22,7,7,0.208,0.769,38,24,8,4
1415,21500186,Los Angeles Clippers,Portland Trail Blazers,91,102,193,11,Portland Trail Blazers,11,0.292,0.5,42,24,6,5,0.32,0.75,55,16,8,3
1416,21500187,Chicago Bulls,Golden State Warriors,94,106,200,12,Golden State Warriors,12,0.318,0.739,43,22,11,2,0.345,0.75,49,20,7,6
1417,21500188,Toronto Raptors,Los Angeles Lakers,102,91,193,11,Toronto Raptors,11,0.455,0.792,41,21,7,3,0.32,0.765,41,21,8,4
1418,21500189,Sacramento Kings,Orlando Magic,97,91,188,6,Sacramento Kings,6,0.35,0.903,47,23,11,5,0.29,0.75,50,27,8,7
1419,21500190,Milwaukee Bucks,Indiana Pacers,86,123,209,37,Indiana Pacers,37,0.294,0.684,43,19,9,5,0.5,0.609,42,28,15,5
1420,21500191,Atlanta Hawks,Cleveland Cavaliers,97,109,206,12,Cleveland Cavaliers,12,0.393,0.88,38,22,10,4,0.379,0.842,51,27,4,8
1421,21500192,Washington Wizards,Detroit Pistons,97,95,192,2,Washington Wizards,2,0.368,0.7,42,22,10,0,0.308,0.714,38,20,3,2
1422,21500193,Philadelphia 76ers,Miami Heat,91,96,187,5,Miami Heat,5,0.323,0.792,43,16,7,8,0.278,0.689,45,16,7,14
1423,21500194,New York Knicks,Houston Rockets,107,102,209,5,New York Knicks,5,0.48,0.794,45,20,4,8,0.429,0.714,42,18,6,4
1424,21500195,Memphis Grizzlies,San Antonio Spurs,82,92,174,10,San Antonio Spurs,10,0.111,1,35,19,13,2,0.333,0.773,40,20,7,6
1425,21500196,Toronto Raptors,Los Angeles Clippers,91,80,171,11,Toronto Raptors,11,0.235,0.935,46,15,8,0,0.219,0.75,42,21,9,9
1426,21500197,Boston Celtics,Brooklyn Nets,101,111,212,10,Brooklyn Nets,10,0.378,0.81,35,19,9,2,0.333,0.788,49,18,11,4
1427,21500198,Phoenix Suns,New Orleans Pelicans,116,122,238,6,New Orleans Pelicans,6,0.472,0.879,46,17,6,4,0.367,0.825,49,23,11,6
1428,21500199,Dallas Mavericks,Oklahoma City Thunder,114,117,231,3,Oklahoma City Thunder,3,0.526,0.571,36,26,8,4,0.409,0.778,41,25,8,6
1429,21500200,Golden State Warriors,Denver Nuggets,118,105,223,13,Golden State Warriors,13,0.517,0.692,46,35,15,8,0.267,0.771,41,23,9,3
1430,21500201,Portland Trail Blazers,Los Angeles Lakers,107,93,200,14,Portland Trail Blazers,14,0.32,0.765,43,27,7,8,0.333,0.852,51,17,2,6
1431,21500202,Sacramento Kings,Charlotte Hornets,122,127,249,5,Charlotte Hornets,5,0.258,0.625,46,34,10,8,0.31,0.769,48,24,10,7
1432,21500203,Orlando Magic,Cleveland Cavaliers,103,117,220,14,Cleveland Cavaliers,14,0.455,0.619,39,25,6,6,0.514,0.591,41,34,5,3
1433,21500204,New York Knicks,Miami Heat,78,95,173,17,Miami Heat,17,0.167,0.857,49,12,7,4,0.263,0.778,56,18,8,7
1434,21500205,Detroit Pistons,Milwaukee Bucks,88,109,197,21,Milwaukee Bucks,21,0.214,0.833,48,19,7,3,0.692,0.824,45,30,12,4
1435,21500206,Philadelphia 76ers,Minnesota Timberwolves,95,100,195,5,Minnesota Timberwolves,5,0.323,0.778,41,15,10,6,0.25,0.926,41,20,8,7
1436,21500207,Phoenix Suns,San Antonio Spurs,84,98,182,14,San Antonio Spurs,14,0.368,0.9,37,23,13,3,0.45,0.5,38,21,18,3
1437,21500208,Oklahoma City Thunder,Utah Jazz,111,89,200,22,Oklahoma City Thunder,22,0.407,0.889,36,22,12,10,0.263,0.7,41,15,11,3
1438,21500209,Indiana Pacers,Washington Wizards,123,106,229,17,Indiana Pacers,17,0.731,0.696,41,25,11,0,0.394,0.708,40,27,9,1
1439,21500210,Boston Celtics,Atlanta Hawks,97,121,218,24,Atlanta Hawks,24,0.429,0.769,33,23,14,2,0.5,0.864,43,33,8,7
1440,21500211,Dallas Mavericks,Memphis Grizzlies,96,110,206,14,Memphis Grizzlies,14,0.324,0.893,48,22,4,6,0.333,0.784,42,20,12,4
1441,21500212,Los Angeles Clippers,Denver Nuggets,111,94,205,17,Los Angeles Clippers,17,0.4,0.617,43,24,10,8,0.32,0.828,48,16,3,0
1442,21500213,Chicago Bulls,Portland Trail Blazers,93,88,181,5,Chicago Bulls,5,0.389,0.87,44,19,6,3,0.273,0.741,55,18,5,9
1443,21500214,Los Angeles Lakers,Golden State Warriors,77,111,188,34,Golden State Warriors,34,0.143,0.75,45,16,8,2,0.343,0.6,48,32,9,6
1444,21500215,Washington Wizards,Charlotte Hornets,87,101,188,14,Charlotte Hornets,14,0.313,0.833,41,15,13,4,0.308,1,51,22,5,6
1445,21500216,New York Knicks,Orlando Magic,91,100,191,9,Orlando Magic,9,0.333,0.8,47,16,2,10,0.313,0.844,48,20,2,7
1446,21500217,Philadelphia 76ers,Boston Celtics,80,84,164,4,Boston Celtics,4,0.259,0.733,50,12,11,14,0.31,0.722,54,18,7,6
1447,21500218,Miami Heat,Detroit Pistons,81,104,185,23,Detroit Pistons,23,0.3,0.688,43,21,2,7,0.516,0.857,54,24,6,7
1448,21500219,Cleveland Cavaliers,Toronto Raptors,99,103,202,4,Toronto Raptors,4,0.483,0.813,42,22,4,2,0.44,0.545,40,14,8,5
1449,21500220,Memphis Grizzlies,Houston Rockets,102,93,195,9,Memphis Grizzlies,9,0.188,0.913,41,21,8,3,0.294,0.852,37,19,14,7
1450,21500221,Sacramento Kings,Milwaukee Bucks,129,118,247,11,Sacramento Kings,11,0.435,0.838,42,23,9,7,0.419,0.778,37,30,7,7
1451,21500222,Atlanta Hawks,Minnesota Timberwolves,95,99,194,4,Minnesota Timberwolves,4,0.258,0.714,53,14,10,7,0.429,0.759,45,22,9,4
1452,21500223,Brooklyn Nets,Oklahoma City Thunder,99,110,209,11,Oklahoma City Thunder,11,0.231,0.833,45,20,10,3,0.417,0.857,42,26,11,7
1453,21500224,Dallas Mavericks,San Antonio Spurs,83,88,171,5,San Antonio Spurs,5,0.273,0.75,46,21,7,1,0.286,0.737,52,23,6,4
1454,21500225,New Orleans Pelicans,Phoenix Suns,120,114,234,6,New Orleans Pelicans,6,0.455,0.765,42,20,4,6,0.385,0.8,44,25,8,5
1455,21500226,Utah Jazz,Los Angeles Clippers,102,91,193,11,Utah Jazz,11,0.462,0.72,39,19,12,4,0.333,0.647,35,18,11,7
1456,21500227,Cleveland Cavaliers,Charlotte Hornets,95,90,185,5,Cleveland Cavaliers,5,0.32,0.76,50,17,3,2,0.2,0.76,38,20,7,7
1457,21500228,Milwaukee Bucks,Orlando Magic,90,114,204,24,Orlando Magic,24,0.308,0.909,38,20,8,2,0.444,0.727,41,30,9,5
1458,21500229,Washington Wizards,Boston Celtics,78,111,189,33,Boston Celtics,33,0.278,0.864,46,16,7,4,0.364,0.789,58,28,11,7
1459,21500230,Miami Heat,New York Knicks,97,78,175,19,Miami Heat,19,0.412,0.857,42,16,4,7,0.214,0.733,39,16,7,5
1460,21500231,Chicago Bulls,Indiana Pacers,92,104,196,12,Indiana Pacers,12,0.423,0.85,47,21,7,7,0.286,0.759,51,18,8,4
1461,21500232,Philadelphia 76ers,Houston Rockets,114,116,230,2,Houston Rockets,2,0.457,0.692,33,24,18,5,0.55,0.784,49,21,5,6
1462,21500233,Atlanta Hawks,Memphis Grizzlies,116,101,217,15,Atlanta Hawks,15,0.359,0.889,40,25,4,3,0.4,0.905,37,20,3,1
1463,21500234,Detroit Pistons,Oklahoma City Thunder,87,103,190,16,Oklahoma City Thunder,16,0.31,0.8,38,17,9,1,0.292,0.846,58,19,2,9
1464,21500235,San Antonio Spurs,Denver Nuggets,91,80,171,11,San Antonio Spurs,11,0.364,0.786,42,22,11,7,0.35,0.846,37,17,8,2
1465,21500236,Golden State Warriors,Phoenix Suns,135,116,251,19,Golden State Warriors,19,0.579,0.677,53,32,7,9,0.385,0.696,30,21,13,2
1466,21500237,Minnesota Timberwolves,Sacramento Kings,101,91,192,10,Minnesota Timberwolves,10,0.36,0.947,46,20,4,3,0.364,0.6,36,21,4,3
1467,21500238,New Orleans Pelicans,Los Angeles Clippers,90,111,201,21,Los Angeles Clippers,21,0.25,0.739,50,20,8,1,0.368,0.8,49,27,6,7
1468,21500239,Toronto Raptors,Washington Wizards,84,82,166,2,Toronto Raptors,2,0.458,0.786,48,17,8,7,0.304,0.778,42,20,11,3
1469,21500240,Brooklyn Nets,Cleveland Cavaliers,88,90,178,2,Cleveland Cavaliers,2,0.235,0.75,46,21,9,4,0.333,0.647,49,20,9,11
1470,21500241,Denver Nuggets,Dallas Mavericks,81,92,173,11,Dallas Mavericks,11,0.32,0.765,45,17,9,5,0.269,0.704,42,18,13,3
1471,21500242,Atlanta Hawks,San Antonio Spurs,88,108,196,20,San Antonio Spurs,20,0.231,0.615,43,28,9,5,0.529,0.95,49,25,11,9
1472,21500243,New Orleans Pelicans,Utah Jazz,87,101,188,14,Utah Jazz,14,0.294,0.8,35,19,8,4,0.5,0.762,49,18,11,9
1473,21500244,Los Angeles Lakers,Portland Trail Blazers,96,108,204,12,Portland Trail Blazers,12,0.304,0.739,33,20,12,2,0.4,0.769,46,24,5,2
1474,21500245,Sacramento Kings,Golden State Warriors,101,120,221,19,Golden State Warriors,19,0.4,0.867,48,22,9,7,0.533,0.839,48,32,8,7
1475,21500246,Milwaukee Bucks,Charlotte Hornets,82,87,169,5,Charlotte Hornets,5,0.286,0.571,46,25,9,2,0.484,0.818,43,20,6,6
1476,21500247,Minnesota Timberwolves,Los Angeles Clippers,99,107,206,8,Los Angeles Clippers,8,0.5,0.81,39,21,7,3,0.364,0.636,39,24,3,5
1477,21500248,Detroit Pistons,Brooklyn Nets,83,87,170,4,Brooklyn Nets,4,0.25,0.429,51,19,11,1,0.333,0.813,51,15,8,11
1478,21500249,Boston Celtics,Orlando Magic,91,110,201,19,Orlando Magic,19,0.185,0.7,34,28,7,6,0.36,0.688,54,24,6,7
1479,21500250,Phoenix Suns,Toronto Raptors,107,102,209,5,Phoenix Suns,5,0.407,0.8,50,24,4,9,0.414,0.824,43,19,6,7
1480,21500251,Philadelphia 76ers,Memphis Grizzlies,84,92,176,8,Memphis Grizzlies,8,0.333,0.75,41,23,18,9,0.308,0.741,49,19,11,7
1481,21500252,Houston Rockets,New York Knicks,116,111,227,5,Houston Rockets,5,0.28,0.639,39,16,16,2,0.333,0.882,43,22,5,7
1482,21500253,Indiana Pacers,Los Angeles Lakers,107,103,210,4,Indiana Pacers,4,0.333,0.811,50,17,4,5,0.333,0.727,54,17,6,5
1483,21500254,Houston Rockets,Detroit Pistons,105,116,221,11,Detroit Pistons,11,0.407,0.857,45,19,11,7,0.348,0.486,46,22,8,8
1484,21500255,Boston Celtics,Miami Heat,105,95,200,10,Boston Celtics,10,0.4,0.84,40,23,15,3,0.294,0.75,38,21,9,6
1485,21500256,Oklahoma City Thunder,Atlanta Hawks,100,106,206,6,Atlanta Hawks,6,0.368,0.864,48,19,8,8,0.357,0.9,51,23,9,8
1486,21500257,San Antonio Spurs,Chicago Bulls,89,92,181,3,Chicago Bulls,3,0.143,0.722,47,20,5,4,0.375,0.6,51,25,4,6
1487,21500258,Denver Nuggets,Milwaukee Bucks,74,92,166,18,Milwaukee Bucks,18,0.316,0.75,43,19,6,4,0.333,0.727,38,25,10,12
1488,21500259,Golden State Warriors,Utah Jazz,106,103,209,3,Golden State Warriors,3,0.483,0.8,45,21,2,5,0.316,0.773,35,18,9,2
1489,21500260,Dallas Mavericks,Sacramento Kings,98,112,210,14,Sacramento Kings,14,0.243,0.773,40,22,8,3,0.29,0.705,42,22,1,1
1490,21500261,Portland Trail Blazers,Los Angeles Clippers,87,102,189,15,Los Angeles Clippers,15,0.217,0.593,54,18,6,2,0.421,0.5,55,26,7,5
1491,21500262,Washington Wizards,Cleveland Cavaliers,97,85,182,12,Washington Wizards,12,0.25,0.75,39,23,7,5,0.3,0.87,47,15,8,3
1492,21500263,Los Angeles Lakers,Philadelphia 76ers,91,103,194,12,Philadelphia 76ers,12,0.235,0.708,46,15,4,2,0.438,0.652,47,28,6,8
1493,21500264,Phoenix Suns,Brooklyn Nets,91,94,185,3,Brooklyn Nets,3,0.357,0.682,39,20,9,3,0.308,0.667,42,23,10,4
1494,21500265,Orlando Magic,Minnesota Timberwolves,96,93,189,3,Orlando Magic,3,0.294,0.75,44,19,7,5,0.211,0.816,46,14,7,11
1495,21500266,Memphis Grizzlies,New Orleans Pelicans,113,104,217,9,Memphis Grizzlies,9,0.2,0.962,49,21,3,4,0.333,0.758,37,25,3,11
1496,21500267,Dallas Mavericks,Portland Trail Blazers,115,112,227,3,Dallas Mavericks,3,0.31,0.833,49,23,7,5,0.375,0.882,50,24,6,1
1497,21500268,Golden State Warriors,Charlotte Hornets,116,99,215,17,Golden State Warriors,17,0.471,0.727,53,31,2,9,0.29,0.667,41,19,10,7
1498,21500269,Los Angeles Lakers,Washington Wizards,108,104,212,4,Los Angeles Lakers,4,0.32,0.9,45,17,18,3,0.333,0.742,41,24,11,2
1499,21500270,Phoenix Suns,Detroit Pistons,122,127,249,5,Detroit Pistons,5,0.424,0.933,36,28,7,3,0.444,0.614,50,24,10,1
1500,21500271,Philadelphia 76ers,New York Knicks,87,99,186,12,New York Knicks,12,0.3,0.583,42,11,8,7,0.211,0.864,50,19,5,9
1501,21500272,Toronto Raptors,Atlanta Hawks,96,86,182,10,Toronto Raptors,10,0.24,0.75,50,12,10,5,0.296,0.75,43,22,8,7
1502,21500273,Denver Nuggets,Chicago Bulls,90,99,189,9,Chicago Bulls,9,0.333,0.591,49,26,8,8,0.353,0.778,62,22,3,10
1503,21500274,New Orleans Pelicans,Houston Rockets,101,108,209,7,Houston Rockets,7,0.28,0.88,56,20,5,6,0.296,0.718,42,20,9,7
1504,21500275,Milwaukee Bucks,San Antonio Spurs,70,95,165,25,San Antonio Spurs,25,0.214,0.833,44,17,7,6,0.333,0.7,54,25,11,9
1505,21500276,Indiana Pacers,Los Angeles Clippers,103,91,194,12,Indiana Pacers,12,0.35,0.821,47,16,7,6,0.222,0.641,40,19,4,2
1506,21500277,Oklahoma City Thunder,Miami Heat,95,97,192,2,Miami Heat,2,0.25,0.875,44,15,5,1,0.231,0.583,35,25,10,3
1507,21500278,Denver Nuggets,Toronto Raptors,106,105,211,1,Denver Nuggets,1,0.444,1,42,30,2,4,0.296,0.864,39,21,9,3
1508,21500279,Orlando Magic,Utah Jazz,103,94,197,9,Orlando Magic,9,0.348,1,40,19,13,4,0.424,0.75,39,18,4,8
1509,21500280,San Antonio Spurs,Memphis Grizzlies,103,83,186,20,San Antonio Spurs,20,0.556,0.722,48,27,8,8,0.125,0.84,37,19,6,6
1510,21500281,Indiana Pacers,Portland Trail Blazers,111,123,234,12,Portland Trail Blazers,12,0.433,0.917,41,18,4,3,0.5,0.85,48,26,11,3
1511,21500282,Boston Celtics,Sacramento Kings,114,97,211,17,Boston Celtics,17,0.424,0.833,40,34,14,5,0.333,0.78,46,21,8,4
1512,21500283,Brooklyn Nets,New York Knicks,91,108,199,17,New York Knicks,17,0.273,0.667,49,15,9,4,0.444,0.857,44,25,8,6
1513,21500284,Phoenix Suns,Washington Wizards,106,109,215,3,Washington Wizards,3,0.435,0.625,35,21,8,4,0.385,0.76,41,19,9,2
1514,21500285,Milwaukee Bucks,Detroit Pistons,95,102,197,7,Detroit Pistons,7,0.222,0.929,51,21,6,6,0.304,0.692,46,18,8,4
1515,21500286,Los Angeles Lakers,Atlanta Hawks,87,100,187,13,Atlanta Hawks,13,0.481,0.769,42,19,10,7,0.385,0.8,43,24,11,9
1516,21500287,Houston Rockets,Dallas Mavericks,100,96,196,4,Houston Rockets,4,0.462,0.556,45,20,12,5,0.276,0.7,42,23,8,5
1517,21500288,Cleveland Cavaliers,New Orleans Pelicans,108,114,222,6,New Orleans Pelicans,6,0.303,0.833,43,18,8,1,0.36,0.677,46,25,10,2
1518,21500289,Denver Nuggets,Philadelphia 76ers,108,105,213,3,Denver Nuggets,3,0.355,0.605,47,25,8,4,0.484,0.615,40,22,11,8
1519,21500290,Golden State Warriors,Toronto Raptors,112,109,221,3,Golden State Warriors,3,0.533,0.722,43,22,2,5,0.4,0.808,38,21,9,3
1520,21500291,Cleveland Cavaliers,Miami Heat,84,99,183,15,Miami Heat,15,0.214,0.667,36,14,8,1,0.438,0.621,41,21,5,9
1521,21500292,Charlotte Hornets,Chicago Bulls,102,96,198,6,Charlotte Hornets,6,0.294,0.72,50,23,10,3,0.36,0.684,52,29,5,5
1522,21500293,Sacramento Kings,Houston Rockets,113,120,233,7,Houston Rockets,7,0.385,0.846,47,35,12,7,0.471,0.744,43,25,9,5
1523,21500294,Portland Trail Blazers,Minnesota Timberwolves,109,103,212,6,Portland Trail Blazers,6,0.5,0.7,40,23,7,3,0.333,0.846,45,24,3,4
1524,21500295,New York Knicks,Milwaukee Bucks,91,106,197,15,Milwaukee Bucks,15,0.24,0.75,37,22,4,4,0.5,0.667,49,25,5,6
1525,21500296,Boston Celtics,San Antonio Spurs,105,108,213,3,San Antonio Spurs,3,0.414,0.682,39,22,9,3,0.294,0.682,47,26,3,3
1526,21500297,Indiana Pacers,Utah Jazz,119,122,241,3,Utah Jazz,3,0.414,0.794,44,17,10,2,0.348,0.757,54,21,7,3
1527,21500298,Orlando Magic,Los Angeles Clippers,101,103,204,2,Los Angeles Clippers,2,0.3,0.833,51,22,8,6,0.387,0.68,45,25,5,2
1528,21500299,Phoenix Suns,Memphis Grizzlies,93,95,188,2,Memphis Grizzlies,2,0.29,0.706,47,20,8,5,0.333,0.75,46,23,8,5
1529,21500300,Golden State Warriors,Brooklyn Nets,114,98,212,16,Golden State Warriors,16,0.424,0.522,46,25,9,9,0.294,0.652,46,21,8,2
1530,21500301,Los Angeles Lakers,Detroit Pistons,91,111,202,20,Detroit Pistons,20,0.278,0.759,39,12,6,4,0.375,0.769,61,20,11,1
1531,21500302,Dallas Mavericks,Washington Wizards,116,104,220,12,Dallas Mavericks,12,0.516,0.889,50,25,5,4,0.296,0.571,31,22,9,0
1532,21500303,Sacramento Kings,Oklahoma City Thunder,95,98,193,3,Oklahoma City Thunder,3,0.292,0.6,41,20,11,5,0.273,0.71,62,18,8,6
1533,21500304,Detroit Pistons,Charlotte Hornets,84,104,188,20,Charlotte Hornets,20,0.294,0.455,41,17,11,2,0.308,0.686,57,21,5,5
1534,21500305,San Antonio Spurs,Philadelphia 76ers,119,68,187,51,San Antonio Spurs,51,0.364,0.84,47,32,4,1,0.167,0.571,31,14,3,1
1535,21500306,Washington Wizards,Miami Heat,114,103,217,11,Washington Wizards,11,0.5,0.765,37,23,7,2,0.313,0.727,34,25,5,6
1536,21500307,Dallas Mavericks,New York Knicks,104,97,201,7,Dallas Mavericks,7,0.419,0.85,43,21,7,3,0.36,0.889,37,25,4,4
1537,21500308,Los Angeles Lakers,Toronto Raptors,93,102,195,9,Toronto Raptors,9,0.368,0.9,47,14,4,4,0.36,0.781,38,18,7,2
1538,21500309,Phoenix Suns,Chicago Bulls,103,101,204,2,Phoenix Suns,2,0.412,0.824,40,18,12,4,0.286,0.722,48,28,11,8
1539,21500310,Portland Trail Blazers,Milwaukee Bucks,88,90,178,2,Milwaukee Bucks,2,0.242,0.778,46,21,10,7,0.308,0.788,45,22,8,7
1540,21500311,Los Angeles Clippers,Minnesota Timberwolves,110,106,216,4,Los Angeles Clippers,4,0.32,0.897,43,21,10,9,0.389,0.771,46,18,10,3
1541,21500312,Boston Celtics,New Orleans Pelicans,111,93,204,18,Boston Celtics,18,0.429,0.792,46,24,8,8,0.308,0.833,44,21,8,6
1542,21500313,Portland Trail Blazers,Cleveland Cavaliers,100,105,205,5,Cleveland Cavaliers,5,0.423,0.563,36,21,3,2,0.429,0.8,30,18,10,4
1543,21500314,Golden State Warriors,Indiana Pacers,131,123,254,8,Golden State Warriors,8,0.457,0.733,46,29,10,6,0.424,0.808,44,23,8,3
1544,21500315,Houston Rockets,Brooklyn Nets,105,110,215,5,Brooklyn Nets,5,0.429,0.706,36,26,20,3,0.389,0.813,42,27,14,7
1545,21500316,Oklahoma City Thunder,Memphis Grizzlies,125,88,213,37,Oklahoma City Thunder,37,0.5,0.783,46,31,11,3,0.214,0.864,33,14,6,4
1546,21500317,Orlando Magic,Denver Nuggets,85,74,159,11,Orlando Magic,11,0.063,0.8,54,14,9,8,0.292,0.55,47,19,11,7
1547,21500318,Utah Jazz,Sacramento Kings,106,114,220,8,Sacramento Kings,8,0.417,0.682,44,23,7,0,0.357,0.75,40,29,6,2
1548,21500319,Chicago Bulls,Boston Celtics,100,105,205,5,Boston Celtics,5,0.286,0.696,50,22,7,5,0.217,0.857,45,22,10,4
1549,21500320,Miami Heat,Charlotte Hornets,81,99,180,18,Charlotte Hornets,18,0.286,0.708,43,17,3,8,0.407,0.471,40,27,9,5
1550,21500321,Houston Rockets,Washington Wizards,109,103,212,6,Houston Rockets,6,0.364,0.68,42,23,8,4,0.2,0.833,47,20,8,3
1551,21500322,Memphis Grizzlies,Detroit Pistons,93,92,185,1,Memphis Grizzlies,1,0.267,0.538,53,23,4,4,0.276,0.667,43,17,9,6
1552,21500323,San Antonio Spurs,Toronto Raptors,94,97,191,3,Toronto Raptors,3,0.28,0.792,35,23,10,2,0.3,0.909,34,23,10,2
1553,21500324,Los Angeles Clippers,Milwaukee Bucks,109,95,204,14,Los Angeles Clippers,14,0.429,0.583,51,27,7,8,0.2,0.75,40,26,7,1
1554,21500325,Los Angeles Lakers,Minnesota Timberwolves,122,123,245,1,Minnesota Timberwolves,1,0.391,0.63,40,19,9,1,0.368,0.774,47,30,4,4
1555,21500326,Orlando Magic,Phoenix Suns,104,107,211,3,Phoenix Suns,3,0.48,0.75,32,28,11,1,0.25,0.704,44,23,9,6
1556,21500327,New York Knicks,Utah Jazz,85,106,191,21,Utah Jazz,21,0.381,0.556,36,20,10,3,0.429,0.826,51,26,6,2
1557,21500328,Atlanta Hawks,Dallas Mavericks,98,95,193,3,Atlanta Hawks,3,0.3,0.778,47,26,7,7,0.226,0.842,51,18,7,3
1558,21500329,Philadelphia 76ers,Brooklyn Nets,91,100,191,9,Brooklyn Nets,9,0.129,0.864,38,17,14,6,0.429,0.741,43,22,5,1
1559,21500330,Los Angeles Clippers,Chicago Bulls,80,83,163,3,Chicago Bulls,3,0.455,0.833,52,22,4,4,0.304,0.875,54,20,8,6
1560,21500331,Atlanta Hawks,Oklahoma City Thunder,94,107,201,13,Oklahoma City Thunder,13,0.357,0.609,34,21,9,7,0.529,0.769,52,24,6,2
1561,21500332,New York Knicks,Sacramento Kings,97,99,196,2,Sacramento Kings,2,0.31,0.786,54,17,9,6,0.188,0.75,44,24,6,3
1562,21500333,Miami Heat,Indiana Pacers,83,96,179,13,Indiana Pacers,13,0.25,0.615,45,14,6,8,0.214,0.9,45,22,13,6
1563,21500334,Cleveland Cavaliers,Orlando Magic,111,76,187,35,Cleveland Cavaliers,35,0.524,0.667,45,28,12,0,0.273,0.7,30,16,8,3
1564,21500335,Detroit Pistons,Philadelphia 76ers,107,95,202,12,Detroit Pistons,12,0.37,0.688,48,18,9,9,0.333,0.708,44,22,5,5
1565,21500336,Golden State Warriors,Boston Celtics,124,119,243,5,Golden State Warriors,5,0.29,0.795,67,28,10,11,0.364,0.563,51,32,7,9
1566,21500337,Milwaukee Bucks,Toronto Raptors,83,90,173,7,Toronto Raptors,7,0.364,0.813,40,19,9,4,0.35,0.652,39,16,9,8
1567,21500338,Charlotte Hornets,Memphis Grizzlies,123,99,222,24,Charlotte Hornets,24,0.486,0.9,41,23,5,5,0.35,0.757,40,19,8,5
1568,21500339,Washington Wizards,New Orleans Pelicans,105,107,212,2,New Orleans Pelicans,2,0.444,0.619,33,27,10,1,0.593,0.722,41,21,9,0
1569,21500340,Minnesota Timberwolves,Denver Nuggets,108,111,219,3,Denver Nuggets,3,0.368,0.862,43,22,5,8,0.393,0.727,50,21,7,1
1570,21500341,Oklahoma City Thunder,Utah Jazz,94,90,184,4,Oklahoma City Thunder,4,0.353,0.875,45,14,4,2,0.286,0.667,39,17,7,4
1571,21500342,Los Angeles Lakers,San Antonio Spurs,87,109,196,22,San Antonio Spurs,22,0.36,0.6,36,20,7,5,0.429,0.6,49,26,9,6
1572,21500343,Portland Trail Blazers,Phoenix Suns,106,96,202,10,Portland Trail Blazers,10,0.353,0.571,51,23,7,3,0.371,0.611,40,21,8,7
1573,21500344,Los Angeles Clippers,Brooklyn Nets,105,100,205,5,Los Angeles Clippers,5,0.333,0.611,40,28,12,0,0.263,0.833,46,17,5,2
1574,21500345,Boston Celtics,Charlotte Hornets,98,93,191,5,Boston Celtics,5,0.36,0.9,42,26,5,5,0.314,1,52,17,1,5
1575,21500346,Indiana Pacers,Detroit Pistons,96,118,214,22,Detroit Pistons,22,0.188,0.611,33,17,7,2,0.448,0.789,46,26,11,6
1576,21500347,San Antonio Spurs,Atlanta Hawks,103,78,181,25,San Antonio Spurs,25,0.5,0.955,49,26,11,2,0.208,0.813,33,21,15,3
1577,21500348,New Orleans Pelicans,Chicago Bulls,94,98,192,4,Chicago Bulls,4,0.375,0.727,41,26,9,6,0.4,0.828,48,17,6,6
1578,21500349,Los Angeles Lakers,Houston Rockets,97,126,223,29,Houston Rockets,29,0.313,0.85,40,21,11,4,0.455,0.607,52,32,16,7
1579,21500350,Washington Wizards,Dallas Mavericks,114,111,225,3,Washington Wizards,3,0.483,0.8,39,33,6,6,0.424,0.875,46,23,5,3
1580,21500351,Golden State Warriors,Milwaukee Bucks,95,108,203,13,Milwaukee Bucks,13,0.222,0.68,49,23,9,8,0.429,0.778,44,31,12,4
1581,21500352,New York Knicks,Portland Trail Blazers,112,110,222,2,New York Knicks,2,0.429,0.893,34,17,3,3,0.286,0.759,39,15,4,0
1582,21500353,Minnesota Timberwolves,Phoenix Suns,101,108,209,7,Phoenix Suns,7,0.421,0.794,38,22,7,4,0.333,0.833,38,28,16,8
1583,21500354,Memphis Grizzlies,Miami Heat,97,100,197,3,Miami Heat,3,0.368,0.714,33,23,10,3,0.318,0.826,35,18,9,1
1584,21500355,Philadelphia 76ers,Toronto Raptors,76,96,172,20,Toronto Raptors,20,0.357,0.714,52,18,1,9,0.318,0.735,41,14,11,9
1585,21500356,Utah Jazz,Oklahoma City Thunder,98,104,202,6,Oklahoma City Thunder,6,0.364,0.6,44,14,6,2,0.333,0.9,42,18,7,13
1586,21500357,Toronto Raptors,Indiana Pacers,90,106,196,16,Indiana Pacers,16,0.357,0.846,45,10,9,6,0.455,0.875,44,14,8,3
1587,21500358,Orlando Magic,Brooklyn Nets,105,82,187,23,Orlando Magic,23,0.429,0.7,43,24,12,3,0.368,0.813,39,23,5,0
1588,21500359,Los Angeles Clippers,Detroit Pistons,105,103,208,2,Los Angeles Clippers,2,0.316,0.733,39,29,9,4,0.316,0.742,54,17,8,0
1589,21500360,Miami Heat,Atlanta Hawks,100,88,188,12,Miami Heat,12,0.438,0.867,54,26,6,5,0.242,0.933,37,25,7,4
1590,21500361,Philadelphia 76ers,Chicago Bulls,96,115,211,19,Chicago Bulls,19,0.355,0.692,36,19,6,8,0.364,0.808,53,28,7,8
1591,21500362,Washington Wizards,Memphis Grizzlies,95,112,207,17,Memphis Grizzlies,17,0.375,0.6,36,22,9,3,0.667,0.933,39,26,8,5
1592,21500363,Phoenix Suns,Dallas Mavericks,94,104,198,10,Dallas Mavericks,10,0.36,0.704,47,19,9,5,0.375,0.762,41,17,12,1
1593,21500364,Utah Jazz,San Antonio Spurs,81,118,199,37,San Antonio Spurs,37,0.273,0.824,32,18,8,3,0.429,0.926,48,24,6,2
1594,21500365,Houston Rockets,Denver Nuggets,108,114,222,6,Denver Nuggets,6,0.45,0.727,26,26,14,1,0.32,0.88,52,26,8,5
1595,21500366,New Orleans Pelicans,Portland Trail Blazers,101,105,206,4,Portland Trail Blazers,4,0.32,0.778,41,15,9,9,0.406,0.759,50,28,7,5
1596,21500367,Cleveland Cavaliers,Boston Celtics,89,77,166,12,Cleveland Cavaliers,12,0.348,0.9,46,17,5,7,0.281,0.857,41,18,6,6
1597,21500368,Denver Nuggets,Minnesota Timberwolves,112,100,212,12,Denver Nuggets,12,0.556,0.741,39,24,9,6,0.4,0.774,31,21,6,6
1598,21500369,Houston Rockets,Sacramento Kings,97,107,204,10,Sacramento Kings,10,0.308,0.739,36,22,17,3,0.458,0.69,47,25,13,3
1599,21500370,Milwaukee Bucks,Los Angeles Lakers,95,113,208,18,Los Angeles Lakers,18,0.308,0.55,38,23,7,7,0.37,0.84,52,26,7,3
1600,21500371,Dallas Mavericks,Indiana Pacers,81,107,188,26,Indiana Pacers,26,0.242,0.7,47,16,2,3,0.379,0.588,47,28,9,4
1601,21500372,Charlotte Hornets,Orlando Magic,98,113,211,15,Orlando Magic,15,0.412,0.8,33,23,12,3,0.583,0.867,40,28,12,4
1602,21500373,Miami Heat,Brooklyn Nets,104,98,202,6,Miami Heat,6,0.333,0.708,45,16,4,6,0.25,0.714,35,24,6,3
1603,21500374,Boston Celtics,Detroit Pistons,116,119,235,3,Detroit Pistons,3,0.4,0.833,44,17,4,2,0.524,0.744,36,13,5,4
1604,21500375,Minnesota Timberwolves,New York Knicks,102,107,209,5,New York Knicks,5,0.19,1,50,21,12,2,0.381,0.833,50,28,2,10
1605,21500376,Philadelphia 76ers,Atlanta Hawks,106,127,233,21,Atlanta Hawks,21,0.462,0.667,32,20,5,2,0.476,0.875,25,32,11,7
1606,21500377,Memphis Grizzlies,Chicago Bulls,85,98,183,13,Chicago Bulls,13,0.263,0.571,41,27,6,5,0.375,0.684,45,22,5,6
1607,21500378,Portland Trail Blazers,Oklahoma City Thunder,90,106,196,16,Oklahoma City Thunder,16,0.423,0.833,47,13,6,3,0.143,0.757,51,13,6,8
1608,21500379,Washington Wizards,San Antonio Spurs,95,114,209,19,San Antonio Spurs,19,0.2,0.88,38,22,6,4,0.364,0.783,43,29,10,9
1609,21500380,New Orleans Pelicans,Utah Jazz,104,94,198,10,New Orleans Pelicans,10,0.476,0.929,36,14,9,2,0.35,0.793,34,17,4,4
1610,21500381,Phoenix Suns,Golden State Warriors,103,128,231,25,Golden State Warriors,25,0.227,0.889,41,28,11,4,0.469,0.778,49,32,12,4
1611,21500382,Milwaukee Bucks,Los Angeles Clippers,90,103,193,13,Los Angeles Clippers,13,0.313,0.818,41,21,9,6,0.524,0.833,40,25,7,4
1612,21500383,Toronto Raptors,Charlotte Hornets,99,109,208,10,Charlotte Hornets,10,0.231,0.714,46,18,7,10,0.345,0.806,51,23,5,9
1613,21500384,Oklahoma City Thunder,Cleveland Cavaliers,100,104,204,4,Cleveland Cavaliers,4,0.3,0.857,36,23,7,7,0.414,0.769,42,29,6,1
1614,21500385,Houston Rockets,Los Angeles Lakers,107,87,194,20,Houston Rockets,20,0.387,0.643,54,22,9,8,0.208,0.556,46,22,5,5
1615,21500386,Brooklyn Nets,Indiana Pacers,97,104,201,7,Indiana Pacers,7,0.5,1,42,18,7,6,0.25,0.885,52,17,4,4
1616,21500387,Portland Trail Blazers,Orlando Magic,94,102,196,8,Orlando Magic,8,0.344,0.731,42,21,3,2,0.133,0.71,48,19,11,5
1617,21500388,New York Knicks,Philadelphia 76ers,107,97,204,10,New York Knicks,10,0.316,0.75,49,24,8,6,0.25,0.567,36,15,7,5
1618,21500389,Atlanta Hawks,Boston Celtics,109,101,210,8,Atlanta Hawks,8,0.2,0.793,42,23,11,4,0.435,0.742,43,19,5,2
1619,21500390,Toronto Raptors,Miami Heat,108,94,202,14,Toronto Raptors,14,0.381,0.818,38,18,11,5,0.36,0.882,34,19,4,6
1620,21500391,Detroit Pistons,Chicago Bulls,147,144,291,3,Detroit Pistons,3,0.276,0.587,64,28,7,4,0.227,0.886,62,21,5,9
1621,21500392,Sacramento Kings,Minnesota Timberwolves,95,99,194,4,Minnesota Timberwolves,4,0.304,0.706,31,22,10,2,0.333,0.938,49,25,2,6
1622,21500393,Los Angeles Clippers,San Antonio Spurs,107,115,222,8,San Antonio Spurs,8,0.417,0.625,37,23,6,8,0.526,0.792,44,25,7,4
1623,21500394,Memphis Grizzlies,Dallas Mavericks,88,97,185,9,Dallas Mavericks,9,0.353,0.917,39,13,11,3,0.345,0.905,50,27,7,4
1624,21500395,Denver Nuggets,Utah Jazz,88,97,185,9,Utah Jazz,9,0.214,0.8,44,15,10,4,0.4,0.76,39,15,8,1
1625,21500396,New Orleans Pelicans,Phoenix Suns,88,104,192,16,Phoenix Suns,16,0.182,0.842,36,13,8,7,0.375,0.588,45,22,10,2
1626,21500397,Milwaukee Bucks,Golden State Warriors,112,121,233,9,Golden State Warriors,9,0.222,0.857,41,25,6,7,0.346,0.757,46,31,7,4
1627,21500398,Los Angeles Lakers,Oklahoma City Thunder,78,118,196,40,Oklahoma City Thunder,40,0.286,0.588,32,14,10,2,0.474,0.68,56,28,6,3
1628,21500399,Charlotte Hornets,Washington Wizards,101,109,210,8,Washington Wizards,8,0.303,0.813,51,23,8,4,0.45,0.87,38,26,10,4
1629,21500400,Chicago Bulls,New York Knicks,91,107,198,16,New York Knicks,16,0.238,0.706,47,17,7,1,0.25,0.833,43,19,6,2
1630,21500401,Los Angeles Clippers,Houston Rockets,97,107,204,10,Houston Rockets,10,0.289,0.621,38,21,10,6,0.32,0.633,55,22,7,7
1631,21500402,Indiana Pacers,Memphis Grizzlies,84,96,180,12,Memphis Grizzlies,12,0.179,0.76,45,12,8,2,0.263,0.81,46,21,9,6
1632,21500403,Minnesota Timberwolves,Brooklyn Nets,100,85,185,15,Minnesota Timberwolves,15,0.25,0.875,46,29,12,5,0.238,0.8,39,26,7,2
1633,21500404,Portland Trail Blazers,Miami Heat,109,116,225,7,Miami Heat,7,0.382,0.818,42,23,7,0,0.522,0.692,30,26,11,7
1634,21500405,Philadelphia 76ers,Cleveland Cavaliers,86,108,194,22,Cleveland Cavaliers,22,0.208,0.7,49,15,6,2,0.44,0.81,40,25,11,6
1635,21500406,Milwaukee Bucks,Phoenix Suns,101,95,196,6,Milwaukee Bucks,6,0.313,0.583,37,25,8,6,0.444,0.875,39,18,8,2
1636,21500407,Atlanta Hawks,Orlando Magic,103,100,203,3,Atlanta Hawks,3,0.5,0.7,41,25,6,7,0.333,0.833,36,27,16,5
1637,21500408,Sacramento Kings,Toronto Raptors,104,94,198,10,Sacramento Kings,10,0.429,0.625,42,26,8,8,0.276,0.941,49,12,8,3
1638,21500409,New Orleans Pelicans,Denver Nuggets,130,125,255,5,New Orleans Pelicans,5,0.458,0.795,36,24,4,11,0.486,0.818,39,26,5,4
1639,21500410,Sacramento Kings,Washington Wizards,99,113,212,14,Washington Wizards,14,0.318,0.818,46,24,8,3,0.583,0.882,38,31,9,5
1640,21500411,Minnesota Timberwolves,Boston Celtics,99,113,212,14,Boston Celtics,14,0.154,0.781,36,20,9,6,0.48,0.563,50,34,6,9
1641,21500412,Orlando Magic,New York Knicks,107,99,206,8,Orlando Magic,8,0.455,0.818,33,19,8,3,0.292,0.875,39,21,5,6
1642,21500413,Portland Trail Blazers,Atlanta Hawks,97,106,203,9,Atlanta Hawks,9,0.208,0.727,50,24,5,4,0.31,0.821,31,21,8,1
1643,21500414,Brooklyn Nets,Chicago Bulls,105,102,207,3,Brooklyn Nets,3,0.35,0.857,51,26,9,4,0.346,0.538,45,32,8,8
1644,21500415,Charlotte Hornets,Houston Rockets,95,102,197,7,Houston Rockets,7,0.293,0.806,35,20,8,3,0.25,0.707,49,18,3,4
1645,21500416,Indiana Pacers,San Antonio Spurs,92,106,198,14,San Antonio Spurs,14,0.368,0.6,48,21,5,3,0.3,0.889,45,27,8,7
1646,21500417,Phoenix Suns,Utah Jazz,89,110,199,21,Utah Jazz,21,0.292,0.909,40,12,3,0,0.36,0.784,47,16,8,6
1647,21500418,Oklahoma City Thunder,Los Angeles Clippers,100,99,199,1,Oklahoma City Thunder,1,0.235,0.8,44,21,10,4,0.318,0.714,45,21,7,3
1648,21500419,Memphis Grizzlies,Philadelphia 76ers,104,90,194,14,Memphis Grizzlies,14,0.333,0.792,36,26,16,3,0.304,0.656,42,19,6,3
1649,21500420,Detroit Pistons,Miami Heat,93,92,185,1,Detroit Pistons,1,0.5,0.571,43,16,3,3,0.222,0.833,40,13,9,7
1650,21500421,Dallas Mavericks,Toronto Raptors,99,103,202,4,Toronto Raptors,4,0.379,0.727,34,23,8,7,0.462,0.778,53,20,4,4
1651,21500422,Los Angeles Lakers,Denver Nuggets,111,107,218,4,Los Angeles Lakers,4,0.269,0.75,40,17,6,6,0.36,0.842,44,26,2,5
1652,21500423,Boston Celtics,Charlotte Hornets,102,89,191,13,Boston Celtics,13,0.241,0.885,49,25,9,4,0.286,0.719,44,19,6,6
1653,21500424,New York Knicks,Cleveland Cavaliers,84,91,175,7,Cleveland Cavaliers,7,0.313,0.938,44,19,5,7,0.227,0.88,48,23,6,4
1654,21500425,Sacramento Kings,Indiana Pacers,108,106,214,2,Sacramento Kings,2,0.174,0.75,49,28,6,4,0.375,0.6,38,20,14,4
1655,21500426,Houston Rockets,Orlando Magic,101,104,205,3,Orlando Magic,3,0.241,0.706,36,19,5,6,0.438,0.692,42,26,5,3
1656,21500427,Memphis Grizzlies,Washington Wizards,91,100,191,9,Washington Wizards,9,0.176,0.688,35,12,13,7,0.44,0.789,44,26,3,2
1657,21500428,Dallas Mavericks,Brooklyn Nets,119,118,237,1,Dallas Mavericks,1,0.471,0.867,34,27,3,4,0.526,0.429,43,32,9,4
1658,21500429,Detroit Pistons,Atlanta Hawks,100,107,207,7,Atlanta Hawks,7,0.333,0.515,46,18,7,9,0.3,0.75,42,25,8,4
1659,21500430,Philadelphia 76ers,Milwaukee Bucks,100,113,213,13,Milwaukee Bucks,13,0.35,0.655,41,24,12,7,0.417,0.75,34,34,14,12
1660,21500431,San Antonio Spurs,Minnesota Timberwolves,108,83,191,25,San Antonio Spurs,25,0.417,0.714,47,24,7,9,0.3,0.8,31,19,5,2
1661,21500432,Portland Trail Blazers,New Orleans Pelicans,89,115,204,26,New Orleans Pelicans,26,0.25,0.667,58,16,7,7,0.419,0.87,49,27,5,8
1662,21500433,Denver Nuggets,Phoenix Suns,104,96,200,8,Denver Nuggets,8,0.4,0.462,50,26,6,7,0.52,0.647,46,21,9,2
1663,21500434,Utah Jazz,Golden State Warriors,85,103,188,18,Golden State Warriors,18,0.35,0.857,40,14,9,3,0.391,1,40,26,10,9
1664,21500435,Oklahoma City Thunder,Los Angeles Lakers,120,85,205,35,Oklahoma City Thunder,35,0.263,0.765,61,23,7,13,0.28,0.636,35,19,6,5
1665,21500436,New Orleans Pelicans,Miami Heat,88,94,182,6,Miami Heat,6,0.3,0.909,45,19,10,3,0.231,0.667,57,19,10,5
1666,21500437,Chicago Bulls,Oklahoma City Thunder,105,96,201,9,Chicago Bulls,9,0.389,0.9,53,22,8,6,0.25,0.696,48,20,12,3
1667,21500438,Cleveland Cavaliers,Golden State Warriors,83,89,172,6,Golden State Warriors,6,0.167,0.72,55,12,6,4,0.278,0.741,49,21,7,10
1668,21500439,San Antonio Spurs,Houston Rockets,84,88,172,4,Houston Rockets,4,0.25,0.875,47,24,11,4,0.467,0.654,42,23,8,2
1669,21500440,Los Angeles Clippers,Los Angeles Lakers,94,84,178,10,Los Angeles Clippers,10,0.385,0.727,45,22,10,3,0.304,0.52,40,17,10,2
1670,21500441,Toronto Raptors,Milwaukee Bucks,111,90,201,21,Toronto Raptors,21,0.448,0.737,44,31,7,10,0.429,0.889,38,25,3,5
1671,21500442,New York Knicks,Atlanta Hawks,98,117,215,19,Atlanta Hawks,19,0.292,0.765,42,25,6,8,0.333,0.833,37,33,13,4
1672,21500443,Memphis Grizzlies,Charlotte Hornets,92,98,190,6,Charlotte Hornets,6,0.368,0.524,48,21,9,5,0.438,0.875,43,21,10,13
1673,21500444,Miami Heat,Orlando Magic,108,101,209,7,Miami Heat,7,0.5,0.957,38,22,5,4,0.474,0.462,34,31,7,2
1674,21500445,Houston Rockets,New Orleans Pelicans,108,110,218,2,New Orleans Pelicans,2,0.455,0.85,35,21,8,3,0.542,0.808,40,25,5,8
1675,21500446,Boston Celtics,Detroit Pistons,99,93,192,6,Boston Celtics,6,0.174,0.739,47,20,6,1,0.24,0.68,51,16,11,2
1676,21500447,Washington Wizards,Brooklyn Nets,111,96,207,15,Washington Wizards,15,0.444,0.682,39,32,10,5,0.294,0.313,50,24,8,5
1677,21500448,Indiana Pacers,Minnesota Timberwolves,102,88,190,14,Indiana Pacers,14,0.346,0.929,39,25,10,2,0.333,0.778,33,22,14,2
1678,21500449,Chicago Bulls,Dallas Mavericks,111,118,229,7,Dallas Mavericks,7,0.381,0.731,41,20,7,7,0.485,0.786,42,24,10,1
1679,21500450,Denver Nuggets,San Antonio Spurs,86,101,187,15,San Antonio Spurs,15,0.278,0.833,36,25,6,3,0.7,0.941,41,21,11,12
1680,21500451,Philadelphia 76ers,Phoenix Suns,111,104,215,7,Philadelphia 76ers,7,0.444,0.852,48,20,9,8,0.37,0.765,41,17,10,3
1681,21500452,Los Angeles Clippers,Utah Jazz,109,104,213,5,Los Angeles Clippers,5,0.5,0.833,34,24,9,6,0.37,0.815,36,18,7,4
1682,21500453,Cleveland Cavaliers,Portland Trail Blazers,76,105,181,29,Portland Trail Blazers,29,0.355,0.6,42,21,4,2,0.409,0.737,49,28,9,3
1683,21500454,New York Knicks,Boston Celtics,91,100,191,9,Boston Celtics,9,0.211,0.875,48,15,6,4,0.4,0.69,51,18,5,4
1684,21500455,Los Angeles Lakers,Memphis Grizzlies,96,112,208,16,Memphis Grizzlies,16,0.276,0.75,46,16,6,5,0.375,0.727,41,30,11,4
1685,21500456,Denver Nuggets,Oklahoma City Thunder,112,122,234,10,Oklahoma City Thunder,10,0.36,0.733,37,24,6,2,0.533,0.857,43,27,5,5
1686,21500457,Portland Trail Blazers,Sacramento Kings,98,94,192,4,Portland Trail Blazers,4,0.303,0.75,52,19,13,5,0.375,0.806,43,22,10,5
1687,21500458,Los Angeles Lakers,Charlotte Hornets,98,108,206,10,Charlotte Hornets,10,0.31,0.826,41,24,7,4,0.24,0.727,46,28,7,6
1688,21500459,Atlanta Hawks,Indiana Pacers,87,93,180,6,Indiana Pacers,6,0.24,0.76,44,16,9,6,0.269,0.556,40,9,16,3
1689,21500460,New Orleans Pelicans,Orlando Magic,89,104,193,15,Orlando Magic,15,0.25,0.667,42,23,5,5,0.412,0.636,37,28,7,1
1690,21500461,Los Angeles Clippers,Washington Wizards,108,91,199,17,Los Angeles Clippers,17,0.304,0.76,37,23,11,4,0.292,0.667,45,19,10,3
1691,21500462,Brooklyn Nets,Miami Heat,111,105,216,6,Brooklyn Nets,6,0.522,0.75,50,20,8,3,0.417,0.767,42,20,9,8
1692,21500463,Toronto Raptors,Chicago Bulls,97,104,201,7,Chicago Bulls,7,0.3,0.625,46,23,5,5,0.381,0.667,49,23,4,10
1693,21500464,Milwaukee Bucks,Dallas Mavericks,93,103,196,10,Dallas Mavericks,10,0.286,0.867,52,14,4,5,0.455,0.654,34,25,9,2
1694,21500465,Minnesota Timberwolves,San Antonio Spurs,95,101,196,6,San Antonio Spurs,6,0.273,0.583,32,25,12,4,0.294,0.786,36,25,5,5
1695,21500466,Cleveland Cavaliers,Phoenix Suns,101,97,198,4,Cleveland Cavaliers,4,0.415,0.72,37,21,8,8,0.44,0.7,44,20,8,1
1696,21500467,Philadelphia 76ers,Utah Jazz,91,95,186,4,Utah Jazz,4,0.238,0.737,37,20,8,9,0.269,0.889,53,13,11,9
1697,21500468,Sacramento Kings,Golden State Warriors,103,122,225,19,Golden State Warriors,19,0.419,0.571,48,23,10,4,0.476,0.667,59,33,12,8
1698,21500469,Detroit Pistons,New York Knicks,96,108,204,12,New York Knicks,12,0.37,0.706,39,21,6,4,0.5,0.824,36,23,5,8
1699,21500470,Atlanta Hawks,Houston Rockets,121,115,236,6,Atlanta Hawks,6,0.341,0.84,45,27,10,7,0.55,0.667,46,23,6,4
1700,21500471,Miami Heat,Memphis Grizzlies,90,99,189,9,Memphis Grizzlies,9,0.379,0.5,38,23,5,6,0.267,0.95,46,25,4,6
1701,21500472,Milwaukee Bucks,Oklahoma City Thunder,123,131,254,8,Oklahoma City Thunder,8,0.625,0.682,47,29,6,5,0.364,0.925,41,21,12,7
1702,21500473,Cleveland Cavaliers,Denver Nuggets,93,87,180,6,Cleveland Cavaliers,6,0.182,0.591,44,17,12,3,0.208,0.727,52,18,8,6
1703,21500474,Los Angeles Clippers,Charlotte Hornets,122,117,239,5,Los Angeles Clippers,5,0.5,0.805,39,27,7,7,0.3,0.889,42,20,8,3
1704,21500475,Brooklyn Nets,Orlando Magic,93,100,193,7,Orlando Magic,7,0.15,0.909,37,23,12,6,0.346,0.905,50,21,6,4
1705,21500476,Los Angeles Lakers,Boston Celtics,112,104,216,8,Los Angeles Lakers,8,0.474,0.739,52,22,5,2,0.259,0.84,45,23,7,5
1706,21500477,Washington Wizards,Toronto Raptors,91,94,185,3,Toronto Raptors,3,0.364,0.765,44,24,8,4,0.25,0.821,55,14,5,6
1707,21500478,Indiana Pacers,Chicago Bulls,100,102,202,2,Chicago Bulls,2,0.318,0.792,46,18,14,7,0.333,0.815,53,15,6,10
1708,21500479,Utah Jazz,Minnesota Timberwolves,80,94,174,14,Minnesota Timberwolves,14,0.256,0.7,44,15,8,8,0.5,0.63,47,27,13,3
1709,21500480,Golden State Warriors,Dallas Mavericks,91,114,205,23,Dallas Mavericks,23,0.368,0.75,37,20,9,0,0.519,0.8,52,20,6,4
1710,21500481,Phoenix Suns,San Antonio Spurs,79,112,191,33,San Antonio Spurs,33,0.278,0.556,36,18,6,3,0.429,0.606,46,26,13,5
1711,21500482,Denver Nuggets,Portland Trail Blazers,103,110,213,7,Portland Trail Blazers,7,0.444,0.895,44,20,9,5,0.375,0.8,47,22,8,6
1712,21500483,Philadelphia 76ers,Sacramento Kings,110,105,215,5,Philadelphia 76ers,5,0.29,0.618,53,23,10,9,0.32,0.61,46,23,5,5
1713,21500484,Milwaukee Bucks,Indiana Pacers,120,116,236,4,Milwaukee Bucks,4,0.429,0.686,34,18,12,10,0.433,0.808,35,27,9,6
1714,21500485,Golden State Warriors,Houston Rockets,114,110,224,4,Golden State Warriors,4,0.478,0.63,43,35,8,5,0.4,0.897,33,21,13,5
1715,21500486,Minnesota Timberwolves,Detroit Pistons,90,115,205,25,Detroit Pistons,25,0.357,0.789,36,22,9,3,0.4,0.679,52,24,7,3
1716,21500487,Los Angeles Clippers,New Orleans Pelicans,95,89,184,6,Los Angeles Clippers,6,0.294,0.789,47,24,8,6,0.28,0.667,42,21,6,3
1717,21500488,Phoenix Suns,Oklahoma City Thunder,106,110,216,4,Oklahoma City Thunder,4,0.4,0.923,37,24,10,3,0.333,0.792,37,29,12,5
1718,21500489,Portland Trail Blazers,Utah Jazz,96,109,205,13,Utah Jazz,13,0.444,0.714,39,19,1,0,0.455,0.727,42,19,7,5
1719,21500490,Orlando Magic,Washington Wizards,91,103,194,12,Washington Wizards,12,0.25,0.75,39,29,6,4,0.308,0.9,46,25,11,5
1720,21500491,Dallas Mavericks,Miami Heat,82,106,188,24,Miami Heat,24,0.226,0.786,40,22,6,3,0.444,0.667,50,24,4,1
1721,21500492,Charlotte Hornets,Toronto Raptors,94,104,198,10,Toronto Raptors,10,0.313,0.889,43,15,7,7,0.455,0.944,54,21,6,4
1722,21500493,New York Knicks,Chicago Bulls,81,108,189,27,Chicago Bulls,27,0.316,0.765,42,16,3,7,0.625,0.8,54,27,4,9
1723,21500494,Philadelphia 76ers,Los Angeles Lakers,84,93,177,9,Los Angeles Lakers,9,0.167,0.72,50,21,6,10,0.313,0.759,50,17,11,6
1724,21500495,Brooklyn Nets,Boston Celtics,100,97,197,3,Brooklyn Nets,3,0.167,0.955,50,23,5,2,0.219,0.786,51,17,8,4
1725,21500496,Phoenix Suns,Sacramento Kings,119,142,261,23,Sacramento Kings,23,0.345,0.821,25,27,9,7,0.391,0.794,46,30,9,2
1726,21500497,Oklahoma City Thunder,Charlotte Hornets,109,90,199,19,Oklahoma City Thunder,19,0.391,0.811,53,20,2,15,0.273,0.765,34,18,7,7
1727,21500498,Detroit Pistons,Indiana Pacers,82,94,176,12,Indiana Pacers,12,0.15,0.565,48,17,5,2,0.389,0.724,47,11,7,9
1728,21500499,Orlando Magic,Cleveland Cavaliers,79,104,183,25,Cleveland Cavaliers,25,0.24,0.882,45,16,1,2,0.324,0.615,53,24,6,1
1729,21500500,Milwaukee Bucks,Minnesota Timberwolves,95,85,180,10,Milwaukee Bucks,10,0.5,0.821,48,20,7,5,0.214,0.667,47,19,10,6
1730,21500501,New Orleans Pelicans,Dallas Mavericks,105,98,203,7,New Orleans Pelicans,7,0.3,0.792,53,19,8,2,0.385,0.842,33,20,10,2
1731,21500502,Houston Rockets,San Antonio Spurs,103,121,224,18,San Antonio Spurs,18,0.409,0.606,37,26,7,4,0.542,0.947,39,31,9,2
1732,21500503,Memphis Grizzlies,Utah Jazz,87,92,179,5,Utah Jazz,5,0.389,0.538,40,17,8,4,0.333,0.75,48,17,4,7
1733,21500504,Denver Nuggets,Golden State Warriors,108,111,219,3,Golden State Warriors,3,0.167,0.652,52,27,7,0,0.357,0.652,47,34,9,5
1734,21500505,Philadelphia 76ers,Los Angeles Clippers,99,130,229,31,Los Angeles Clippers,31,0.391,0.471,33,30,8,4,0.522,0.8,47,28,7,6
1735,21500506,Atlanta Hawks,New York Knicks,97,111,208,14,New York Knicks,14,0.308,0.75,32,26,11,5,0.423,0.857,46,27,8,7
1736,21500507,Chicago Bulls,Toronto Raptors,115,113,228,2,Chicago Bulls,2,0.429,0.88,42,23,4,8,0.419,0.842,37,21,6,8
1737,21500508,Miami Heat,Washington Wizards,97,75,172,22,Miami Heat,22,0.391,0.833,54,27,8,11,0.133,0.692,45,19,5,2
1738,21500509,Portland Trail Blazers,Denver Nuggets,112,106,218,6,Portland Trail Blazers,6,0.435,0.688,41,23,4,3,0.318,0.646,41,20,7,6
1739,21500510,Phoenix Suns,Los Angeles Lakers,77,97,174,20,Los Angeles Lakers,20,0.222,0.778,45,16,8,4,0.364,0.765,54,26,8,7
1740,21500511,Toronto Raptors,Cleveland Cavaliers,100,122,222,22,Cleveland Cavaliers,22,0.421,0.69,26,24,9,5,0.515,0.885,40,25,6,4
1741,21500512,Minnesota Timberwolves,Philadelphia 76ers,99,109,208,10,Philadelphia 76ers,10,0.4,0.792,27,26,11,4,0.2,0.643,37,31,11,10
1742,21500513,Boston Celtics,Brooklyn Nets,103,94,197,9,Boston Celtics,9,0.286,0.789,48,22,10,5,0.214,0.889,53,16,4,6
1743,21500514,Orlando Magic,Detroit Pistons,89,115,204,26,Detroit Pistons,26,0.3,1,30,17,6,7,0.467,0.714,54,25,6,6
1744,21500515,Indiana Pacers,Miami Heat,100,103,203,3,Miami Heat,3,0.286,0.72,55,18,4,3,0.227,0.769,52,14,5,6
1745,21500516,San Antonio Spurs,Milwaukee Bucks,123,98,221,25,San Antonio Spurs,25,0.45,0.8,44,32,11,5,0.25,0.7,35,23,6,5
1746,21500517,Sacramento Kings,Oklahoma City Thunder,116,104,220,12,Sacramento Kings,12,0.412,0.744,48,26,7,8,0.345,0.696,39,23,7,9
1747,21500518,Houston Rockets,Utah Jazz,93,91,184,2,Houston Rockets,2,0.423,0.762,34,17,8,2,0.414,0.76,44,17,9,4
1748,21500519,Memphis Grizzlies,Portland Trail Blazers,91,78,169,13,Memphis Grizzlies,13,0.2,0.692,52,21,10,3,0.25,0.625,42,14,7,4
1749,21500520,Charlotte Hornets,Golden State Warriors,101,111,212,10,Golden State Warriors,10,0.333,0.947,41,15,7,1,0.441,1,37,32,4,9
1750,21500521,New York Knicks,Atlanta Hawks,107,101,208,6,New York Knicks,6,0.278,0.917,46,20,7,6,0.385,0.632,41,22,3,4
1751,21500522,Milwaukee Bucks,Chicago Bulls,106,117,223,11,Chicago Bulls,11,0.375,0.571,43,28,9,3,0.263,1,45,27,5,10
1752,21500523,Sacramento Kings,Dallas Mavericks,116,117,233,1,Dallas Mavericks,1,0.375,0.714,49,27,16,1,0.414,0.652,55,22,13,2
1753,21500524,Golden State Warriors,Los Angeles Lakers,109,88,197,21,Golden State Warriors,21,0.419,0.762,54,26,9,9,0.238,0.833,52,15,7,4
1754,21500525,New York Knicks,Miami Heat,98,90,188,8,New York Knicks,8,0.375,0.944,34,15,6,5,0.118,0.933,35,14,2,4
1755,21500526,Indiana Pacers,Orlando Magic,95,86,181,9,Indiana Pacers,9,0.273,0.862,42,19,11,6,0.194,0.941,39,17,7,6
1756,21500527,Cleveland Cavaliers,Washington Wizards,121,115,236,6,Cleveland Cavaliers,6,0.414,0.684,44,16,9,3,0.583,0.63,33,31,7,1
1757,21500528,Detroit Pistons,Boston Celtics,99,94,193,5,Detroit Pistons,5,0.37,0.639,47,18,4,5,0.214,0.741,39,23,5,5
1758,21500529,Toronto Raptors,Brooklyn Nets,91,74,165,17,Toronto Raptors,17,0.182,0.944,49,16,12,7,0.313,0.583,39,18,8,4
1759,21500530,Denver Nuggets,Minnesota Timberwolves,78,74,152,4,Denver Nuggets,4,0.4,0.706,46,21,3,7,0.273,0.75,40,23,5,5
1760,21500531,Dallas Mavericks,New Orleans Pelicans,100,91,191,9,Dallas Mavericks,9,0.25,0.864,52,22,7,6,0.233,0.8,51,22,7,5
1761,21500532,Utah Jazz,San Antonio Spurs,98,123,221,25,San Antonio Spurs,25,0.389,0.944,34,21,8,3,0.429,0.769,38,34,10,2
1762,21500533,Charlotte Hornets,Phoenix Suns,102,111,213,9,Phoenix Suns,9,0.393,0.682,44,20,9,5,0.576,0.769,39,25,11,2
1763,21500534,Memphis Grizzlies,Oklahoma City Thunder,94,112,206,18,Oklahoma City Thunder,18,0.333,0.708,39,21,9,4,0.471,0.848,52,20,3,6
1764,21500535,Los Angeles Clippers,Portland Trail Blazers,109,98,207,11,Los Angeles Clippers,11,0.478,0.824,42,24,7,6,0.346,0.565,49,21,5,4
1765,21500536,Atlanta Hawks,Philadelphia 76ers,126,98,224,28,Atlanta Hawks,28,0.406,0.789,48,36,18,6,0.278,0.6,43,21,9,4
1766,21500537,Boston Celtics,Chicago Bulls,92,101,193,9,Chicago Bulls,9,0.2,0.773,51,17,11,3,0.409,0.824,54,23,4,5
1767,21500538,Utah Jazz,Houston Rockets,94,103,197,9,Houston Rockets,9,0.25,0.647,35,25,9,5,0.304,0.692,41,15,11,3
1768,21500539,Los Angeles Lakers,Sacramento Kings,115,118,233,3,Sacramento Kings,3,0.333,0.862,33,20,10,4,0.286,0.667,37,32,8,6
1769,21500540,Toronto Raptors,Washington Wizards,97,88,185,9,Toronto Raptors,9,0.357,0.923,47,11,7,13,0.32,0.933,35,18,9,9
1770,21500541,Orlando Magic,Brooklyn Nets,83,77,160,6,Orlando Magic,6,0.464,0.667,49,25,7,4,0.318,0.6,41,17,4,2
1771,21500542,Denver Nuggets,Memphis Grizzlies,84,91,175,7,Memphis Grizzlies,7,0.211,0.842,59,19,2,4,0.444,0.767,43,14,10,6
1772,21500543,Cleveland Cavaliers,Minnesota Timberwolves,125,99,224,26,Cleveland Cavaliers,26,0.481,0.897,43,23,8,5,0.438,0.769,33,24,8,2
1773,21500544,Indiana Pacers,New Orleans Pelicans,91,86,177,5,Indiana Pacers,5,0.238,0.737,54,21,7,7,0.31,0.75,37,21,21,5
1774,21500545,Dallas Mavericks,Milwaukee Bucks,95,96,191,1,Milwaukee Bucks,1,0.318,0.688,42,27,6,5,0.444,0.621,43,24,11,4
1775,21500546,New York Knicks,San Antonio Spurs,99,100,199,1,San Antonio Spurs,1,0.429,0.824,44,19,1,4,0.308,0.824,49,23,5,9
1776,21500547,Miami Heat,Phoenix Suns,103,95,198,8,Miami Heat,8,0.389,0.8,41,23,9,6,0.25,0.692,46,15,5,4
1777,21500548,Golden State Warriors,Portland Trail Blazers,128,108,236,20,Golden State Warriors,20,0.563,0.857,48,36,6,5,0.364,0.714,45,21,12,4
1778,21500549,Oklahoma City Thunder,Los Angeles Lakers,117,113,230,4,Oklahoma City Thunder,4,0.294,0.846,45,17,8,3,0.346,0.96,34,19,9,5
1779,21500550,Charlotte Hornets,Los Angeles Clippers,83,97,180,14,Los Angeles Clippers,14,0.304,0.737,47,14,4,3,0.258,0.9,47,19,6,9
1780,21500551,Chicago Bulls,Atlanta Hawks,105,120,225,15,Atlanta Hawks,15,0.389,0.839,46,16,7,6,0.417,0.8,40,33,15,13
1781,21500552,Washington Wizards,Orlando Magic,105,99,204,6,Washington Wizards,6,0.565,0.8,27,29,10,3,0.357,0.75,37,22,9,2
1782,21500553,Brooklyn Nets,Detroit Pistons,89,103,192,14,Detroit Pistons,14,0.556,0.8,38,24,5,3,0.296,0.643,47,23,10,5
1783,21500554,Toronto Raptors,Philadelphia 76ers,108,95,203,13,Toronto Raptors,13,0.294,0.778,37,19,7,7,0.647,0.429,35,26,9,5
1784,21500555,Miami Heat,Utah Jazz,83,98,181,15,Utah Jazz,15,0.316,0.529,39,14,7,8,0.45,0.611,37,19,10,7
1785,21500556,Golden State Warriors,Sacramento Kings,128,116,244,12,Golden State Warriors,12,0.514,0.733,48,35,5,8,0.348,0.759,34,27,8,3
1786,21500557,Dallas Mavericks,Minnesota Timberwolves,93,87,180,6,Dallas Mavericks,6,0.3,0.714,39,20,7,3,0.25,0.773,38,23,8,2
1787,21500558,New Orleans Pelicans,Los Angeles Clippers,111,114,225,3,Los Angeles Clippers,3,0.267,0.793,56,20,8,2,0.333,0.529,47,26,8,3
1788,21500559,Cleveland Cavaliers,Philadelphia 76ers,95,85,180,10,Cleveland Cavaliers,10,0.281,0.696,51,20,9,2,0.333,0.474,48,22,6,7
1789,21500560,Boston Celtics,Memphis Grizzlies,98,101,199,3,Memphis Grizzlies,3,0.318,0.739,39,22,17,4,0.25,0.875,58,12,8,9
1790,21500561,Indiana Pacers,Houston Rockets,103,107,210,4,Houston Rockets,4,0.29,0.8,39,33,12,5,0.368,0.652,49,24,11,3
1791,21500562,Milwaukee Bucks,New York Knicks,88,100,188,12,New York Knicks,12,0.231,0.7,42,19,7,4,0.292,0.833,43,25,5,7
1792,21500563,Charlotte Hornets,Denver Nuggets,92,95,187,3,Denver Nuggets,3,0.333,0.833,40,24,6,4,0.444,0.826,44,25,7,7
1793,21500564,Oklahoma City Thunder,Portland Trail Blazers,110,115,225,5,Portland Trail Blazers,5,0.476,0.722,42,23,8,6,0.432,0.857,52,27,7,4
1794,21500565,Utah Jazz,Los Angeles Lakers,86,74,160,12,Utah Jazz,12,0.313,0.76,45,16,8,8,0.143,0.867,41,15,9,4
1795,21500566,San Antonio Spurs,Brooklyn Nets,106,79,185,27,San Antonio Spurs,27,0.308,0.737,40,27,8,4,0.167,0.846,30,15,5,3
1796,21500567,Washington Wizards,Chicago Bulls,114,100,214,14,Washington Wizards,14,0.375,0.9,43,31,10,7,0.409,0.852,44,18,5,6
1797,21500568,Miami Heat,Golden State Warriors,103,111,214,8,Golden State Warriors,8,0.368,0.875,47,31,2,4,0.304,0.733,49,25,5,1
1798,21500569,Phoenix Suns,Indiana Pacers,97,116,213,19,Indiana Pacers,19,0.32,0.63,45,24,6,3,0.417,0.774,41,25,13,5
1799,21500570,San Antonio Spurs,Detroit Pistons,109,99,208,10,San Antonio Spurs,10,0.357,0.815,49,20,9,5,0.261,0.654,41,22,8,2
1800,21500571,Boston Celtics,New York Knicks,114,120,234,6,New York Knicks,6,0.31,0.808,42,25,5,4,0.35,0.9,39,24,5,5
1801,21500572,Houston Rockets,Memphis Grizzlies,107,91,198,16,Houston Rockets,16,0.514,0.852,42,21,10,4,0.389,0.75,31,22,9,3
1802,21500573,Chicago Bulls,Milwaukee Bucks,101,106,207,5,Milwaukee Bucks,5,0.414,0.792,57,22,3,8,0.231,0.607,40,28,11,9
1803,21500574,Oklahoma City Thunder,Minnesota Timberwolves,101,96,197,5,Oklahoma City Thunder,5,0.409,0.778,41,21,10,3,0.389,0.739,45,22,7,6
1804,21500575,Cleveland Cavaliers,Dallas Mavericks,110,107,217,3,Cleveland Cavaliers,3,0.386,0.813,46,28,12,4,0.393,0.818,44,25,4,7
1805,21500576,New Orleans Pelicans,Los Angeles Lakers,91,95,186,4,Los Angeles Lakers,4,0.261,0.643,51,20,2,6,0.207,0.781,47,16,7,4
1806,21500577,Atlanta Hawks,Charlotte Hornets,84,107,191,23,Charlotte Hornets,23,0.28,0.81,37,17,5,4,0.333,0.846,54,26,8,9
1807,21500578,Milwaukee Bucks,Washington Wizards,101,106,207,5,Washington Wizards,5,0.125,0.706,47,23,10,2,0.444,0.75,30,27,18,4
1808,21500579,New York Knicks,Brooklyn Nets,104,110,214,6,Brooklyn Nets,6,0.318,0.652,47,19,10,3,0.529,0.786,45,24,8,3
1809,21500580,Indiana Pacers,Boston Celtics,94,103,197,9,Boston Celtics,9,0.167,0.75,48,18,12,3,0.346,0.7,49,24,7,2
1810,21500581,Minnesota Timberwolves,Houston Rockets,104,107,211,3,Houston Rockets,3,0.471,0.8,43,25,11,1,0.233,0.684,39,19,11,3
1811,21500582,Dallas Mavericks,Oklahoma City Thunder,89,108,197,19,Oklahoma City Thunder,19,0.194,0.76,41,18,7,3,0.455,0.586,54,24,11,5
1812,21500583,Golden State Warriors,Denver Nuggets,110,112,222,2,Denver Nuggets,2,0.385,0.8,39,25,9,11,0.227,0.892,49,22,7,3
1813,21500584,Utah Jazz,Portland Trail Blazers,85,99,184,14,Portland Trail Blazers,14,0.421,0.682,38,20,8,6,0.423,0.667,54,25,7,10
1814,21500585,New Orleans Pelicans,Sacramento Kings,109,97,206,12,New Orleans Pelicans,12,0.485,0.818,45,27,10,3,0.261,0.643,52,21,4,7
1815,21500586,Miami Heat,Los Angeles Clippers,90,104,194,14,Los Angeles Clippers,14,0.375,0.655,49,26,5,7,0.44,0.813,43,26,18,5
1816,21500587,Chicago Bulls,Philadelphia 76ers,115,111,226,4,Chicago Bulls,4,0.412,0.839,53,17,9,2,0.444,0.75,34,23,13,5
1817,21500588,Toronto Raptors,Orlando Magic,106,103,209,3,Toronto Raptors,3,0.333,0.774,47,20,11,11,0.391,0.75,46,28,4,9
1818,21500589,Detroit Pistons,Memphis Grizzlies,101,103,204,2,Memphis Grizzlies,2,0.469,0.706,35,18,3,2,0.563,0.8,29,21,13,3
1819,21500590,Cleveland Cavaliers,San Antonio Spurs,95,99,194,4,San Antonio Spurs,4,0.385,0.818,43,15,4,2,0.294,0.818,45,17,6,7
1820,21500591,Sacramento Kings,Utah Jazz,103,101,204,2,Sacramento Kings,2,0.455,0.714,54,19,12,2,0.176,0.735,38,12,8,3
1821,21500592,Los Angeles Lakers,Golden State Warriors,98,116,214,18,Golden State Warriors,18,0.174,0.583,47,17,13,3,0.394,0.85,47,26,12,4
1822,21500593,Washington Wizards,Indiana Pacers,118,104,222,14,Washington Wizards,14,0.44,0.5,54,26,8,2,0.176,0.781,35,19,9,3
1823,21500594,Minnesota Timberwolves,Oklahoma City Thunder,93,113,206,20,Oklahoma City Thunder,20,0.417,0.87,45,15,3,2,0.217,0.636,40,31,10,7
1824,21500595,Phoenix Suns,Boston Celtics,103,117,220,14,Boston Celtics,14,0.37,0.821,45,24,9,5,0.467,0.655,56,30,12,5
1825,21500596,Portland Trail Blazers,Brooklyn Nets,116,104,220,12,Portland Trail Blazers,12,0.429,0.636,42,26,7,5,0.421,0.714,46,22,6,5
1826,21500597,Dallas Mavericks,Chicago Bulls,83,77,160,6,Dallas Mavericks,6,0.364,0.882,43,20,1,6,0.105,0.867,47,16,6,2
1827,21500598,Charlotte Hornets,New Orleans Pelicans,107,109,216,2,New Orleans Pelicans,2,0.4,0.75,38,21,1,1,0.444,0.846,38,29,7,7
1828,21500599,Atlanta Hawks,Milwaukee Bucks,101,108,209,7,Milwaukee Bucks,7,0.3,1,43,29,5,9,0.3,0.676,60,19,9,13
1829,21500600,Miami Heat,Denver Nuggets,98,95,193,3,Miami Heat,3,0.333,0.737,42,26,5,13,0.333,0.962,37,23,4,6
1830,21500601,Cleveland Cavaliers,Houston Rockets,91,77,168,14,Cleveland Cavaliers,14,0.229,0.652,49,19,10,6,0.24,0.655,40,15,10,6
1831,21500602,Brooklyn Nets,Atlanta Hawks,86,114,200,28,Atlanta Hawks,28,0.3,0.632,36,22,5,3,0.276,0.75,40,34,14,5
1832,21500603,Milwaukee Bucks,Charlotte Hornets,105,92,197,13,Milwaukee Bucks,13,0.417,0.846,46,23,3,11,0.25,0.773,35,27,8,2
1833,21500604,Boston Celtics,Washington Wizards,119,117,236,2,Boston Celtics,2,0.31,0.889,47,27,7,3,0.273,0.861,42,25,13,5
1834,21500605,Golden State Warriors,Detroit Pistons,95,113,208,18,Detroit Pistons,18,0.4,0.739,47,18,6,9,0.348,0.55,57,22,8,11
1835,21500606,Portland Trail Blazers,Philadelphia 76ers,89,114,203,25,Philadelphia 76ers,25,0.172,0.667,38,17,6,4,0.435,0.667,45,27,9,8
1836,21500607,New York Knicks,Memphis Grizzlies,95,103,198,8,Memphis Grizzlies,8,0.25,0.833,36,20,4,6,0.5,0.769,44,24,2,5
1837,21500608,Los Angeles Lakers,Utah Jazz,82,109,191,27,Utah Jazz,27,0.391,0.611,44,16,4,4,0.5,0.833,51,17,8,8
1838,21500609,Sacramento Kings,Los Angeles Clippers,110,103,213,7,Sacramento Kings,7,0.52,0.758,52,28,5,8,0.333,0.737,46,24,6,4
1839,21500610,Phoenix Suns,Minnesota Timberwolves,87,117,204,30,Minnesota Timberwolves,30,0.2,0.56,30,16,5,2,0.389,0.8,41,23,11,7
1840,21500611,Miami Heat,Oklahoma City Thunder,74,99,173,25,Oklahoma City Thunder,25,0.286,0.909,36,12,6,9,0.318,1,44,24,11,8
1841,21500612,Dallas Mavericks,San Antonio Spurs,83,112,195,29,San Antonio Spurs,29,0.261,0.76,45,20,4,6,0.25,0.821,51,22,7,5
1842,21500613,Indiana Pacers,Denver Nuggets,126,129,255,3,Denver Nuggets,3,0.45,0.7,33,27,10,6,0.385,0.711,42,25,12,4
1843,21500614,Houston Rockets,Los Angeles Lakers,112,95,207,17,Houston Rockets,17,0.286,0.75,51,21,10,5,0.316,0.789,36,25,8,7
1844,21500615,Philadelphia 76ers,New York Knicks,113,119,232,6,New York Knicks,6,0.357,0.52,51,27,9,7,0.4,0.833,53,26,6,8
1845,21500616,Utah Jazz,Charlotte Hornets,119,124,243,5,Charlotte Hornets,5,0.333,0.8,49,27,6,7,0.519,0.875,50,20,6,4
1846,21500617,Portland Trail Blazers,Washington Wizards,108,98,206,10,Portland Trail Blazers,10,0.548,0.455,48,25,5,2,0.429,0.75,35,25,6,3
1847,21500618,New Orleans Pelicans,Memphis Grizzlies,99,101,200,2,Memphis Grizzlies,2,0.316,0.913,34,19,8,5,0.421,0.767,40,27,9,3
1848,21500619,Chicago Bulls,Detroit Pistons,111,101,212,10,Chicago Bulls,10,0.429,0.7,38,28,6,6,0.192,0.6,50,18,8,2
1849,21500620,Orlando Magic,Atlanta Hawks,81,98,179,17,Atlanta Hawks,17,0.273,0.75,42,21,11,5,0.474,0.7,47,31,9,6
1850,21500621,Brooklyn Nets,Toronto Raptors,100,112,212,12,Toronto Raptors,12,0.357,0.895,40,24,4,4,0.542,0.722,36,24,8,4
1851,21500622,Golden State Warriors,Cleveland Cavaliers,132,98,230,34,Golden State Warriors,34,0.475,0.778,37,33,7,2,0.368,0.68,36,22,3,4
1852,21500623,Boston Celtics,Dallas Mavericks,113,118,231,5,Dallas Mavericks,5,0.4,0.808,49,24,9,3,0.471,0.917,51,23,4,2
1853,21500624,Houston Rockets,Los Angeles Clippers,132,140,272,8,Los Angeles Clippers,8,0.344,0.635,52,31,8,5,0.595,0.727,41,28,10,6
1854,21500625,Milwaukee Bucks,Miami Heat,91,79,170,12,Milwaukee Bucks,12,0.417,0.875,39,19,6,4,0.227,0.769,38,13,6,2
1855,21500626,Minnesota Timberwolves,New Orleans Pelicans,99,114,213,15,New Orleans Pelicans,15,0.214,0.774,39,18,10,7,0.435,0.87,40,21,9,6
1856,21500627,Oklahoma City Thunder,Denver Nuggets,110,104,214,6,Oklahoma City Thunder,6,0.214,0.733,52,30,11,5,0.35,0.75,48,21,5,6
1857,21500628,Indiana Pacers,Phoenix Suns,97,94,191,3,Indiana Pacers,3,0.2,0.735,46,14,16,6,0.314,0.931,53,15,4,2
1858,21500629,Philadelphia 76ers,Orlando Magic,96,87,183,9,Philadelphia 76ers,9,0.474,0.714,41,20,8,8,0.235,0.654,47,19,12,3
1859,21500630,Miami Heat,Washington Wizards,87,106,193,19,Washington Wizards,19,0.467,0.778,31,23,3,4,0.313,0.846,34,27,11,3
1860,21500631,Cleveland Cavaliers,Brooklyn Nets,91,78,169,13,Cleveland Cavaliers,13,0.294,0.7,45,15,6,3,0.211,0.5,39,20,4,4
1861,21500632,Utah Jazz,New York Knicks,111,118,229,7,New York Knicks,7,0.444,0.806,40,19,4,4,0.412,0.944,38,20,3,7
1862,21500633,Boston Celtics,Toronto Raptors,109,115,224,6,Toronto Raptors,6,0.462,0.733,33,30,8,1,0.379,0.706,37,23,7,5
1863,21500634,Golden State Warriors,Chicago Bulls,125,94,219,31,Golden State Warriors,31,0.375,0.65,55,38,8,9,0.05,0.792,49,14,4,4
1864,21500635,Detroit Pistons,Houston Rockets,123,114,237,9,Detroit Pistons,9,0.4,0.593,52,23,8,7,0.5,0.889,48,21,7,3
1865,21500636,Charlotte Hornets,Oklahoma City Thunder,95,109,204,14,Oklahoma City Thunder,14,0.333,0.857,34,17,8,2,0.375,0.733,51,28,9,3
1866,21500637,Minnesota Timberwolves,Dallas Mavericks,94,106,200,12,Dallas Mavericks,12,0.217,0.818,52,26,4,9,0.2,0.773,46,18,11,2
1867,21500638,Sacramento Kings,Los Angeles Lakers,112,93,205,19,Sacramento Kings,19,0.3,0.714,59,28,6,12,0.16,0.806,41,17,6,5
1868,21500639,Atlanta Hawks,Portland Trail Blazers,104,98,202,6,Atlanta Hawks,6,0.417,0.696,43,25,7,3,0.29,0.636,50,23,5,4
1869,21500640,Los Angeles Clippers,Cleveland Cavaliers,102,115,217,13,Cleveland Cavaliers,13,0.24,0.667,35,19,9,3,0.464,0.75,47,29,5,2
1870,21500641,Detroit Pistons,New Orleans Pelicans,99,115,214,16,New Orleans Pelicans,16,0.233,0.8,44,17,5,2,0.417,1,44,26,8,5
1871,21500642,Memphis Grizzlies,Denver Nuggets,102,101,203,1,Memphis Grizzlies,1,0.286,0.828,37,21,7,6,0.3,0.769,40,26,6,1
1872,21500643,Atlanta Hawks,Sacramento Kings,88,91,179,3,Sacramento Kings,3,0.242,0.667,42,21,15,9,0.292,0.75,56,24,13,4
1873,21500644,San Antonio Spurs,Phoenix Suns,117,89,206,28,San Antonio Spurs,28,0.643,0.857,43,24,8,6,0.333,0.826,43,18,3,4
1874,21500645,Charlotte Hornets,Orlando Magic,120,116,236,4,Charlotte Hornets,4,0.37,0.909,48,23,10,4,0.478,0.789,48,31,6,9
1875,21500646,Chicago Bulls,Boston Celtics,101,110,211,9,Boston Celtics,9,0.231,0.846,50,11,7,4,0.348,0.762,46,26,14,6
1876,21500647,Utah Jazz,Brooklyn Nets,108,86,194,22,Utah Jazz,22,0.563,0.867,40,28,5,4,0.375,0.778,24,24,5,2
1877,21500648,Los Angeles Clippers,New York Knicks,116,88,204,28,Los Angeles Clippers,28,0.565,0.708,36,27,10,3,0.222,0.9,42,24,5,2
1878,21500649,Miami Heat,Toronto Raptors,81,101,182,20,Toronto Raptors,20,0.235,0.647,42,13,4,2,0.52,0.857,41,19,4,8
1879,21500650,Milwaukee Bucks,Houston Rockets,98,102,200,4,Houston Rockets,4,0.214,0.773,48,30,7,10,0.341,0.688,42,27,10,10
1880,21500651,Oklahoma City Thunder,Dallas Mavericks,109,106,215,3,Oklahoma City Thunder,3,0.267,0.733,47,18,3,6,0.303,0.889,33,24,9,6
1881,21500652,Indiana Pacers,Golden State Warriors,110,122,232,12,Golden State Warriors,12,0.176,0.704,44,22,11,4,0.424,0.88,50,31,9,4
1882,21500653,San Antonio Spurs,Los Angeles Lakers,108,95,203,13,San Antonio Spurs,13,0.524,0.846,35,26,10,13,0.375,0.722,45,19,3,5
1883,21500654,Utah Jazz,Washington Wizards,89,103,192,14,Washington Wizards,14,0.267,0.793,48,20,9,6,0.389,0.571,36,25,14,10
1884,21500655,New York Knicks,Charlotte Hornets,84,97,181,13,Charlotte Hornets,13,0.292,0.594,51,23,4,8,0.29,0.865,49,17,5,3
1885,21500656,Boston Celtics,Philadelphia 76ers,112,92,204,20,Boston Celtics,20,0.44,0.789,51,29,14,2,0.308,0.7,47,17,12,6
1886,21500657,Milwaukee Bucks,New Orleans Pelicans,99,116,215,17,New Orleans Pelicans,17,0.4,0.833,43,20,3,6,0.548,0.765,41,33,10,4
1887,21500658,Memphis Grizzlies,Minnesota Timberwolves,101,106,207,5,Minnesota Timberwolves,5,0.474,0.818,34,22,9,3,0.294,0.917,38,26,7,5
1888,21500659,Chicago Bulls,Cleveland Cavaliers,96,83,179,13,Chicago Bulls,13,0.412,0.867,53,21,2,5,0.167,0.409,48,17,5,5
1889,21500660,Atlanta Hawks,Phoenix Suns,95,98,193,3,Phoenix Suns,3,0.353,0.833,43,23,8,7,0.417,0.769,52,22,10,6
1890,21500661,Detroit Pistons,Denver Nuggets,101,104,205,3,Denver Nuggets,3,0.379,0.526,51,23,4,5,0.364,0.828,32,18,15,4
1891,21500662,Los Angeles Lakers,Portland Trail Blazers,103,121,224,18,Portland Trail Blazers,18,0.412,0.875,30,14,4,6,0.323,0.773,42,26,12,1
1892,21500663,Indiana Pacers,Sacramento Kings,97,108,205,11,Sacramento Kings,11,0.368,0.72,41,18,7,10,0.313,0.75,52,19,7,4
1893,21500664,Oklahoma City Thunder,Brooklyn Nets,106,116,222,10,Brooklyn Nets,10,0.308,0.632,46,20,7,5,0.471,0.72,49,24,10,7
1894,21500665,Dallas Mavericks,Houston Rockets,104,115,219,11,Houston Rockets,11,0.5,0.773,36,17,4,4,0.341,0.667,40,27,9,7
1895,21500666,Los Angeles Clippers,Toronto Raptors,94,112,206,18,Toronto Raptors,18,0.308,0.6,34,21,6,3,0.545,0.692,44,19,8,3
1896,21500667,Minnesota Timberwolves,Cleveland Cavaliers,107,114,221,7,Cleveland Cavaliers,7,0.25,0.913,38,28,10,2,0.355,0.65,43,30,7,3
1897,21500668,Boston Celtics,Washington Wizards,116,91,207,25,Boston Celtics,25,0.409,0.826,43,31,12,1,0.292,0.667,39,24,5,3
1898,21500669,Miami Heat,Chicago Bulls,89,84,173,5,Miami Heat,5,0.214,0.706,46,21,7,3,0.278,0.75,49,18,5,3
1899,21500670,Orlando Magic,Memphis Grizzlies,102,108,210,6,Memphis Grizzlies,6,0.357,0.857,46,24,2,6,0.333,0.64,54,25,12,5
1900,21500671,Houston Rockets,New Orleans Pelicans,112,111,223,1,Houston Rockets,1,0.475,0.81,38,22,7,5,0.448,0.56,50,23,8,4
1901,21500672,Atlanta Hawks,Denver Nuggets,119,105,224,14,Atlanta Hawks,14,0.333,0.923,42,28,11,3,0.3,0.892,43,18,10,3
1902,21500673,Detroit Pistons,Utah Jazz,95,92,187,3,Detroit Pistons,3,0.5,0.485,42,19,7,1,0.31,0.833,49,18,5,4
1903,21500674,Charlotte Hornets,Sacramento Kings,129,128,257,1,Charlotte Hornets,1,0.455,0.808,46,27,11,2,0.304,0.781,56,36,4,8
1904,21500675,San Antonio Spurs,Golden State Warriors,90,120,210,30,Golden State Warriors,30,0.357,0.742,38,21,11,4,0.423,0.84,45,31,15,3
1905,21500676,Los Angeles Clippers,Indiana Pacers,91,89,180,2,Los Angeles Clippers,2,0.405,0.5,44,16,9,5,0.313,0.583,48,18,7,2
1906,21500677,Phoenix Suns,Philadelphia 76ers,103,113,216,10,Philadelphia 76ers,10,0.316,0.679,45,27,6,6,0.393,0.667,41,25,9,6
1907,21500678,Miami Heat,Brooklyn Nets,102,98,200,4,Miami Heat,4,0.333,0.9,37,27,10,4,0.5,0.739,32,24,5,2
1908,21500679,Oklahoma City Thunder,New York Knicks,128,122,250,6,Oklahoma City Thunder,6,0.55,0.862,59,23,7,2,0.478,0.767,42,24,9,7
1909,21500680,Washington Wizards,Toronto Raptors,89,106,195,17,Toronto Raptors,17,0.267,0.75,35,20,7,3,0.379,0.781,48,20,7,3
1910,21500681,Orlando Magic,Milwaukee Bucks,100,107,207,7,Milwaukee Bucks,7,0.542,0.724,39,22,6,4,0.385,0.839,45,22,5,7
1911,21500682,Sacramento Kings,Portland Trail Blazers,97,112,209,15,Portland Trail Blazers,15,0.368,0.563,45,26,7,5,0.3,0.789,48,28,6,8
1912,21500683,Dallas Mavericks,Los Angeles Lakers,92,90,182,2,Dallas Mavericks,2,0.24,0.769,35,21,5,1,0.28,0.821,47,15,4,7
1913,21500684,Phoenix Suns,Cleveland Cavaliers,93,115,208,22,Cleveland Cavaliers,22,0.4,0.76,34,25,6,2,0.393,0.875,37,34,12,3
1914,21500685,Denver Nuggets,Boston Celtics,103,111,214,8,Boston Celtics,8,0.333,0.75,53,23,4,6,0.321,0.833,48,29,15,5
1915,21500686,Philadelphia 76ers,Detroit Pistons,97,110,207,13,Detroit Pistons,13,0.368,0.706,38,24,6,7,0.238,0.711,51,15,9,2
1916,21500687,Los Angeles Clippers,Atlanta Hawks,85,83,168,2,Los Angeles Clippers,2,0.185,0.667,46,18,16,5,0.435,0.5,49,21,6,3
1917,21500688,Oklahoma City Thunder,Minnesota Timberwolves,126,123,249,3,Oklahoma City Thunder,3,0.5,0.952,47,23,0,6,0.357,0.643,35,31,6,4
1918,21500689,Houston Rockets,San Antonio Spurs,99,130,229,31,San Antonio Spurs,31,0.267,0.673,40,14,7,11,0.522,0.857,49,34,7,3
1919,21500690,Charlotte Hornets,Utah Jazz,73,102,175,29,Utah Jazz,29,0.24,0.81,35,10,6,0,0.387,0.667,45,23,10,6
1920,21500691,Dallas Mavericks,Golden State Warriors,107,127,234,20,Golden State Warriors,20,0.355,0.667,34,20,4,0,0.483,0.905,40,33,5,4
1921,21500692,Atlanta Hawks,Indiana Pacers,92,111,203,19,Indiana Pacers,19,0.25,0.905,32,20,9,4,0.6,0.867,49,20,10,8
1922,21500693,Denver Nuggets,Washington Wizards,117,113,230,4,Denver Nuggets,4,0.5,0.788,39,25,9,5,0.393,0.8,41,21,13,7
1923,21500694,New York Knicks,Toronto Raptors,93,103,196,10,Toronto Raptors,10,0.389,0.5,40,20,6,8,0.4,0.724,50,21,7,11
1924,21500695,Milwaukee Bucks,Memphis Grizzlies,83,103,186,20,Memphis Grizzlies,20,0.063,0.889,46,17,8,3,0.357,0.85,37,28,7,5
1925,21500696,Sacramento Kings,New Orleans Pelicans,105,114,219,9,New Orleans Pelicans,9,0.357,0.75,40,29,6,8,0.385,0.75,47,25,9,6
1926,21500697,Chicago Bulls,Los Angeles Lakers,114,91,205,23,Chicago Bulls,23,0.353,0.875,51,29,12,5,0.36,0.783,41,21,6,4
1927,21500698,Orlando Magic,Boston Celtics,94,113,207,19,Boston Celtics,19,0.35,0.793,41,17,9,4,0.417,0.81,46,28,8,6
1928,21500699,Cleveland Cavaliers,Detroit Pistons,114,106,220,8,Cleveland Cavaliers,8,0.391,0.931,47,20,4,1,0.304,0.731,39,20,5,4
1929,21500700,Phoenix Suns,New York Knicks,84,102,186,18,New York Knicks,18,0.269,0.583,47,20,4,5,0.35,0.885,49,24,12,7
1930,21500701,Houston Rockets,Oklahoma City Thunder,108,116,224,8,Oklahoma City Thunder,8,0.231,0.628,40,23,14,7,0.421,0.867,57,23,6,7
1931,21500702,Brooklyn Nets,Dallas Mavericks,79,91,170,12,Dallas Mavericks,12,0.2,0.826,44,13,10,2,0.381,0.6,49,22,6,5
1932,21500703,Miami Heat,Milwaukee Bucks,107,103,210,4,Miami Heat,4,0.389,0.813,34,27,12,9,0.167,0.893,40,18,10,5
1933,21500704,Minnesota Timberwolves,Utah Jazz,90,103,193,13,Utah Jazz,13,0.2,0.692,38,17,9,2,0.4,0.813,40,24,8,5
1934,21500705,Charlotte Hornets,Portland Trail Blazers,91,109,200,18,Portland Trail Blazers,18,0.345,0.679,47,17,9,4,0.35,0.75,51,24,10,4
1935,21500706,Los Angeles Lakers,Los Angeles Clippers,93,105,198,12,Los Angeles Clippers,12,0.385,0.8,48,19,6,4,0.308,0.708,38,20,10,9
1936,21500707,Golden State Warriors,Philadelphia 76ers,108,105,213,3,Golden State Warriors,3,0.433,0.5,57,37,5,7,0.345,0.524,40,23,18,4
1937,21500708,Detroit Pistons,Toronto Raptors,107,111,218,4,Toronto Raptors,4,0.31,0.588,39,9,10,6,0.286,0.745,45,12,9,3
1938,21500709,Denver Nuggets,Indiana Pacers,105,109,214,4,Indiana Pacers,4,0.222,0.84,45,24,10,3,0.333,0.75,49,26,6,10
1939,21500710,Brooklyn Nets,New Orleans Pelicans,103,105,208,2,New Orleans Pelicans,2,0.45,0.609,44,23,6,5,0.407,0.8,48,24,6,6
1940,21500711,Washington Wizards,Houston Rockets,123,122,245,1,Washington Wizards,1,0.344,0.733,45,30,6,5,0.486,0.697,37,24,8,3
1941,21500712,Sacramento Kings,Memphis Grizzlies,117,121,238,4,Memphis Grizzlies,4,0.375,0.842,51,16,10,3,0.444,0.838,32,23,15,9
1942,21500713,San Antonio Spurs,Cleveland Cavaliers,103,117,220,14,Cleveland Cavaliers,14,0.333,0.81,32,20,2,2,0.391,0.857,43,24,4,4
1943,21500714,Chicago Bulls,Los Angeles Clippers,93,120,213,27,Los Angeles Clippers,27,0.333,0.727,42,19,2,4,0.531,0.684,46,26,8,6
1944,21500715,Atlanta Hawks,Miami Heat,87,105,192,18,Miami Heat,18,0.227,0.875,31,13,10,3,0.25,0.846,47,21,10,4
1945,21500716,Boston Celtics,Orlando Magic,114,119,233,5,Orlando Magic,5,0.348,0.8,41,17,9,2,0.417,0.6,50,27,7,6
1946,21500717,Phoenix Suns,Dallas Mavericks,78,91,169,13,Dallas Mavericks,13,0.217,0.792,44,13,7,6,0.276,0.913,42,15,9,1
1947,21500718,Golden State Warriors,New York Knicks,116,95,211,21,Golden State Warriors,21,0.552,0.696,44,31,8,5,0.333,0.885,41,19,6,4
1948,21500719,Minnesota Timberwolves,Portland Trail Blazers,93,96,189,3,Portland Trail Blazers,3,0.25,0.679,49,20,10,4,0.222,0.867,37,16,7,5
1949,21500720,Charlotte Hornets,Los Angeles Lakers,101,82,183,19,Charlotte Hornets,19,0.361,0.615,59,28,8,8,0.276,0.87,42,13,6,8
1950,21500721,Cleveland Cavaliers,Indiana Pacers,111,106,217,5,Cleveland Cavaliers,5,0.318,0.696,45,22,8,3,0.296,0.857,44,24,11,7
1951,21500722,Detroit Pistons,Brooklyn Nets,105,100,205,5,Detroit Pistons,5,0.333,0.688,49,18,5,4,0.438,0.867,39,28,5,4
1952,21500723,Dallas Mavericks,Atlanta Hawks,97,112,209,15,Atlanta Hawks,15,0.269,0.737,37,14,5,2,0.4,0.737,50,29,2,6
1953,21500724,Memphis Grizzlies,New Orleans Pelicans,110,95,205,15,Memphis Grizzlies,15,0.563,0.833,40,27,4,5,0.385,0.619,37,19,8,4
1954,21500725,Washington Wizards,Oklahoma City Thunder,98,114,212,16,Oklahoma City Thunder,16,0.269,0.733,27,20,8,3,0.318,0.778,53,25,9,5
1955,21500726,Orlando Magic,San Antonio Spurs,92,107,199,15,San Antonio Spurs,15,0.294,0.818,51,19,9,6,0.375,0.857,42,27,6,10
1956,21500727,Toronto Raptors,Denver Nuggets,93,112,205,19,Denver Nuggets,19,0.32,0.692,35,13,13,6,0.455,0.8,49,28,6,5
1957,21500728,Chicago Bulls,Utah Jazz,96,105,201,9,Utah Jazz,9,0.238,0.65,42,19,4,7,0.389,0.667,50,19,5,4
1958,21500729,Milwaukee Bucks,Sacramento Kings,104,111,215,7,Sacramento Kings,7,0.4,0.706,37,27,11,5,0.346,0.8,53,21,7,3
1959,21500730,Boston Celtics,New York Knicks,97,89,186,8,Boston Celtics,8,0.158,0.824,45,20,9,2,0.3,0.75,50,13,3,4
1960,21500731,Miami Heat,Houston Rockets,102,115,217,13,Houston Rockets,13,0.353,0.741,51,26,5,3,0.457,0.688,34,30,9,6
1961,21500732,Toronto Raptors,Phoenix Suns,104,97,201,7,Toronto Raptors,7,0.333,0.781,35,15,9,3,0.387,0.733,38,23,5,4
1962,21500733,Milwaukee Bucks,Portland Trail Blazers,95,107,202,12,Portland Trail Blazers,12,0.357,0.583,43,23,7,4,0.355,0.72,49,25,6,7
1963,21500734,Minnesota Timberwolves,Los Angeles Lakers,115,119,234,4,Los Angeles Lakers,4,0.235,0.76,33,36,6,4,0.462,0.771,31,23,9,2
1964,21500735,Cleveland Cavaliers,Charlotte Hornets,97,106,203,9,Charlotte Hornets,9,0.357,0.786,28,16,9,5,0.333,0.826,49,26,4,3
1965,21500736,Atlanta Hawks,Philadelphia 76ers,124,86,210,38,Atlanta Hawks,38,0.5,0.72,52,28,13,7,0.222,0.714,38,27,7,10
1966,21500737,Detroit Pistons,Boston Celtics,95,102,197,7,Boston Celtics,7,0.324,0.714,48,18,3,5,0.333,0.846,49,28,8,7
1967,21500738,Indiana Pacers,Brooklyn Nets,114,100,214,14,Indiana Pacers,14,0.5,0.824,44,23,11,5,0.304,0.677,40,25,5,2
1968,21500739,Golden State Warriors,Washington Wizards,134,121,255,13,Golden State Warriors,13,0.488,0.552,49,35,10,5,0.348,0.7,38,26,16,4
1969,21500740,Orlando Magic,Oklahoma City Thunder,114,117,231,3,Oklahoma City Thunder,3,0.435,0.833,39,25,3,5,0.333,0.8,50,25,7,10
1970,21500741,Miami Heat,Dallas Mavericks,93,90,183,3,Miami Heat,3,0.133,0.739,54,18,3,11,0.4,0.737,46,18,4,5
1971,21500742,New Orleans Pelicans,San Antonio Spurs,97,110,207,13,San Antonio Spurs,13,0.158,0.857,45,21,12,4,0.6,0.944,36,30,6,8
1972,21500743,Denver Nuggets,Utah Jazz,81,85,166,4,Utah Jazz,4,0.222,0.758,41,11,12,2,0.227,0.7,38,14,4,10
1973,21500744,Chicago Bulls,Sacramento Kings,107,102,209,5,Chicago Bulls,5,0.524,0.762,49,26,8,0,0.3,0.632,45,21,12,8
1974,21500745,Minnesota Timberwolves,Los Angeles Clippers,108,102,210,6,Minnesota Timberwolves,6,0.471,0.846,42,24,6,3,0.344,0.735,35,20,10,6
1975,21500746,New York Knicks,Detroit Pistons,105,111,216,6,Detroit Pistons,6,0.273,0.794,43,20,7,0,0.529,0.667,42,17,7,3
1976,21500747,Los Angeles Lakers,New Orleans Pelicans,99,96,195,3,Los Angeles Lakers,3,0.35,0.7,48,14,4,0,0.2,0.538,40,16,8,4
1977,21500748,Toronto Raptors,Portland Trail Blazers,110,103,213,7,Toronto Raptors,7,0.632,0.72,45,23,7,6,0.4,0.739,40,21,8,6
1978,21500749,Houston Rockets,Phoenix Suns,111,105,216,6,Houston Rockets,6,0.357,0.688,49,24,16,5,0.379,0.938,54,22,9,1
1979,21500750,Indiana Pacers,Atlanta Hawks,96,102,198,6,Atlanta Hawks,6,0.419,0.778,53,23,6,4,0.37,0.7,32,29,10,5
1980,21500751,Miami Heat,Charlotte Hornets,98,95,193,3,Miami Heat,3,0,0.667,48,20,7,12,0.385,0.867,41,23,5,10
1981,21500752,Los Angeles Clippers,Orlando Magic,107,93,200,14,Los Angeles Clippers,14,0.296,0.826,44,15,13,8,0.2,0.75,39,19,6,1
1982,21500753,Philadelphia 76ers,Washington Wizards,94,106,200,12,Washington Wizards,12,0.346,0.786,38,23,7,8,0.273,0.6,46,26,7,4
1983,21500754,Sacramento Kings,Brooklyn Nets,119,128,247,9,Brooklyn Nets,9,0.308,0.955,31,30,15,3,0.643,0.933,46,29,5,4
1984,21500755,Boston Celtics,Cleveland Cavaliers,104,103,207,1,Boston Celtics,1,0.35,0.84,49,21,6,5,0.267,0.6,47,21,8,6
1985,21500756,Memphis Grizzlies,New York Knicks,91,85,176,6,Memphis Grizzlies,6,0.222,0.875,37,17,8,5,0.345,0.882,47,15,2,6
1986,21500757,Chicago Bulls,Denver Nuggets,110,115,225,5,Denver Nuggets,5,0.417,0.704,40,21,5,7,0.333,0.705,48,22,5,8
1987,21500758,Milwaukee Bucks,Utah Jazz,81,84,165,3,Utah Jazz,3,0.5,0.667,41,9,12,7,0.296,0.696,45,13,15,8
1988,21500759,San Antonio Spurs,Dallas Mavericks,116,90,206,26,San Antonio Spurs,26,0.545,0.88,42,19,6,4,0.2,0.778,36,17,7,2
1989,21500760,Portland Trail Blazers,Houston Rockets,96,79,175,17,Portland Trail Blazers,17,0.314,0.652,54,21,15,6,0.194,0.733,43,13,13,4
1990,21500761,Washington Wizards,Charlotte Hornets,104,108,212,4,Charlotte Hornets,4,0.36,0.792,44,22,9,5,0.444,0.8,43,23,7,5
1991,21500762,Detroit Pistons,Indiana Pacers,104,112,216,8,Indiana Pacers,8,0.364,0.516,38,14,7,3,0.545,0.828,41,21,7,1
1992,21500763,New Orleans Pelicans,Cleveland Cavaliers,84,99,183,15,Cleveland Cavaliers,15,0.217,0.688,42,18,5,2,0.341,1,49,21,6,6
1993,21500764,Brooklyn Nets,Philadelphia 76ers,98,103,201,5,Philadelphia 76ers,5,0.333,0.885,36,19,5,5,0.345,0.773,42,17,12,8
1994,21500765,Dallas Mavericks,Memphis Grizzlies,114,110,224,4,Dallas Mavericks,4,0.395,0.697,42,26,6,1,0.391,0.565,51,27,3,4
1995,21500766,Chicago Bulls,Minnesota Timberwolves,105,112,217,7,Minnesota Timberwolves,7,0.4,0.895,31,27,5,4,0.083,0.955,45,24,7,4
1996,21500767,Los Angeles Lakers,San Antonio Spurs,102,106,208,4,San Antonio Spurs,4,0.333,0.889,46,19,5,3,0.333,0.8,51,27,4,6
1997,21500768,Utah Jazz,Phoenix Suns,98,89,187,9,Utah Jazz,9,0.313,0.806,44,14,7,7,0.375,0.769,39,19,3,6
1998,21500769,Oklahoma City Thunder,Golden State Warriors,108,116,224,8,Golden State Warriors,8,0.318,0.784,50,22,10,5,0.269,0.65,46,24,7,4
1999,21500770,Denver Nuggets,New York Knicks,101,96,197,5,Denver Nuggets,5,0.238,0.786,48,20,6,3,0.364,0.7,46,19,2,6
2000,21500771,Atlanta Hawks,Orlando Magic,94,96,190,2,Orlando Magic,2,0.464,0.733,50,22,7,7,0.28,0.917,43,24,9,10
2001,21500772,Los Angeles Clippers,Miami Heat,100,93,193,7,Los Angeles Clippers,7,0.36,0.515,42,17,8,5,0.412,0.69,53,14,2,0
2002,21500773,Sacramento Kings,Boston Celtics,119,128,247,9,Boston Celtics,9,0.385,0.789,32,32,15,5,0.542,0.867,49,34,9,5
2003,21500774,Chicago Bulls,Charlotte Hornets,91,108,199,17,Charlotte Hornets,17,0.4,0.786,41,25,5,8,0.389,0.774,56,20,6,8
2004,21500775,Sacramento Kings,Cleveland Cavaliers,100,120,220,20,Cleveland Cavaliers,20,0.391,0.655,44,28,11,4,0.457,0.737,53,27,7,5
2005,21500776,Los Angeles Lakers,Indiana Pacers,87,89,176,2,Indiana Pacers,2,0.229,0.808,51,13,10,2,0.148,0.697,53,13,8,5
2006,21500777,Los Angeles Clippers,Philadelphia 76ers,98,92,190,6,Los Angeles Clippers,6,0.227,0.742,52,21,12,4,0.24,0.857,54,20,7,5
2007,21500778,Denver Nuggets,Brooklyn Nets,104,105,209,1,Brooklyn Nets,1,0.36,0.846,42,24,10,2,0.474,0.8,39,23,6,6
2008,21500779,Toronto Raptors,Detroit Pistons,103,89,192,14,Toronto Raptors,14,0.55,0.824,36,22,11,2,0.286,0.529,39,22,7,2
2009,21500780,Orlando Magic,Atlanta Hawks,117,110,227,7,Orlando Magic,7,0.31,0.727,47,37,11,8,0.414,0.6,47,31,9,4
2010,21500781,Portland Trail Blazers,Memphis Grizzlies,112,106,218,6,Portland Trail Blazers,6,0.345,0.7,37,22,9,6,0.368,0.684,39,18,5,3
2011,21500782,New Orleans Pelicans,Minnesota Timberwolves,116,102,218,14,New Orleans Pelicans,14,0.417,0.6,41,22,7,3,0.167,0.8,50,24,0,9
2012,21500783,Oklahoma City Thunder,Phoenix Suns,122,106,228,16,Oklahoma City Thunder,16,0.455,0.767,38,23,8,5,0.091,0.795,36,22,9,4
2013,21500784,San Antonio Spurs,Miami Heat,119,101,220,18,San Antonio Spurs,18,0.429,0.731,43,25,10,4,0.333,0.708,31,21,7,5
2014,21500785,Washington Wizards,New York Knicks,111,108,219,3,Washington Wizards,3,0.615,0.68,32,26,8,4,0.308,0.857,46,22,6,5
2015,21500786,Boston Celtics,Milwaukee Bucks,111,112,223,1,Milwaukee Bucks,1,0.345,0.958,44,28,11,2,0.368,0.652,38,25,5,6
2016,21500787,Utah Jazz,Dallas Mavericks,121,119,240,2,Utah Jazz,2,0.231,0.704,44,23,3,2,0.379,0.878,36,24,5,1
2017,21500788,Houston Rockets,Golden State Warriors,110,123,233,13,Golden State Warriors,13,0.394,0.657,43,24,8,4,0.353,0.885,49,28,5,6
2018,21500789,Charlotte Hornets,Indiana Pacers,117,95,212,22,Charlotte Hornets,22,0.429,0.789,45,24,6,8,0.222,0.733,39,19,7,4
2019,21500790,San Antonio Spurs,Orlando Magic,98,96,194,2,San Antonio Spurs,2,0.4,0.933,44,24,6,11,0.4,0.875,50,26,7,7
2020,21500791,Sacramento Kings,Philadelphia 76ers,114,110,224,4,Sacramento Kings,4,0.25,0.759,44,29,7,6,0.429,0.647,44,29,9,10
2021,21500792,Los Angeles Clippers,Boston Celtics,134,139,273,5,Boston Celtics,5,0.4,0.68,44,25,7,9,0.394,0.865,43,34,5,2
2022,21500793,Memphis Grizzlies,Brooklyn Nets,109,90,199,19,Memphis Grizzlies,19,0.45,0.833,35,26,15,2,0.5,0.684,35,25,4,2
2023,21500794,Denver Nuggets,Detroit Pistons,103,92,195,11,Denver Nuggets,11,0.316,0.792,47,25,10,3,0.37,0.857,42,21,5,8
2024,21500795,Los Angeles Lakers,Cleveland Cavaliers,111,120,231,9,Cleveland Cavaliers,9,0.464,0.815,44,16,5,3,0.419,0.611,46,26,6,1
2025,21500796,Atlanta Hawks,Chicago Bulls,113,90,203,23,Atlanta Hawks,23,0.394,0.933,46,25,16,7,0.357,0.75,45,21,7,3
2026,21500797,Toronto Raptors,Minnesota Timberwolves,112,117,229,5,Minnesota Timberwolves,5,0.323,0.75,40,19,3,10,0.286,0.811,45,22,5,6
2027,21500798,Utah Jazz,New Orleans Pelicans,96,100,196,4,New Orleans Pelicans,4,0.333,0.767,44,19,6,3,0.421,0.667,40,23,9,3
2028,21500799,Golden State Warriors,Phoenix Suns,112,104,216,8,Golden State Warriors,8,0.35,0.828,50,24,12,7,0.286,0.727,50,21,7,6
2029,21500800,Houston Rockets,Portland Trail Blazers,103,116,219,13,Portland Trail Blazers,13,0.324,0.529,40,23,6,3,0.286,0.765,49,21,11,2
2030,21500801,Washington Wizards,Milwaukee Bucks,92,99,191,7,Milwaukee Bucks,7,0.188,0.75,38,25,8,6,0.286,0.719,58,24,10,4
2031,21500802,New Orleans Pelicans,Oklahoma City Thunder,95,121,216,26,Oklahoma City Thunder,26,0.188,0.667,31,17,13,2,0.375,0.826,50,28,4,7
2032,21500803,Chicago Bulls,Cleveland Cavaliers,95,106,201,11,Cleveland Cavaliers,11,0.381,0.591,49,12,4,4,0.292,0.882,52,21,8,8
2033,21500804,San Antonio Spurs,Los Angeles Clippers,86,105,191,19,Los Angeles Clippers,19,0.235,0.8,33,19,11,2,0.48,0.75,45,23,8,7
2034,21500805,Dallas Mavericks,Orlando Magic,104,110,214,6,Orlando Magic,6,0.463,0.611,45,23,8,6,0.371,0.882,63,25,10,4
2035,21500806,Detroit Pistons,Washington Wizards,86,98,184,12,Washington Wizards,12,0.304,0.529,41,13,2,3,0.318,0.731,47,26,5,5
2036,21500807,New York Knicks,Brooklyn Nets,98,109,207,11,Brooklyn Nets,11,0.385,0.889,44,20,6,6,0.471,0.85,42,26,14,6
2037,21500808,Miami Heat,Atlanta Hawks,115,111,226,4,Miami Heat,4,0.4,0.679,46,27,13,1,0.444,1,42,27,7,4
2038,21500809,Toronto Raptors,Chicago Bulls,106,116,222,10,Chicago Bulls,10,0.278,0.735,45,22,7,7,0.438,0.65,49,32,4,6
2039,21500810,Minnesota Timberwolves,Memphis Grizzlies,104,109,213,5,Memphis Grizzlies,5,0.423,1,42,25,7,6,0.333,0.786,42,17,13,5
2040,21500811,Philadelphia 76ers,New Orleans Pelicans,114,121,235,7,New Orleans Pelicans,7,0.444,0.846,32,20,11,4,0.412,0.8,42,22,12,4
2041,21500812,Indiana Pacers,Oklahoma City Thunder,101,98,199,3,Indiana Pacers,3,0.409,0.636,45,27,8,8,0.192,0.9,48,28,6,4
2042,21500813,Charlotte Hornets,Milwaukee Bucks,98,95,193,3,Charlotte Hornets,3,0.29,0.833,37,13,13,6,0.368,0.762,47,22,7,11
2043,21500814,Houston Rockets,Phoenix Suns,116,100,216,16,Houston Rockets,16,0.292,0.625,51,20,16,4,0.314,0.829,40,23,7,6
2044,21500815,Golden State Warriors,Portland Trail Blazers,105,137,242,32,Portland Trail Blazers,32,0.353,0.75,47,25,7,4,0.567,0.696,48,28,12,4
2045,21500816,Denver Nuggets,Sacramento Kings,110,116,226,6,Sacramento Kings,6,0.333,0.692,44,26,12,5,0.476,0.774,45,16,12,8
2046,21500817,Boston Celtics,Utah Jazz,93,111,204,18,Utah Jazz,18,0.28,0.722,34,18,8,3,0.435,0.614,51,22,4,8
2047,21500818,San Antonio Spurs,Los Angeles Lakers,119,113,232,6,San Antonio Spurs,6,0.5,0.944,39,30,6,9,0.455,0.885,36,20,5,4
2048,21500819,Milwaukee Bucks,Atlanta Hawks,117,109,226,8,Milwaukee Bucks,8,0.176,0.688,65,23,12,10,0.22,0.667,49,31,11,8
2049,21500820,Washington Wizards,Miami Heat,94,114,208,20,Miami Heat,20,0.136,0.524,45,13,5,4,0.154,0.643,67,23,2,9
2050,21500821,New York Knicks,Minnesota Timberwolves,103,95,198,8,New York Knicks,8,0.294,0.875,51,17,4,7,0.417,0.72,31,24,9,6
2051,21500822,Golden State Warriors,Los Angeles Clippers,115,112,227,3,Golden State Warriors,3,0.355,0.769,39,32,8,2,0.361,0.833,49,24,9,2
2052,21500823,New Orleans Pelicans,Detroit Pistons,111,106,217,5,New Orleans Pelicans,5,0.2,0.862,51,23,5,2,0.364,0.625,41,18,9,6
2053,21500824,Cleveland Cavaliers,Oklahoma City Thunder,115,92,207,23,Cleveland Cavaliers,23,0.435,0.852,49,25,4,1,0.238,0.684,39,22,9,7
2054,21500825,Boston Celtics,Denver Nuggets,121,101,222,20,Boston Celtics,20,0.313,0.85,48,32,11,2,0.286,0.794,36,19,11,5
2055,21500826,San Antonio Spurs,Phoenix Suns,118,111,229,7,San Antonio Spurs,7,0.625,0.647,42,23,10,9,0.375,0.727,46,26,6,5
2056,21500827,Charlotte Hornets,Brooklyn Nets,104,96,200,8,Charlotte Hornets,8,0.37,0.933,41,23,7,1,0.227,0.875,42,23,8,4
2057,21500828,Indiana Pacers,Orlando Magic,105,102,207,3,Indiana Pacers,3,0.375,0.667,44,26,7,6,0.28,0.655,45,27,12,3
2058,21500829,Memphis Grizzlies,Toronto Raptors,85,98,183,13,Toronto Raptors,13,0.15,0.813,44,13,6,3,0.25,0.806,47,12,4,2
2059,21500830,Philadelphia 76ers,Dallas Mavericks,103,129,232,26,Dallas Mavericks,26,0.429,0.63,35,19,8,4,0.382,0.944,48,23,8,3
2060,21500831,Los Angeles Lakers,Chicago Bulls,115,126,241,11,Chicago Bulls,11,0.333,0.667,44,13,5,4,0.684,0.962,38,30,2,7
2061,21500832,Utah Jazz,Portland Trail Blazers,111,115,226,4,Portland Trail Blazers,4,0.5,0.739,38,19,6,10,0.375,0.658,48,20,7,6
2062,21500833,Detroit Pistons,Cleveland Cavaliers,96,88,184,8,Detroit Pistons,8,0.32,0.667,43,17,10,3,0.308,0.923,40,19,8,2
2063,21500834,Indiana Pacers,Miami Heat,93,101,194,8,Miami Heat,8,0.333,0.64,45,17,8,6,0.154,0.676,66,19,8,8
2064,21500835,Toronto Raptors,New York Knicks,122,95,217,27,Toronto Raptors,27,0.44,0.76,47,26,7,6,0.3,0.652,40,18,2,3
2065,21500836,Golden State Warriors,Atlanta Hawks,102,92,194,10,Golden State Warriors,10,0.311,0.833,43,30,14,8,0.294,0.625,47,23,7,7
2066,21500837,Los Angeles Lakers,Milwaukee Bucks,101,108,209,7,Milwaukee Bucks,7,0.414,0.767,46,18,7,2,0.313,0.6,44,32,10,8
2067,21500838,Boston Celtics,Minnesota Timberwolves,122,124,246,2,Minnesota Timberwolves,2,0.357,0.824,38,33,13,2,0.533,0.75,51,24,5,6
2068,21500839,Phoenix Suns,Los Angeles Clippers,84,124,208,40,Los Angeles Clippers,40,0.292,0.75,41,20,8,2,0.542,0.657,53,29,9,10
2069,21500840,Orlando Magic,Philadelphia 76ers,124,115,239,9,Orlando Magic,9,0.5,0.854,43,26,11,2,0.476,0.731,36,23,7,4
2070,21500841,New Orleans Pelicans,Washington Wizards,89,109,198,20,Washington Wizards,20,0.261,0.758,48,17,8,4,0.462,0.647,55,29,9,4
2071,21500842,Sacramento Kings,Denver Nuggets,114,110,224,4,Sacramento Kings,4,0.412,0.75,50,28,9,12,0.37,0.818,44,27,10,3
2072,21500843,Houston Rockets,Utah Jazz,114,117,231,3,Utah Jazz,3,0.324,0.756,35,17,15,4,0.417,0.816,41,22,11,4
2073,21500844,Brooklyn Nets,Portland Trail Blazers,104,112,216,8,Portland Trail Blazers,8,0.25,0.789,47,18,10,2,0.435,0.88,40,24,6,6
2074,21500845,Charlotte Hornets,Cleveland Cavaliers,103,114,217,11,Cleveland Cavaliers,11,0.345,0.704,43,23,7,2,0.406,0.647,47,26,11,1
2075,21500846,New York Knicks,Indiana Pacers,105,108,213,3,Indiana Pacers,3,0.5,0.88,38,22,4,5,0.2,0.813,43,22,8,4
2076,21500847,Philadelphia 76ers,Detroit Pistons,91,111,202,20,Detroit Pistons,20,0.304,0.692,40,18,8,4,0.393,0.647,50,22,10,1
2077,21500848,Golden State Warriors,Miami Heat,118,112,230,6,Golden State Warriors,6,0.464,0.84,43,23,7,2,0.429,0.839,46,19,8,8
2078,21500849,Minnesota Timberwolves,Toronto Raptors,105,114,219,9,Toronto Raptors,9,0.6,0.758,36,25,8,4,0.385,0.846,39,21,7,7
2079,21500850,Washington Wizards,Chicago Bulls,104,109,213,5,Chicago Bulls,5,0.321,0.731,42,19,11,4,0.348,0.813,50,26,6,2
2080,21500851,Los Angeles Lakers,Memphis Grizzlies,119,128,247,9,Memphis Grizzlies,9,0.436,0.727,45,16,5,3,0.481,0.655,46,26,6,4
2081,21500852,Oklahoma City Thunder,Dallas Mavericks,116,103,219,13,Oklahoma City Thunder,13,0.364,0.818,52,28,5,5,0.321,0.8,42,26,10,4
2082,21500853,Denver Nuggets,Los Angeles Clippers,87,81,168,6,Denver Nuggets,6,0.25,0.765,57,18,11,2,0.283,0.571,47,19,13,9
2083,21500854,San Antonio Spurs,Sacramento Kings,108,92,200,16,San Antonio Spurs,16,0.421,0.8,50,26,13,8,0.333,0.533,44,27,13,1
2084,21500855,Golden State Warriors,Orlando Magic,130,114,244,16,Golden State Warriors,16,0.52,0.688,42,35,9,4,0.385,0.786,37,23,11,4
2085,21500856,Milwaukee Bucks,Boston Celtics,107,112,219,5,Boston Celtics,5,0.267,0.76,35,26,9,7,0.217,0.758,42,21,9,3
2086,21500857,Oklahoma City Thunder,New Orleans Pelicans,119,123,242,4,New Orleans Pelicans,4,0.421,0.773,36,25,4,6,0.6,0.944,39,29,5,6
2087,21500858,Brooklyn Nets,Phoenix Suns,116,106,222,10,Brooklyn Nets,10,0.444,0.81,42,21,12,8,0.333,0.565,50,16,10,4
2088,21500859,Houston Rockets,Portland Trail Blazers,119,105,224,14,Houston Rockets,14,0.345,0.6,46,26,14,5,0.371,0.818,40,22,4,3
2089,21500860,San Antonio Spurs,Utah Jazz,96,78,174,18,San Antonio Spurs,18,0.5,0.917,43,17,5,5,0.176,0.75,31,15,6,2
2090,21500861,Charlotte Hornets,Indiana Pacers,96,95,191,1,Charlotte Hornets,1,0.393,0.684,38,23,8,7,0.211,0.875,52,19,8,3
2091,21500862,Washington Wizards,Philadelphia 76ers,103,94,197,9,Washington Wizards,9,0.304,0.941,55,24,7,8,0.32,0.762,41,21,10,5
2092,21500863,Orlando Magic,New York Knicks,95,108,203,13,New York Knicks,13,0.222,0.688,47,24,6,1,0.25,0.833,51,18,7,4
2093,21500864,Cleveland Cavaliers,Toronto Raptors,97,99,196,2,Toronto Raptors,2,0.5,0.714,39,21,4,0,0.353,0.731,34,18,6,0
2094,21500865,Chicago Bulls,Atlanta Hawks,88,103,191,15,Atlanta Hawks,15,0.25,0.864,49,19,3,2,0.206,0.917,48,28,14,11
2095,21500866,Denver Nuggets,Dallas Mavericks,116,122,238,6,Dallas Mavericks,6,0.31,0.677,49,18,7,3,0.379,0.778,45,25,9,1
2096,21500867,Los Angeles Clippers,Sacramento Kings,117,107,224,10,Los Angeles Clippers,10,0.31,0.846,41,18,6,4,0.5,0.73,44,19,6,3
2097,21500868,Memphis Grizzlies,Los Angeles Lakers,112,95,207,17,Memphis Grizzlies,17,0.406,0.867,47,24,6,7,0.217,0.667,38,14,9,3
2098,21500869,Miami Heat,Boston Celtics,89,101,190,12,Boston Celtics,12,0.077,0.696,54,19,7,12,0.313,0.818,48,26,12,6
2099,21500870,Minnesota Timberwolves,New Orleans Pelicans,112,110,222,2,Minnesota Timberwolves,2,0.333,0.767,44,28,9,5,0.37,0.846,42,22,9,4
2100,21500871,Portland Trail Blazers,Chicago Bulls,103,95,198,8,Portland Trail Blazers,8,0.238,0.815,47,20,6,7,0.318,0.833,50,33,4,6
2101,21500872,San Antonio Spurs,Houston Rockets,104,94,198,10,San Antonio Spurs,10,0.421,0.786,43,24,4,4,0.32,0.727,39,19,5,4
2102,21500873,Detroit Pistons,Milwaukee Bucks,102,91,193,11,Detroit Pistons,11,0.4,0.667,46,24,13,2,0.583,0.667,44,21,3,7
2103,21500874,Golden State Warriors,Oklahoma City Thunder,121,118,239,3,Golden State Warriors,3,0.438,0.68,32,25,15,7,0.346,0.654,62,23,6,4
2104,21500875,Memphis Grizzlies,Phoenix Suns,106,111,217,5,Phoenix Suns,5,0.3,0.857,34,15,11,4,0.375,0.714,56,19,4,3
2105,21500876,Brooklyn Nets,Utah Jazz,98,96,194,2,Brooklyn Nets,2,0.467,0.647,45,23,12,2,0.25,0.68,48,14,11,9
2106,21500877,Cleveland Cavaliers,Washington Wizards,99,113,212,14,Washington Wizards,14,0.31,0.867,39,20,6,2,0.355,0.706,45,28,6,2
2107,21500878,Charlotte Hornets,Atlanta Hawks,76,87,163,11,Atlanta Hawks,11,0.219,0.652,41,16,7,4,0.471,0.6,48,29,4,5
2108,21500879,Toronto Raptors,Detroit Pistons,101,114,215,13,Detroit Pistons,13,0.476,0.722,32,21,5,1,0.522,0.741,38,28,2,1
2109,21500880,Portland Trail Blazers,Indiana Pacers,111,102,213,9,Portland Trail Blazers,9,0.583,0.714,45,19,4,7,0.214,0.76,52,21,7,5
2110,21500881,Philadelphia 76ers,Orlando Magic,116,130,246,14,Orlando Magic,14,0.227,0.784,34,20,6,7,0.625,0.88,33,28,9,6
2111,21500882,Minnesota Timberwolves,Dallas Mavericks,101,128,229,27,Dallas Mavericks,27,0.304,0.703,53,19,5,3,0.361,1,43,34,9,6
2112,21500883,Miami Heat,New York Knicks,98,81,179,17,Miami Heat,17,0.125,0.81,54,25,9,4,0.4,0.917,39,16,8,9
2113,21500884,Indiana Pacers,Cleveland Cavaliers,96,100,196,4,Cleveland Cavaliers,4,0.444,0.933,36,23,8,11,0.31,0.84,40,22,4,2
2114,21500885,Philadelphia 76ers,Washington Wizards,108,116,224,8,Washington Wizards,8,0.313,0.571,32,27,8,4,0.3,0.774,53,25,6,6
2115,21500886,Utah Jazz,Boston Celtics,95,100,195,5,Boston Celtics,5,0.292,0.706,52,23,6,4,0.333,0.69,47,27,6,13
2116,21500887,Houston Rockets,Milwaukee Bucks,121,128,249,7,Milwaukee Bucks,7,0.417,0.686,41,30,12,1,0.533,0.727,42,30,12,4
2117,21500888,Memphis Grizzlies,Denver Nuggets,103,96,199,7,Memphis Grizzlies,7,0.15,0.778,27,27,7,4,0.32,0.8,40,27,3,4
2118,21500889,Oklahoma City Thunder,Sacramento Kings,131,116,247,15,Oklahoma City Thunder,15,0.412,0.885,47,28,7,3,0.28,0.684,46,28,11,0
2119,21500890,Brooklyn Nets,Los Angeles Clippers,95,105,200,10,Los Angeles Clippers,10,0.421,0.697,44,25,10,3,0.391,0.875,47,22,8,4
2120,21500891,Phoenix Suns,Charlotte Hornets,92,126,218,34,Charlotte Hornets,34,0.222,0.741,42,14,5,2,0.481,0.852,58,27,8,6
2121,21500892,Chicago Bulls,Miami Heat,111,129,240,18,Miami Heat,18,0.478,0.692,29,20,10,2,0.5,0.76,38,28,5,11
2122,21500893,Portland Trail Blazers,New York Knicks,104,85,189,19,Portland Trail Blazers,19,0.4,0.9,55,17,5,7,0.286,0.722,46,11,4,4
2123,21500894,Orlando Magic,Dallas Mavericks,108,121,229,13,Dallas Mavericks,13,0.3,0.85,45,29,11,4,0.474,0.839,36,27,7,4
2124,21500895,Atlanta Hawks,Golden State Warriors,105,109,214,4,Golden State Warriors,4,0.364,0.792,42,25,9,5,0.333,0.882,51,28,11,3
2125,21500896,Brooklyn Nets,Los Angeles Lakers,101,107,208,6,Los Angeles Lakers,6,0.278,0.667,44,28,8,4,0.423,0.667,46,22,5,4
2126,21500897,Chicago Bulls,Orlando Magic,89,102,191,13,Orlando Magic,13,0.316,0.636,48,24,6,2,0.333,0.773,59,25,5,6
2127,21500898,Charlotte Hornets,Philadelphia 76ers,119,99,218,20,Charlotte Hornets,20,0.4,0.829,50,20,9,7,0.394,0.692,38,23,8,5
2128,21500899,Portland Trail Blazers,Boston Celtics,93,116,209,23,Boston Celtics,23,0.379,0.7,48,15,4,7,0.269,0.958,57,20,9,8
2129,21500900,Utah Jazz,Toronto Raptors,94,104,198,10,Toronto Raptors,10,0.385,0.625,33,21,6,6,0.273,0.857,45,12,7,5
2130,21500901,New Orleans Pelicans,Houston Rockets,95,100,195,5,Houston Rockets,5,0.378,0.692,43,24,10,3,0.086,0.658,51,20,15,9
2131,21500902,Sacramento Kings,Memphis Grizzlies,98,104,202,6,Memphis Grizzlies,6,0.346,0.55,44,31,7,3,0.278,0.879,37,20,13,4
2132,21500903,Indiana Pacers,Milwaukee Bucks,104,99,203,5,Indiana Pacers,5,0.5,0.692,49,28,7,6,0.214,0.875,37,14,8,1
2133,21500904,Washington Wizards,Minnesota Timberwolves,104,98,202,6,Washington Wizards,6,0.379,0.692,36,25,8,3,0.357,0.853,45,17,8,2
2134,21500905,Detroit Pistons,San Antonio Spurs,81,97,178,16,San Antonio Spurs,16,0.316,0.565,42,19,3,1,0.214,0.889,41,25,8,6
2135,21500906,Los Angeles Lakers,Denver Nuggets,107,117,224,10,Denver Nuggets,10,0.355,0.813,31,19,7,4,0.522,0.763,42,22,3,6
2136,21500907,Oklahoma City Thunder,Los Angeles Clippers,98,103,201,5,Los Angeles Clippers,5,0.286,0.909,63,22,3,8,0.281,0.667,45,26,11,3
2137,21500908,Phoenix Suns,Miami Heat,92,108,200,16,Miami Heat,16,0.227,0.778,38,12,7,2,0.529,0.76,48,25,5,8
2138,21500909,San Antonio Spurs,New Orleans Pelicans,94,86,180,8,San Antonio Spurs,8,0.381,0.933,49,27,8,10,0.333,1,41,23,6,4
2139,21500910,Sacramento Kings,Dallas Mavericks,104,101,205,3,Sacramento Kings,3,0.28,0.542,43,23,8,4,0.241,0.667,47,25,5,3
2140,21500911,Oklahoma City Thunder,Golden State Warriors,106,121,227,15,Golden State Warriors,15,0.2,0.815,46,22,3,4,0.324,0.762,40,33,11,3
2141,21500912,Indiana Pacers,Charlotte Hornets,101,108,209,7,Charlotte Hornets,7,0.321,0.857,46,23,10,4,0.419,0.826,41,20,4,9
2142,21500913,Phoenix Suns,Orlando Magic,102,84,186,18,Phoenix Suns,18,0.357,0.692,57,18,8,5,0.259,0.5,50,20,12,3
2143,21500914,Miami Heat,Philadelphia 76ers,112,102,214,10,Miami Heat,10,0.313,0.806,55,24,7,5,0.29,0.778,44,21,12,5
2144,21500915,New York Knicks,Boston Celtics,104,105,209,1,Boston Celtics,1,0.391,0.786,45,22,4,3,0.2,0.76,51,20,8,2
2145,21500916,Portland Trail Blazers,Toronto Raptors,115,117,232,2,Toronto Raptors,2,0.407,0.743,36,14,5,3,0.5,0.796,38,12,5,4
2146,21500917,Washington Wizards,Cleveland Cavaliers,83,108,191,25,Cleveland Cavaliers,25,0.15,0.667,47,14,2,5,0.444,0.75,47,24,9,5
2147,21500918,Utah Jazz,Memphis Grizzlies,88,94,182,6,Memphis Grizzlies,6,0.263,0.655,45,21,6,5,0.222,0.842,42,14,8,5
2148,21500919,Minnesota Timberwolves,Milwaukee Bucks,101,116,217,15,Milwaukee Bucks,15,0.318,0.714,43,25,9,5,0.583,0.8,37,24,13,6
2149,21500920,Brooklyn Nets,Denver Nuggets,121,120,241,1,Brooklyn Nets,1,0.591,0.762,34,32,5,4,0.231,0.88,50,28,8,6
2150,21500921,Atlanta Hawks,Los Angeles Lakers,106,77,183,29,Atlanta Hawks,29,0.464,0.731,39,31,6,8,0.185,0.7,46,19,5,1
2151,21500922,Boston Celtics,Cleveland Cavaliers,103,120,223,17,Cleveland Cavaliers,17,0.435,0.704,37,17,8,1,0.333,0.765,47,27,8,4
2152,21500923,Detroit Pistons,New York Knicks,89,102,191,13,New York Knicks,13,0.231,0.733,42,13,6,1,0.25,0.778,47,19,4,5
2153,21500924,Indiana Pacers,Washington Wizards,100,99,199,1,Indiana Pacers,1,0.333,0.95,42,14,8,4,0.4,0.625,46,25,7,4
2154,21500925,Utah Jazz,New Orleans Pelicans,106,94,200,12,Utah Jazz,12,0.3,0.963,53,23,4,10,0.474,0.818,32,25,6,5
2155,21500926,Brooklyn Nets,Minnesota Timberwolves,118,132,250,14,Minnesota Timberwolves,14,0.346,0.731,37,19,7,4,0.556,0.818,30,36,8,8
2156,21500927,Houston Rockets,Chicago Bulls,100,108,208,8,Chicago Bulls,8,0.257,0.7,40,22,17,3,0.429,0.794,53,28,8,4
2157,21500928,Sacramento Kings,San Antonio Spurs,94,104,198,10,San Antonio Spurs,10,0.375,0.667,33,21,13,4,0.348,0.842,46,31,6,5
2158,21500929,Atlanta Hawks,Los Angeles Clippers,107,97,204,10,Atlanta Hawks,10,0.37,0.85,53,26,9,3,0.375,0.607,41,22,10,10
2159,21500930,Oklahoma City Thunder,Milwaukee Bucks,104,96,200,8,Oklahoma City Thunder,8,0.28,0.767,55,27,5,8,0.158,0.833,43,22,17,6
2160,21500931,Golden State Warriors,Los Angeles Lakers,95,112,207,17,Los Angeles Lakers,17,0.133,0.81,49,32,5,3,0.36,0.955,41,23,12,6
2161,21500932,Phoenix Suns,Memphis Grizzlies,109,100,209,9,Phoenix Suns,9,0.429,0.767,47,24,3,3,0.455,0.788,38,17,6,3
2162,21500933,Dallas Mavericks,Denver Nuggets,114,116,230,2,Denver Nuggets,2,0.39,0.8,46,29,5,8,0.346,0.76,58,25,8,5
2163,21500934,Portland Trail Blazers,Detroit Pistons,103,123,226,20,Detroit Pistons,20,0.355,0.957,31,18,8,0,0.545,0.821,45,22,7,1
2164,21500935,Philadelphia 76ers,Miami Heat,98,103,201,5,Miami Heat,5,0.355,0.591,40,20,5,7,0.571,0.767,51,16,7,10
2165,21500936,Houston Rockets,Toronto Raptors,113,107,220,6,Houston Rockets,6,0.448,0.649,37,27,9,4,0.364,0.778,42,27,8,6
2166,21500937,Minnesota Timberwolves,Charlotte Hornets,103,108,211,5,Charlotte Hornets,5,0.267,0.875,43,22,10,6,0.4,0.824,42,20,8,7
2167,21500938,Memphis Grizzlies,Cleveland Cavaliers,106,103,209,3,Memphis Grizzlies,3,0.3,0.818,35,23,16,8,0.241,0.828,49,23,9,7
2168,21500939,San Antonio Spurs,Indiana Pacers,91,99,190,8,Indiana Pacers,8,0.143,0.864,52,15,5,6,0.438,0.933,48,19,5,7
2169,21500940,Milwaukee Bucks,Chicago Bulls,90,100,190,10,Chicago Bulls,10,0.389,0.647,48,24,7,5,0.4,0.8,44,35,5,11
2170,21500941,Sacramento Kings,New Orleans Pelicans,112,115,227,3,New Orleans Pelicans,3,0.28,0.852,44,27,12,1,0.28,0.692,43,23,17,6
2171,21500942,Los Angeles Clippers,Dallas Mavericks,109,90,199,19,Los Angeles Clippers,19,0.375,0.655,48,18,10,7,0.16,0.813,51,15,5,1
2172,21500943,Orlando Magic,Golden State Warriors,113,119,232,6,Golden State Warriors,6,0.238,0.824,42,24,14,3,0.457,0.704,50,27,13,7
2173,21500944,Brooklyn Nets,Toronto Raptors,99,104,203,5,Toronto Raptors,5,0.5,1,29,23,7,8,0.435,0.8,40,24,9,7
2174,21500945,San Antonio Spurs,Minnesota Timberwolves,116,91,207,25,San Antonio Spurs,25,0.211,0.947,46,28,13,7,0.267,0.789,35,18,5,2
2175,21500946,New York Knicks,Denver Nuggets,94,110,204,16,Denver Nuggets,16,0.333,0.846,43,21,1,9,0.286,0.737,45,28,9,3
2176,21500947,Atlanta Hawks,Utah Jazz,91,84,175,7,Atlanta Hawks,7,0.32,0.5,41,15,9,4,0.269,0.739,54,16,10,4
2177,21500948,Washington Wizards,Portland Trail Blazers,109,116,225,7,Portland Trail Blazers,7,0.4,0.478,45,26,9,5,0.417,0.774,53,24,2,4
2178,21500949,Orlando Magic,Los Angeles Lakers,98,107,205,9,Los Angeles Lakers,9,0.263,0.704,35,19,5,4,0.333,0.783,45,21,7,2
2179,21500950,New Orleans Pelicans,Charlotte Hornets,113,122,235,9,Charlotte Hornets,9,0.303,0.821,43,22,2,3,0.429,0.816,43,21,6,3
2180,21500951,Houston Rockets,Philadelphia 76ers,118,104,222,14,Houston Rockets,14,0.333,0.756,45,22,14,5,0.364,0.688,42,23,8,5
2181,21500952,Miami Heat,Milwaukee Bucks,108,114,222,6,Milwaukee Bucks,6,0.4,0.947,39,23,6,8,0.5,0.703,34,27,7,0
2182,21500953,Memphis Grizzlies,Boston Celtics,96,116,212,20,Boston Celtics,20,0.269,0.806,48,20,8,7,0.469,0.792,38,26,9,7
2183,21500954,Detroit Pistons,Dallas Mavericks,102,96,198,6,Detroit Pistons,6,0.333,0.567,51,19,7,3,0.3,0.818,40,25,6,2
2184,21500955,Los Angeles Clippers,Oklahoma City Thunder,108,120,228,12,Oklahoma City Thunder,12,0.353,0.609,29,29,11,4,0.375,0.833,52,33,6,2
2185,21500956,New York Knicks,Phoenix Suns,128,97,225,31,New York Knicks,31,0.667,0.833,43,31,8,9,0.31,0.667,38,16,6,0
2186,21500957,Cleveland Cavaliers,Sacramento Kings,120,111,231,9,Cleveland Cavaliers,9,0.295,0.829,51,17,5,1,0.364,0.719,38,20,8,2
2187,21500958,Utah Jazz,Golden State Warriors,94,115,209,21,Golden State Warriors,21,0.4,0.71,42,21,9,4,0.433,0.6,39,36,10,7
2188,21500959,Atlanta Hawks,Toronto Raptors,96,104,200,8,Toronto Raptors,8,0.304,0.704,33,17,8,5,0.292,0.724,48,16,6,3
2189,21500960,Chicago Bulls,San Antonio Spurs,101,109,210,8,San Antonio Spurs,8,0.5,0.923,50,23,5,5,0.353,0.789,40,29,14,4
2190,21500961,Phoenix Suns,Denver Nuggets,98,116,214,18,Denver Nuggets,18,0.214,0.788,52,19,4,4,0.464,0.789,49,27,9,11
2191,21500962,Cleveland Cavaliers,Los Angeles Lakers,120,108,228,12,Cleveland Cavaliers,12,0.457,0.7,38,22,4,6,0.318,0.81,34,18,8,4
2192,21500963,Detroit Pistons,Charlotte Hornets,103,118,221,15,Charlotte Hornets,15,0.3,0.815,33,19,7,4,0.4,0.828,37,28,9,5
2193,21500964,Brooklyn Nets,Philadelphia 76ers,89,95,184,6,Philadelphia 76ers,6,0.294,0.818,41,22,8,4,0.321,0.667,49,25,5,6
2194,21500965,Houston Rockets,Boston Celtics,102,98,200,4,Houston Rockets,4,0.192,0.68,50,19,8,3,0.258,0.786,45,24,14,3
2195,21500966,Miami Heat,Chicago Bulls,118,96,214,22,Miami Heat,22,0.556,0.7,43,30,14,6,0.381,0.8,39,27,7,6
2196,21500967,New Orleans Pelicans,Memphis Grizzlies,114,121,235,7,Memphis Grizzlies,7,0.292,0.676,58,23,6,6,0.429,0.656,50,27,14,7
2197,21500968,Minnesota Timberwolves,Oklahoma City Thunder,99,96,195,3,Minnesota Timberwolves,3,0.333,0.857,37,22,12,7,0.222,0.72,54,15,3,7
2198,21500969,Washington Wizards,Utah Jazz,93,114,207,21,Utah Jazz,21,0.292,0.727,29,20,9,1,0.563,0.763,42,15,10,4
2199,21500970,Orlando Magic,Sacramento Kings,107,100,207,7,Orlando Magic,7,0.267,0.618,51,22,11,8,0.32,0.88,37,23,9,4
2200,21500971,Portland Trail Blazers,Golden State Warriors,112,128,240,16,Golden State Warriors,16,0.528,0.826,39,20,4,4,0.45,0.769,56,23,5,6
2201,21500972,New York Knicks,Los Angeles Clippers,94,101,195,7,Los Angeles Clippers,7,0.2,0.88,48,23,7,3,0.448,0.75,44,23,8,9
2202,21500973,Indiana Pacers,Dallas Mavericks,112,105,217,7,Indiana Pacers,7,0.321,0.931,42,24,10,6,0.364,0.833,40,30,7,1
2203,21500974,Memphis Grizzlies,Atlanta Hawks,83,95,178,12,Atlanta Hawks,12,0.261,0.786,58,15,10,5,0.324,0.706,47,27,9,12
2204,21500975,Houston Rockets,Charlotte Hornets,109,125,234,16,Charlotte Hornets,16,0.192,0.643,40,21,8,5,0.484,0.875,44,28,6,5
2205,21500976,Detroit Pistons,Philadelphia 76ers,125,111,236,14,Detroit Pistons,14,0.5,0.818,52,26,6,3,0.4,0.852,36,24,11,2
2206,21500977,Miami Heat,Toronto Raptors,104,112,216,8,Toronto Raptors,8,0.36,0.808,47,19,9,5,0.333,0.842,42,17,10,7
2207,21500978,New Orleans Pelicans,Milwaukee Bucks,92,103,195,11,Milwaukee Bucks,11,0.207,0.762,47,19,7,4,0.308,0.792,42,22,11,6
2208,21500979,Oklahoma City Thunder,San Antonio Spurs,85,93,178,8,San Antonio Spurs,8,0.111,0.84,56,18,7,2,0.167,0.84,44,17,12,3
2209,21500980,Washington Wizards,Denver Nuggets,100,116,216,16,Denver Nuggets,16,0.333,0.724,37,20,13,3,0.333,0.828,44,24,10,8
2210,21500981,Phoenix Suns,Golden State Warriors,116,123,239,7,Golden State Warriors,7,0.379,0.75,47,29,3,3,0.333,0.848,42,28,6,9
2211,21500982,Orlando Magic,Portland Trail Blazers,84,121,205,37,Portland Trail Blazers,37,0.269,0.5,39,19,6,4,0.486,0.909,51,34,2,3
2212,21500983,Cleveland Cavaliers,Los Angeles Clippers,114,90,204,24,Cleveland Cavaliers,24,0.486,0.7,49,23,3,4,0.313,0.842,34,23,5,4
2213,21500984,Indiana Pacers,Atlanta Hawks,75,104,179,29,Atlanta Hawks,29,0.208,0.571,38,24,9,5,0.5,0.9,50,27,11,6
2214,21500985,Milwaukee Bucks,Brooklyn Nets,109,100,209,9,Milwaukee Bucks,9,0.429,0.619,41,27,13,3,0.444,0.769,31,25,3,6
2215,21500986,Utah Jazz,Sacramento Kings,108,99,207,9,Utah Jazz,9,0.429,0.818,47,26,8,3,0.429,0.667,36,25,8,5
2216,21500987,New York Knicks,Los Angeles Lakers,90,87,177,3,New York Knicks,3,0.238,0.704,45,19,5,6,0.188,0.762,45,14,6,2
2217,21500988,Dallas Mavericks,Charlotte Hornets,107,96,203,11,Dallas Mavericks,11,0.3,0.778,42,30,9,6,0.333,0.647,40,18,9,7
2218,21500989,Detroit Pistons,Washington Wizards,81,124,205,43,Washington Wizards,43,0.13,0.636,39,17,5,4,0.444,0.778,40,34,11,3
2219,21500990,Denver Nuggets,Miami Heat,119,124,243,5,Miami Heat,5,0.35,0.7,40,22,9,2,0.471,0.786,33,24,9,6
2220,21500991,Chicago Bulls,Toronto Raptors,109,107,216,2,Chicago Bulls,2,0.36,0.9,38,23,2,7,0.3,0.871,42,12,5,9
2221,21500992,Memphis Grizzlies,Houston Rockets,81,130,211,49,Houston Rockets,49,0.235,0.607,58,14,7,0,0.485,0.647,53,29,13,14
2222,21500993,Portland Trail Blazers,Oklahoma City Thunder,94,128,222,34,Oklahoma City Thunder,34,0.259,0.926,39,13,4,7,0.529,0.808,52,31,10,6
2223,21500994,Cleveland Cavaliers,Utah Jazz,85,94,179,9,Utah Jazz,9,0.233,0.625,39,18,6,3,0.444,0.857,40,20,3,4
2224,21500995,Minnesota Timberwolves,Phoenix Suns,104,107,211,3,Phoenix Suns,3,0.25,0.867,36,25,13,4,0.314,0.8,57,22,8,3
2225,21500996,New Orleans Pelicans,Golden State Warriors,107,125,232,18,Golden State Warriors,18,0.28,0.882,40,18,14,3,0.48,0.826,46,30,6,6
2226,21500997,Boston Celtics,Indiana Pacers,98,103,201,5,Indiana Pacers,5,0.258,0.818,50,23,6,3,0.417,0.714,45,18,9,7
2227,21500998,Denver Nuggets,Orlando Magic,110,116,226,6,Orlando Magic,6,0.375,0.875,37,23,8,1,0.32,0.8,35,28,7,4
2228,21500999,Philadelphia 76ers,Brooklyn Nets,114,131,245,17,Brooklyn Nets,17,0.367,0.808,34,26,6,4,0.417,0.871,52,23,12,3
2229,21501000,Toronto Raptors,Milwaukee Bucks,107,89,196,18,Toronto Raptors,18,0.467,0.882,48,27,4,8,0.154,0.731,37,18,8,3
2230,21501001,Los Angeles Clippers,San Antonio Spurs,87,108,195,21,San Antonio Spurs,21,0.421,0.682,27,15,5,4,0.4,0.75,42,25,6,4
2231,21501002,Sacramento Kings,Los Angeles Lakers,106,98,204,8,Sacramento Kings,8,0.222,0.788,41,26,17,8,0.192,0.731,49,20,10,5
2232,21501003,Oklahoma City Thunder,Boston Celtics,130,109,239,21,Oklahoma City Thunder,21,0.414,0.8,53,23,7,5,0.263,0.889,42,17,4,4
2233,21501004,Orlando Magic,Charlotte Hornets,99,107,206,8,Charlotte Hornets,8,0.44,0.857,40,23,4,9,0.297,0.762,59,23,3,4
2234,21501005,Dallas Mavericks,Cleveland Cavaliers,98,99,197,1,Cleveland Cavaliers,1,0.318,0.895,32,24,6,7,0.27,0.846,48,21,9,4
2235,21501006,Chicago Bulls,Washington Wizards,96,117,213,21,Washington Wizards,21,0.3,0.87,40,20,10,3,0.619,0.75,47,25,12,6
2236,21501007,Atlanta Hawks,Detroit Pistons,118,114,232,4,Atlanta Hawks,4,0.353,0.824,46,25,10,3,0.32,0.718,48,23,3,4
2237,21501008,Minnesota Timberwolves,Memphis Grizzlies,114,108,222,6,Minnesota Timberwolves,6,0.476,0.774,33,31,5,8,0.2,0.762,51,22,3,8
2238,21501009,Los Angeles Clippers,Houston Rockets,122,106,228,16,Los Angeles Clippers,16,0.4,0.75,33,31,9,7,0.36,0.708,39,23,5,3
2239,21501010,New Orleans Pelicans,Sacramento Kings,123,108,231,15,New Orleans Pelicans,15,0.571,0.813,42,26,5,4,0.5,0.882,39,23,7,2
2240,21501011,New York Knicks,Golden State Warriors,85,121,206,36,Golden State Warriors,36,0.368,0.6,38,29,7,3,0.486,0.917,54,32,4,8
2241,21501012,Toronto Raptors,Indiana Pacers,101,94,195,7,Toronto Raptors,7,0.318,0.789,57,11,5,5,0.286,0.696,48,21,9,7
2242,21501013,Washington Wizards,Philadelphia 76ers,99,94,193,5,Washington Wizards,5,0.222,0.684,60,25,8,1,0.182,0.692,40,17,16,3
2243,21501014,Charlotte Hornets,Miami Heat,109,106,215,3,Charlotte Hornets,3,0.5,0.762,39,19,3,0,0.412,0.792,39,22,5,8
2244,21501015,Denver Nuggets,Atlanta Hawks,98,116,214,18,Atlanta Hawks,18,0.273,0.824,39,22,6,4,0.462,0.857,40,32,5,8
2245,21501016,Brooklyn Nets,Chicago Bulls,102,118,220,16,Chicago Bulls,16,0.286,0.8,39,22,7,3,0.458,1,50,26,6,8
2246,21501017,Memphis Grizzlies,Milwaukee Bucks,86,96,182,10,Milwaukee Bucks,10,0.231,0.882,47,16,8,3,0.263,0.68,44,21,7,17
2247,21501018,Portland Trail Blazers,San Antonio Spurs,110,118,228,8,San Antonio Spurs,8,0.455,0.733,49,23,5,6,0.5,0.909,37,35,8,11
2248,21501019,Phoenix Suns,Utah Jazz,69,103,172,34,Utah Jazz,34,0.231,0.5,43,14,9,1,0.44,0.667,51,20,14,5
2249,21501020,Cleveland Cavaliers,Orlando Magic,109,103,212,6,Cleveland Cavaliers,6,0.464,0.741,41,23,7,4,0.5,0.818,36,24,12,4
2250,21501021,Oklahoma City Thunder,Philadelphia 76ers,111,97,208,14,Oklahoma City Thunder,14,0.318,0.778,63,27,3,8,0.345,0.63,36,24,11,5
2251,21501022,Sacramento Kings,Detroit Pistons,108,115,223,7,Detroit Pistons,7,0.267,0.828,35,21,8,4,0.462,0.833,49,25,7,6
2252,21501023,Boston Celtics,Toronto Raptors,91,105,196,14,Toronto Raptors,14,0.429,0.833,37,18,8,3,0.464,0.72,40,18,10,8
2253,21501024,Minnesota Timberwolves,Houston Rockets,111,116,227,5,Houston Rockets,5,0.375,0.792,35,30,14,4,0.379,0.643,42,31,9,7
2254,21501025,Portland Trail Blazers,New Orleans Pelicans,117,112,229,5,Portland Trail Blazers,5,0.333,0.9,45,17,4,3,0.476,0.786,34,23,7,4
2255,21501026,Golden State Warriors,Dallas Mavericks,130,112,242,18,Golden State Warriors,18,0.579,0.857,42,35,8,7,0.31,0.955,46,25,4,8
2256,21501027,Phoenix Suns,Los Angeles Lakers,95,90,185,5,Phoenix Suns,5,0.267,0.885,57,19,5,6,0.261,0.846,50,21,4,6
2257,21501028,Denver Nuggets,Charlotte Hornets,101,93,194,8,Denver Nuggets,8,0.5,0.696,51,19,6,4,0.281,0.7,38,22,6,13
2258,21501029,Houston Rockets,Atlanta Hawks,97,109,206,12,Atlanta Hawks,12,0.217,0.839,51,15,11,3,0.368,0.583,40,32,12,6
2259,21501030,Brooklyn Nets,Detroit Pistons,103,115,218,12,Detroit Pistons,12,0.357,0.667,40,24,3,5,0.417,0.619,45,30,5,4
2260,21501031,Oklahoma City Thunder,Indiana Pacers,115,111,226,4,Oklahoma City Thunder,4,0.357,0.808,45,26,8,4,0.409,0.733,34,28,11,2
2261,21501032,New York Knicks,Washington Wizards,89,99,188,10,Washington Wizards,10,0.476,0.882,42,21,2,9,0.276,0.765,42,24,7,4
2262,21501033,Cleveland Cavaliers,Miami Heat,101,122,223,21,Miami Heat,21,0.417,0.846,26,19,6,3,0.579,0.826,42,29,7,5
2263,21501034,Utah Jazz,Chicago Bulls,85,92,177,7,Chicago Bulls,7,0.296,0.583,40,22,5,4,0.316,0.727,42,24,4,6
2264,21501035,Los Angeles Clippers,Memphis Grizzlies,102,113,215,11,Memphis Grizzlies,11,0.4,0.718,30,18,8,8,0.267,0.806,44,23,9,5
2265,21501036,Golden State Warriors,San Antonio Spurs,79,87,166,8,San Antonio Spurs,8,0.25,0.8,37,24,12,3,0.381,0.833,53,17,4,6
2266,21501037,Portland Trail Blazers,Dallas Mavericks,120,132,252,12,Dallas Mavericks,12,0.391,0.643,52,25,9,4,0.6,0.826,50,31,7,8
2267,21501038,Orlando Magic,Toronto Raptors,100,105,205,5,Toronto Raptors,5,0.364,0.667,40,20,4,8,0.3,0.644,45,18,8,7
2268,21501039,Boston Celtics,Philadelphia 76ers,120,105,225,15,Boston Celtics,15,0.4,0.857,53,28,8,3,0.381,0.704,40,28,5,7
2269,21501040,Los Angeles Clippers,New Orleans Pelicans,105,109,214,4,New Orleans Pelicans,4,0.256,0.69,35,21,12,5,0.333,0.8,54,22,9,1
2270,21501041,Utah Jazz,Milwaukee Bucks,94,85,179,9,Utah Jazz,9,0.342,0.929,44,24,8,4,0.375,0.824,27,21,10,10
2271,21501042,Sacramento Kings,New York Knicks,88,80,168,8,Sacramento Kings,8,0.28,0.786,49,20,11,3,0.211,0.8,55,16,5,7
2272,21501043,San Antonio Spurs,Charlotte Hornets,88,91,179,3,Charlotte Hornets,3,0.235,0.769,47,23,9,12,0.421,0.684,46,18,11,5
2273,21501044,Denver Nuggets,Cleveland Cavaliers,91,124,215,33,Cleveland Cavaliers,33,0.364,0.76,35,19,10,4,0.484,0.765,43,38,10,4
2274,21501045,Philadelphia 76ers,Indiana Pacers,75,91,166,16,Indiana Pacers,16,0.222,0.643,44,15,4,4,0.385,0.846,45,18,7,5
2275,21501046,Orlando Magic,Boston Celtics,96,107,203,11,Boston Celtics,11,0.263,0.684,45,15,9,7,0.318,0.833,46,22,8,6
2276,21501047,Milwaukee Bucks,Detroit Pistons,91,92,183,1,Detroit Pistons,1,0.556,0.571,40,23,5,7,0.273,0.765,39,18,6,3
2277,21501048,Washington Wizards,Atlanta Hawks,117,102,219,15,Washington Wizards,15,0.52,0.6,44,27,10,3,0.394,0.765,33,23,5,6
2278,21501049,Sacramento Kings,Chicago Bulls,102,109,211,7,Chicago Bulls,7,0.31,0.813,50,23,6,2,0.5,0.652,40,28,13,7
2279,21501050,Golden State Warriors,Minnesota Timberwolves,109,104,213,5,Golden State Warriors,5,0.333,0.625,44,31,13,10,0.368,0.833,37,26,8,5
2280,21501051,Memphis Grizzlies,Phoenix Suns,103,97,200,6,Memphis Grizzlies,6,0.4,0.895,45,18,10,4,0.393,0.765,45,22,8,10
2281,21501052,Charlotte Hornets,Brooklyn Nets,105,100,205,5,Charlotte Hornets,5,0.357,0.81,36,21,7,5,0.444,0.889,44,21,4,2
2282,21501053,Miami Heat,New Orleans Pelicans,113,99,212,14,Miami Heat,14,0.158,0.815,53,21,5,5,0.438,0.8,42,16,7,1
2283,21501054,Houston Rockets,Oklahoma City Thunder,107,111,218,4,Oklahoma City Thunder,4,0.351,0.824,47,26,9,3,0.229,0.724,46,22,10,7
2284,21501055,Memphis Grizzlies,Los Angeles Lakers,100,107,207,7,Los Angeles Lakers,7,0.267,0.696,33,23,13,2,0.316,0.958,40,21,10,4
2285,21501056,Atlanta Hawks,Washington Wizards,122,101,223,21,Atlanta Hawks,21,0.405,0.682,41,32,10,5,0.4,0.917,43,25,7,2
2286,21501057,Toronto Raptors,Boston Celtics,79,91,170,12,Boston Celtics,12,0.273,0.55,52,13,3,7,0.4,0.619,48,24,5,5
2287,21501058,Orlando Magic,Detroit Pistons,102,118,220,16,Detroit Pistons,16,0.32,0.842,44,24,9,3,0.458,0.84,45,30,4,5
2288,21501059,Milwaukee Bucks,Cleveland Cavaliers,104,113,217,9,Cleveland Cavaliers,9,0.438,0.733,31,23,8,4,0.294,0.852,42,29,6,8
2289,21501060,New York Knicks,Chicago Bulls,115,107,222,8,New York Knicks,8,0.56,0.733,53,28,4,6,0.469,0.762,34,29,7,5
2290,21501061,Utah Jazz,Houston Rockets,89,87,176,2,Utah Jazz,2,0.379,0.8,48,22,8,5,0.391,0.545,32,22,13,9
2291,21501062,Sacramento Kings,Minnesota Timberwolves,104,113,217,9,Minnesota Timberwolves,9,0.4,0.522,40,23,6,4,0.385,0.563,43,29,8,6
2292,21501063,Miami Heat,San Antonio Spurs,88,112,200,24,San Antonio Spurs,24,0.5,0.583,36,23,8,6,0.571,0.833,44,26,7,4
2293,21501064,Philadelphia 76ers,Denver Nuggets,103,104,207,1,Denver Nuggets,1,0.405,0.933,45,26,7,4,0.353,0.8,46,18,7,9
2294,21501065,Los Angeles Lakers,Phoenix Suns,107,119,226,12,Phoenix Suns,12,0.259,0.846,41,13,6,6,0.464,0.6,52,31,6,4
2295,21501066,Los Angeles Clippers,Golden State Warriors,98,114,212,16,Golden State Warriors,16,0.286,0.667,46,21,8,7,0.441,0.75,50,23,9,5
2296,21501067,Dallas Mavericks,Portland Trail Blazers,103,109,212,6,Portland Trail Blazers,6,0.3,0.909,47,21,8,6,0.259,0.88,46,19,12,8
2297,21501068,New Orleans Pelicans,Indiana Pacers,84,92,176,8,Indiana Pacers,8,0.25,0.714,47,15,7,0,0.35,0.867,44,26,10,6
2298,21501069,Cleveland Cavaliers,Brooklyn Nets,95,104,199,9,Brooklyn Nets,9,0.263,0.778,45,22,3,2,0.364,0.737,46,28,10,5
2299,21501070,Chicago Bulls,New York Knicks,94,106,200,12,New York Knicks,12,0.24,0.778,34,15,9,2,0.433,0.938,45,19,4,9
2300,21501071,Utah Jazz,Oklahoma City Thunder,91,113,204,22,Oklahoma City Thunder,22,0.227,0.696,36,18,8,3,0.409,0.636,39,27,13,4
2301,21501072,Portland Trail Blazers,Los Angeles Clippers,94,96,190,2,Los Angeles Clippers,2,0.25,0.75,41,18,10,5,0.211,0.643,47,21,9,5
2302,21501073,Minnesota Timberwolves,Washington Wizards,132,129,261,3,Minnesota Timberwolves,3,0.308,1,42,33,9,2,0.448,0.696,45,37,7,2
2303,21501074,Charlotte Hornets,Detroit Pistons,105,112,217,7,Detroit Pistons,7,0.467,0.773,42,24,8,2,0.267,0.769,62,22,4,6
2304,21501075,Orlando Magic,Miami Heat,97,108,205,11,Miami Heat,11,0.333,0.679,42,20,7,1,0.333,0.697,45,23,9,7
2305,21501076,Milwaukee Bucks,Atlanta Hawks,90,101,191,11,Atlanta Hawks,11,0.231,0.654,49,16,4,9,0.156,0.824,45,26,10,6
2306,21501077,Toronto Raptors,Houston Rockets,109,112,221,3,Houston Rockets,3,0.419,0.692,45,23,9,5,0.545,0.457,48,25,3,11
2307,21501078,Memphis Grizzlies,San Antonio Spurs,104,110,214,6,San Antonio Spurs,6,0.389,0.692,31,23,11,4,0.389,0.833,37,25,7,5
2308,21501079,Phoenix Suns,Sacramento Kings,94,116,210,22,Sacramento Kings,22,0.281,0.652,57,20,4,2,0.318,0.744,52,28,10,7
2309,21501080,Dallas Mavericks,Golden State Warriors,120,128,248,8,Golden State Warriors,8,0.514,0.762,51,31,3,6,0.467,0.913,40,30,8,10
2310,21501081,Denver Nuggets,Los Angeles Lakers,116,105,221,11,Denver Nuggets,11,0.385,0.667,48,31,5,7,0.435,0.808,43,23,6,3
2311,21501082,Indiana Pacers,Brooklyn Nets,110,120,230,10,Brooklyn Nets,10,0.458,0.833,31,24,15,4,0.455,0.861,40,24,13,1
2312,21501083,Chicago Bulls,Orlando Magic,89,111,200,22,Orlando Magic,22,0.25,0.647,40,20,2,3,0.368,0.667,50,32,5,7
2313,21501084,Toronto Raptors,New Orleans Pelicans,115,91,206,24,Toronto Raptors,24,0.414,0.893,48,24,6,7,0.267,0.65,36,22,6,1
2314,21501085,Atlanta Hawks,Detroit Pistons,112,95,207,17,Atlanta Hawks,17,0.382,0.929,39,34,6,7,0.241,0.714,53,25,2,4
2315,21501086,Cleveland Cavaliers,New York Knicks,107,93,200,14,Cleveland Cavaliers,14,0.412,0.76,53,21,6,5,0.348,0.679,41,20,5,0
2316,21501087,Utah Jazz,Minnesota Timberwolves,93,84,177,9,Utah Jazz,9,0.429,0.857,45,21,5,9,0.364,0.842,41,18,9,4
2317,21501088,San Antonio Spurs,Oklahoma City Thunder,92,111,203,19,Oklahoma City Thunder,19,0.267,0.824,34,14,8,3,0.35,0.889,47,19,6,5
2318,21501089,Charlotte Hornets,Milwaukee Bucks,115,91,206,24,Charlotte Hornets,24,0.552,0.81,35,30,6,8,0.267,0.867,37,26,6,3
2319,21501090,Boston Celtics,Phoenix Suns,102,99,201,3,Boston Celtics,3,0.276,0.889,49,14,7,3,0.226,0.857,44,19,7,3
2320,21501091,Philadelphia 76ers,Portland Trail Blazers,105,108,213,3,Portland Trail Blazers,3,0.263,0.708,53,21,5,6,0.32,0.8,56,21,9,5
2321,21501092,Denver Nuggets,Los Angeles Clippers,90,105,195,15,Los Angeles Clippers,15,0.241,0.692,44,24,7,5,0.357,0.731,44,24,13,11
2322,21501093,Houston Rockets,Indiana Pacers,101,104,205,3,Indiana Pacers,3,0.212,0.667,44,17,7,3,0.346,0.65,50,25,9,6
2323,21501094,Philadelphia 76ers,Golden State Warriors,105,117,222,12,Golden State Warriors,12,0.333,0.917,37,27,10,3,0.424,0.75,44,32,9,4
2324,21501095,Dallas Mavericks,Sacramento Kings,111,133,244,22,Sacramento Kings,22,0.333,0.792,41,22,6,2,0.45,0.733,41,32,11,3
2325,21501096,Washington Wizards,Los Angeles Lakers,101,88,189,13,Washington Wizards,13,0.389,0.552,42,23,12,2,0.25,0.882,42,15,12,0
2326,21501097,Brooklyn Nets,Miami Heat,99,110,209,11,Miami Heat,11,0.273,0.778,36,20,8,2,0.313,0.75,32,25,11,4
2327,21501098,Oklahoma City Thunder,Toronto Raptors,119,100,219,19,Oklahoma City Thunder,19,0.423,0.813,53,29,7,5,0.333,0.696,40,19,4,7
2328,21501099,Atlanta Hawks,Chicago Bulls,102,100,202,2,Atlanta Hawks,2,0.227,0.893,48,22,4,13,0.409,0.733,58,22,4,5
2329,21501100,San Antonio Spurs,Memphis Grizzlies,101,87,188,14,San Antonio Spurs,14,0.333,0.733,43,23,9,7,0.316,0.625,39,19,8,4
2330,21501101,Phoenix Suns,Minnesota Timberwolves,116,121,237,5,Minnesota Timberwolves,5,0.455,0.826,36,22,9,2,0.269,0.8,41,22,10,3
2331,21501102,New York Knicks,New Orleans Pelicans,91,99,190,8,New Orleans Pelicans,8,0.323,0.692,42,26,9,6,0.421,0.73,47,18,11,3
2332,21501103,Dallas Mavericks,Denver Nuggets,97,88,185,9,Dallas Mavericks,9,0.344,0.933,34,23,14,6,0.375,0.895,44,20,3,4
2333,21501104,Los Angeles Lakers,Utah Jazz,75,123,198,48,Utah Jazz,48,0.35,0.727,37,11,5,6,0.531,0.737,57,26,4,7
2334,21501105,Sacramento Kings,Portland Trail Blazers,93,105,198,12,Portland Trail Blazers,12,0.467,0.632,43,20,11,2,0.483,0.833,42,25,6,10
2335,21501106,Boston Celtics,Los Angeles Clippers,90,114,204,24,Los Angeles Clippers,24,0.368,0.778,49,14,7,4,0.44,0.833,45,29,13,5
2336,21501107,Chicago Bulls,Indiana Pacers,98,96,194,2,Chicago Bulls,2,0.385,0.875,41,22,5,6,0.158,0.882,44,20,9,6
2337,21501108,Brooklyn Nets,Orlando Magic,105,139,244,34,Orlando Magic,34,0.357,0.667,39,19,7,5,0.519,0.684,35,40,11,5
2338,21501109,Charlotte Hornets,Philadelphia 76ers,100,85,185,15,Charlotte Hornets,15,0.28,0.944,64,26,6,6,0.364,0.9,45,20,8,5
2339,21501110,Oklahoma City Thunder,Detroit Pistons,82,88,170,6,Detroit Pistons,6,0.286,0.636,45,16,10,7,0.211,0.9,53,20,6,4
2340,21501111,Houston Rockets,Cleveland Cavaliers,106,100,206,6,Houston Rockets,6,0.36,0.5,55,23,7,5,0.35,0.857,38,21,5,5
2341,21501112,Washington Wizards,Golden State Warriors,94,102,196,8,Golden State Warriors,8,0.217,0.63,48,26,6,7,0.44,0.652,55,27,11,6
2342,21501113,Atlanta Hawks,Toronto Raptors,97,105,202,8,Toronto Raptors,8,0.424,0.692,44,24,3,7,0.478,0.786,44,26,14,4
2343,21501114,Denver Nuggets,Memphis Grizzlies,109,105,214,4,Denver Nuggets,4,0.448,0.833,42,24,4,7,0.316,0.63,46,18,5,4
2344,21501115,Phoenix Suns,Milwaukee Bucks,94,105,199,11,Milwaukee Bucks,11,0.208,0.765,49,23,6,4,0.4,0.735,38,21,13,9
2345,21501116,Los Angeles Clippers,Minnesota Timberwolves,99,79,178,20,Los Angeles Clippers,20,0.29,0.889,41,26,8,9,0.348,0.647,53,20,2,1
2346,21501117,New York Knicks,Dallas Mavericks,89,91,180,2,Dallas Mavericks,2,0.176,0.889,43,17,11,2,0.32,0.765,42,18,7,1
2347,21501118,New Orleans Pelicans,San Antonio Spurs,92,100,192,8,San Antonio Spurs,8,0.471,0.667,44,27,6,0,0.5,0.727,38,23,10,8
2348,21501119,Golden State Warriors,Utah Jazz,103,96,199,7,Golden State Warriors,7,0.343,0.722,46,19,6,6,0.281,0.448,54,14,11,2
2349,21501120,Washington Wizards,Sacramento Kings,111,120,231,9,Sacramento Kings,9,0.346,0.8,42,30,6,4,0.444,0.72,40,27,13,6
2350,21501121,Miami Heat,Los Angeles Lakers,100,102,202,2,Los Angeles Lakers,2,0.176,0.577,55,26,6,13,0.3,0.759,49,14,9,5
2351,21501122,Brooklyn Nets,Cleveland Cavaliers,87,107,194,20,Cleveland Cavaliers,20,0.19,0.619,55,26,12,4,0.316,0.792,50,29,10,7
2352,21501123,Orlando Magic,Indiana Pacers,114,94,208,20,Orlando Magic,20,0.313,0.722,44,26,6,6,0.368,0.714,49,18,11,4
2353,21501124,Chicago Bulls,Houston Rockets,103,100,203,3,Chicago Bulls,3,0.458,0.818,42,28,5,4,0.36,0.864,45,19,5,6
2354,21501125,Denver Nuggets,New Orleans Pelicans,95,101,196,6,New Orleans Pelicans,6,0.37,0.765,40,28,10,7,0.448,0.889,51,29,7,4
2355,21501126,Los Angeles Clippers,Oklahoma City Thunder,117,119,236,2,Oklahoma City Thunder,2,0.552,0.773,26,22,9,4,0.313,0.792,46,25,10,1
2356,21501127,Boston Celtics,Portland Trail Blazers,109,116,225,7,Portland Trail Blazers,7,0.375,0.765,48,20,12,6,0.412,0.741,50,26,9,10
2357,21501128,Philadelphia 76ers,Charlotte Hornets,91,100,191,9,Charlotte Hornets,9,0.256,0.714,48,24,5,7,0.259,0.778,55,23,9,6
2358,21501129,Dallas Mavericks,Detroit Pistons,98,89,187,9,Dallas Mavericks,9,0.333,0.857,48,18,4,5,0.394,0.583,47,23,4,4
2359,21501130,Brooklyn Nets,New York Knicks,91,105,196,14,New York Knicks,14,0.167,0.75,52,20,11,2,0.609,1,46,24,4,8
2360,21501131,Cleveland Cavaliers,Atlanta Hawks,110,108,218,2,Cleveland Cavaliers,2,0.316,0.645,57,27,9,6,0.3,0.885,48,25,5,8
2361,21501132,Toronto Raptors,Memphis Grizzlies,99,95,194,4,Toronto Raptors,4,0.429,0.931,41,16,8,12,0.368,0.824,42,16,13,7
2362,21501133,Orlando Magic,Milwaukee Bucks,110,113,223,3,Milwaukee Bucks,3,0.333,0.833,37,34,13,8,0.235,0.6,40,31,14,6
2363,21501134,Minnesota Timberwolves,Utah Jazz,85,98,183,13,Utah Jazz,13,0.391,0.6,34,25,11,1,0.364,0.609,43,13,9,5
2364,21501135,Miami Heat,Sacramento Kings,112,106,218,6,Miami Heat,6,0.545,0.941,38,23,5,6,0.333,0.793,41,20,7,5
2365,21501136,Boston Celtics,Golden State Warriors,109,106,215,3,Boston Celtics,3,0.348,0.633,44,28,10,1,0.465,0.769,41,25,12,7
2366,21501137,Washington Wizards,Phoenix Suns,106,99,205,7,Washington Wizards,7,0.385,0.8,44,22,6,7,0.304,0.769,56,19,5,3
2367,21501138,Indiana Pacers,Philadelphia 76ers,115,102,217,13,Indiana Pacers,13,0.348,0.826,48,27,9,4,0.432,0.692,38,23,3,1
2368,21501139,Detroit Pistons,Chicago Bulls,94,90,184,4,Detroit Pistons,4,0.5,0.588,45,17,8,2,0.36,0.867,47,21,6,10
2369,21501140,Toronto Raptors,San Antonio Spurs,95,102,197,7,San Antonio Spurs,7,0.333,0.9,32,18,8,3,0.25,0.9,47,28,11,5
2370,21501141,Sacramento Kings,Denver Nuggets,115,106,221,9,Sacramento Kings,9,0.381,0.806,48,27,4,5,0.31,0.708,50,27,3,10
2371,21501142,Miami Heat,Portland Trail Blazers,93,110,203,17,Portland Trail Blazers,17,0.316,0.704,42,16,9,4,0.667,0.783,45,21,9,4
2372,21501143,New Orleans Pelicans,Brooklyn Nets,106,87,193,19,New Orleans Pelicans,19,0.364,0.609,32,31,11,7,0.348,0.619,50,20,5,3
2373,21501144,Charlotte Hornets,Cleveland Cavaliers,103,112,215,9,Cleveland Cavaliers,9,0.346,0.963,35,23,15,4,0.552,0.462,46,34,7,1
2374,21501145,Oklahoma City Thunder,Houston Rockets,110,118,228,8,Houston Rockets,8,0.259,0.844,50,21,5,5,0.31,0.885,45,24,11,5
2375,21501146,Dallas Mavericks,Minnesota Timberwolves,88,78,166,10,Dallas Mavericks,10,0.35,0.588,44,19,6,4,0.19,0.889,41,20,8,4
2376,21501147,Washington Wizards,Los Angeles Clippers,109,114,223,5,Los Angeles Clippers,5,0.367,0.571,51,31,8,1,0.421,0.606,44,27,9,4
2377,21501148,Memphis Grizzlies,Orlando Magic,107,119,226,12,Orlando Magic,12,0.381,0.654,46,22,4,4,0.385,0.793,43,27,10,3
2378,21501149,Utah Jazz,Phoenix Suns,101,86,187,15,Utah Jazz,15,0.37,0.765,33,27,9,10,0.296,0.632,45,16,5,1
2379,21501150,Chicago Bulls,Milwaukee Bucks,102,98,200,4,Chicago Bulls,4,0.269,0.773,34,30,10,4,0.286,0.8,44,28,6,7
2380,21501151,Indiana Pacers,New York Knicks,92,87,179,5,Indiana Pacers,5,0.318,0.85,53,17,5,3,0.28,0.7,51,20,7,9
2381,21501152,Portland Trail Blazers,Golden State Warriors,111,136,247,25,Golden State Warriors,25,0.375,0.788,37,23,8,4,0.6,0.818,43,30,5,8
2382,21501153,Boston Celtics,Los Angeles Lakers,107,100,207,7,Boston Celtics,7,0.267,0.773,50,30,8,1,0.286,0.69,47,22,6,4
2383,21501154,New Orleans Pelicans,Philadelphia 76ers,93,107,200,14,Philadelphia 76ers,14,0.389,0.75,49,20,5,1,0.382,0.824,41,31,10,6
2384,21501155,Detroit Pistons,Miami Heat,89,107,196,18,Miami Heat,18,0.227,0.8,43,14,7,1,0.643,0.714,41,22,6,4
2385,21501156,Charlotte Hornets,Toronto Raptors,90,96,186,6,Toronto Raptors,6,0.314,0.714,43,20,5,6,0.261,0.71,47,19,6,8
2386,21501157,Phoenix Suns,Atlanta Hawks,90,103,193,13,Atlanta Hawks,13,0.387,0.6,51,19,13,4,0.324,0.737,50,26,16,3
2387,21501158,Chicago Bulls,Memphis Grizzlies,92,108,200,16,Memphis Grizzlies,16,0.379,0.684,42,22,6,11,0.368,0.885,42,18,13,1
2388,21501159,Cleveland Cavaliers,Milwaukee Bucks,109,80,189,29,Cleveland Cavaliers,29,0.5,0.9,41,30,4,8,0.25,0.5,41,20,7,1
2389,21501160,Oklahoma City Thunder,Denver Nuggets,124,102,226,22,Oklahoma City Thunder,22,0.455,0.708,55,32,10,4,0.333,0.667,38,28,9,4
2390,21501161,San Antonio Spurs,Utah Jazz,88,86,174,2,San Antonio Spurs,2,0.412,0.895,32,16,10,4,0.294,0.81,40,13,5,4
2391,21501162,Portland Trail Blazers,Sacramento Kings,115,107,222,8,Portland Trail Blazers,8,0.387,0.852,49,20,12,7,0.5,0.667,34,20,6,7
2392,21501163,Minnesota Timberwolves,Golden State Warriors,124,117,241,7,Minnesota Timberwolves,7,0.471,0.778,40,30,14,6,0.343,0.875,46,35,9,5
2393,21501164,Los Angeles Lakers,Los Angeles Clippers,81,103,184,22,Los Angeles Clippers,22,0.3,0.92,43,11,10,3,0.35,0.615,46,26,11,4
2394,21501165,Cleveland Cavaliers,Indiana Pacers,109,123,232,14,Indiana Pacers,14,0.276,0.912,33,15,7,3,0.516,0.773,38,25,9,1
2395,21501166,Detroit Pistons,Orlando Magic,108,104,212,4,Detroit Pistons,4,0.407,0.613,44,24,9,6,0.267,0.737,48,25,7,8
2396,21501167,Brooklyn Nets,Washington Wizards,103,121,224,18,Washington Wizards,18,0.412,0.75,38,26,7,4,0.286,0.85,53,36,7,10
2397,21501168,New Orleans Pelicans,Boston Celtics,97,104,201,7,Boston Celtics,7,0.375,0.87,49,21,5,2,0.294,0.815,41,24,10,7
2398,21501169,Charlotte Hornets,New York Knicks,111,97,208,14,Charlotte Hornets,14,0.462,0.882,38,19,9,3,0.385,0.867,43,24,5,6
2399,21501170,Houston Rockets,Dallas Mavericks,86,88,174,2,Dallas Mavericks,2,0.3,0.667,41,19,6,4,0.303,0.857,40,19,9,4
2400,21501171,Oklahoma City Thunder,Portland Trail Blazers,115,120,235,5,Portland Trail Blazers,5,0.409,0.645,50,18,9,2,0.455,0.792,39,32,11,6
2401,21501172,Los Angeles Clippers,Los Angeles Lakers,91,81,172,10,Los Angeles Clippers,10,0.28,0.714,49,23,10,6,0.211,0.765,49,12,6,1
2402,21501173,Toronto Raptors,Atlanta Hawks,87,95,182,8,Atlanta Hawks,8,0.381,0.75,46,16,10,4,0.375,0.81,41,23,4,12
2403,21501174,Chicago Bulls,Miami Heat,98,106,204,8,Miami Heat,8,0.214,0.893,41,18,6,7,0.286,0.824,47,16,8,2
2404,21501175,Phoenix Suns,Houston Rockets,124,115,239,9,Phoenix Suns,9,0.387,0.828,47,31,11,2,0.424,0.607,26,26,13,12
2405,21501176,Minnesota Timberwolves,Sacramento Kings,105,97,202,8,Minnesota Timberwolves,8,0.524,0.71,43,25,11,4,0.353,0.905,47,19,11,5
2406,21501177,San Antonio Spurs,Golden State Warriors,101,112,213,11,Golden State Warriors,11,0.438,0.696,32,28,10,2,0.48,0.909,43,33,8,2
2407,21501178,Brooklyn Nets,Charlotte Hornets,99,113,212,14,Charlotte Hornets,14,0.4,0.55,45,24,9,5,0.378,0.85,42,26,11,12
2408,21501179,Miami Heat,Orlando Magic,109,112,221,3,Orlando Magic,3,0.364,0.524,53,18,6,5,0.455,0.75,37,23,4,9
2409,21501180,New York Knicks,Philadelphia 76ers,109,102,211,7,New York Knicks,7,0.25,0.633,59,19,6,8,0.378,0.667,46,25,7,5
2410,21501181,Milwaukee Bucks,Boston Celtics,109,124,233,15,Boston Celtics,15,0.412,0.69,38,30,10,5,0.429,0.789,34,35,6,9
2411,21501182,Washington Wizards,Detroit Pistons,99,112,211,13,Detroit Pistons,13,0.316,0.739,36,19,5,1,0.438,0.897,44,17,5,2
2412,21501183,Indiana Pacers,Toronto Raptors,98,111,209,13,Toronto Raptors,13,0.296,0.8,33,22,7,7,0.455,0.711,36,21,4,5
2413,21501184,Los Angeles Lakers,New Orleans Pelicans,102,110,212,8,New Orleans Pelicans,8,0.458,0.852,34,18,9,5,0.455,0.762,43,29,5,4
2414,21501185,Memphis Grizzlies,Dallas Mavericks,93,103,196,10,Dallas Mavericks,10,0.318,0.727,42,17,9,1,0.387,0.795,38,18,7,6
2415,21501186,San Antonio Spurs,Denver Nuggets,98,102,200,4,Denver Nuggets,4,0.214,0.821,45,20,6,8,0.273,0.842,47,21,9,7
2416,21501187,Los Angeles Clippers,Utah Jazz,102,99,201,3,Los Angeles Clippers,3,0.448,0.789,44,16,13,3,0.355,0.696,47,14,7,6
2417,21501188,Boston Celtics,Atlanta Hawks,107,118,225,11,Atlanta Hawks,11,0.393,0.667,40,26,10,6,0.515,0.818,44,31,10,10
2418,21501189,Phoenix Suns,New Orleans Pelicans,121,100,221,21,Phoenix Suns,21,0.4,0.806,53,27,6,8,0.333,0.75,42,19,8,2
2419,21501190,Golden State Warriors,Memphis Grizzlies,100,99,199,1,Golden State Warriors,1,0.278,0.923,48,20,3,7,0.333,0.9,54,19,8,4
2420,21501191,Cleveland Cavaliers,Chicago Bulls,102,105,207,3,Chicago Bulls,3,0.475,0.611,42,24,5,5,0.333,0.81,45,19,8,6
2421,21501192,Minnesota Timberwolves,Portland Trail Blazers,106,105,211,1,Minnesota Timberwolves,1,0.385,0.76,37,24,8,7,0.375,0.889,37,19,2,4
2422,21501193,Oklahoma City Thunder,Sacramento Kings,112,114,226,2,Sacramento Kings,2,0.406,0.75,44,24,6,5,0.406,0.55,40,22,12,4
2423,21501194,Charlotte Hornets,Washington Wizards,98,113,211,15,Washington Wizards,15,0.364,0.857,46,21,7,2,0.429,0.714,48,27,8,5
2424,21501195,Los Angeles Lakers,Houston Rockets,110,130,240,20,Houston Rockets,20,0.429,0.842,40,25,10,3,0.415,0.722,48,30,11,5
2425,21501196,Dallas Mavericks,Los Angeles Clippers,91,98,189,7,Los Angeles Clippers,7,0.267,0.697,47,18,6,5,0.5,0.405,42,25,11,6
2426,21501197,Milwaukee Bucks,Philadelphia 76ers,109,108,217,1,Milwaukee Bucks,1,0.304,0.917,53,26,10,8,0.283,0.68,45,24,12,6
2427,21501198,Utah Jazz,Denver Nuggets,100,84,184,16,Utah Jazz,16,0.387,0.762,49,19,7,8,0.222,0.737,41,18,6,7
2428,21501199,Brooklyn Nets,Indiana Pacers,105,129,234,24,Indiana Pacers,24,0.378,0.808,36,24,12,4,0.407,0.815,58,34,10,4
2429,21501200,Orlando Magic,Miami Heat,96,118,214,22,Miami Heat,22,0.389,0.789,35,18,6,1,0.3,0.867,41,28,10,3
2430,21501201,Golden State Warriors,San Antonio Spurs,92,86,178,6,Golden State Warriors,6,0.37,0.778,46,19,7,6,0.176,0.789,53,21,10,5
2431,21501202,Toronto Raptors,New York Knicks,93,89,182,4,Toronto Raptors,4,0.35,0.632,38,19,4,6,0.35,0.857,47,14,4,3
2432,21501203,Atlanta Hawks,Cleveland Cavaliers,94,109,203,15,Cleveland Cavaliers,15,0.267,0.533,42,23,8,6,0.379,0.9,47,17,9,4
2433,21501204,Milwaukee Bucks,Orlando Magic,98,107,205,9,Orlando Magic,9,0.2,0.684,45,18,6,7,0.304,0.643,36,28,19,10
2434,21501205,Charlotte Hornets,Boston Celtics,114,100,214,14,Charlotte Hornets,14,0.438,0.818,44,23,10,7,0.333,0.828,46,17,6,1
2435,21501206,Washington Wizards,Brooklyn Nets,120,111,231,9,Washington Wizards,9,0.36,0.792,47,27,8,1,0.323,0.619,43,24,9,9
2436,21501207,Houston Rockets,Minnesota Timberwolves,129,105,234,24,Houston Rockets,24,0.5,0.692,43,28,12,5,0.238,0.727,40,25,12,3
2437,21501208,Chicago Bulls,New Orleans Pelicans,121,116,237,5,Chicago Bulls,5,0.435,0.885,35,29,5,3,0.462,0.786,33,28,8,2
2438,21501209,Los Angeles Lakers,Oklahoma City Thunder,79,112,191,33,Oklahoma City Thunder,33,0.226,0.867,48,15,8,1,0.324,0.593,57,27,8,11
2439,21501210,Dallas Mavericks,Utah Jazz,101,92,193,9,Dallas Mavericks,9,0.344,0.818,47,19,7,2,0.273,0.722,38,21,5,3
2440,21501211,Sacramento Kings,Phoenix Suns,105,101,206,4,Sacramento Kings,4,0.353,0.607,40,25,11,12,0.227,0.824,51,21,8,3
2441,21501212,New York Knicks,Indiana Pacers,90,102,192,12,Indiana Pacers,12,0.37,0.889,37,27,6,8,0.316,0.7,41,26,10,3
2442,21501213,Miami Heat,Detroit Pistons,99,93,192,6,Miami Heat,6,0.35,0.727,39,15,7,5,0.278,0.667,48,15,9,4
2443,21501214,Philadelphia 76ers,Toronto Raptors,98,122,220,24,Toronto Raptors,24,0.429,0.52,32,24,8,6,0.4,0.842,52,25,11,5
2444,21501215,Oklahoma City Thunder,San Antonio Spurs,98,102,200,4,San Antonio Spurs,4,0.24,0.88,55,18,7,5,0.286,0.75,42,15,12,8
2445,21501216,Memphis Grizzlies,Los Angeles Clippers,84,110,194,26,Los Angeles Clippers,26,0.25,0.643,38,16,5,1,0.48,0.762,41,29,11,7
2446,21501217,Miami Heat,Boston Celtics,88,98,186,10,Boston Celtics,10,0.105,0.833,44,14,5,10,0.357,0.864,39,20,7,3
2447,21501218,Toronto Raptors,Brooklyn Nets,103,96,199,7,Toronto Raptors,7,0.351,0.533,57,24,5,10,0.385,0.667,39,26,8,8
2448,21501219,Orlando Magic,Charlotte Hornets,103,117,220,14,Charlotte Hornets,14,0.296,0.611,39,22,7,4,0.379,0.632,46,32,6,5
2449,21501220,Detroit Pistons,Cleveland Cavaliers,112,110,222,2,Detroit Pistons,2,0.485,0.786,47,24,5,11,0.389,0.733,43,21,4,7
2450,21501221,Atlanta Hawks,Washington Wizards,98,109,207,11,Washington Wizards,11,0.367,0.742,47,22,13,5,0.321,0.533,51,25,14,4
2451,21501222,Philadelphia 76ers,Chicago Bulls,105,115,220,10,Chicago Bulls,10,0.486,0.778,31,28,10,7,0.625,0.815,53,27,8,8
2452,21501223,San Antonio Spurs,Dallas Mavericks,96,91,187,5,San Antonio Spurs,5,0.261,0.769,42,24,8,3,0.308,0.81,41,20,8,2
2453,21501224,Sacramento Kings,Houston Rockets,81,116,197,35,Houston Rockets,35,0.297,0.462,49,21,11,4,0.286,0.632,55,33,11,7
2454,21501225,Indiana Pacers,Milwaukee Bucks,97,92,189,5,Indiana Pacers,5,0.458,0.8,48,28,8,3,0.304,0.846,43,23,8,3
2455,21501226,New Orleans Pelicans,Minnesota Timberwolves,109,144,253,35,Minnesota Timberwolves,35,0.367,0.818,33,31,7,0,0.464,0.826,43,41,14,8
2456,21501227,Memphis Grizzlies,Golden State Warriors,104,125,229,21,Golden State Warriors,21,0.333,0.75,40,25,12,1,0.426,0.813,51,35,7,7
2457,21501228,Utah Jazz,Los Angeles Lakers,96,101,197,5,Los Angeles Lakers,5,0.3,0.6,38,27,10,1,0.24,0.867,47,19,6,3
2458,21501229,Los Angeles Clippers,Phoenix Suns,105,114,219,9,Phoenix Suns,9,0.29,0.833,40,23,9,6,0.269,0.773,58,26,10,5
2459,21501230,Denver Nuggets,Portland Trail Blazers,99,107,206,8,Portland Trail Blazers,8,0.28,0.667,53,24,10,6,0.306,0.818,45,19,11,8
2460,21600001,New York Knicks,Cleveland Cavaliers,88,117,205,29,Cleveland Cavaliers,29,0.333,0.75,42,17,6,6,0.371,0.737,51,31,12,5
2461,21600002,Utah Jazz,Portland Trail Blazers,104,113,217,9,Portland Trail Blazers,9,0.333,1,31,19,9,5,0.684,1,34,22,5,3
2462,21600003,San Antonio Spurs,Golden State Warriors,129,100,229,29,San Antonio Spurs,29,0.5,0.885,55,25,13,3,0.212,0.722,35,24,11,6
2463,21600004,Miami Heat,Orlando Magic,108,96,204,12,Miami Heat,12,0.25,0.625,52,27,5,7,0.333,0.786,45,20,5,4
2464,21600005,Dallas Mavericks,Indiana Pacers,121,130,251,9,Indiana Pacers,9,0.375,0.722,49,26,8,8,0.526,0.765,52,30,11,6
2465,21600006,Brooklyn Nets,Boston Celtics,117,122,239,5,Boston Celtics,5,0.341,0.8,44,22,8,3,0.344,0.833,47,36,13,9
2466,21600007,Detroit Pistons,Toronto Raptors,91,109,200,18,Toronto Raptors,18,0.182,0.773,40,17,8,0,0.167,0.828,51,17,8,0
2467,21600008,Charlotte Hornets,Milwaukee Bucks,107,96,203,11,Charlotte Hornets,11,0.304,0.833,51,27,5,10,0.188,0.75,46,23,4,5
2468,21600009,Minnesota Timberwolves,Memphis Grizzlies,98,102,200,4,Memphis Grizzlies,4,0.333,0.69,45,20,6,5,0.458,0.704,45,19,6,11
2469,21600010,Denver Nuggets,New Orleans Pelicans,107,102,209,5,Denver Nuggets,5,0.333,0.758,58,18,7,4,0.158,0.885,33,31,16,5
2470,21600011,Oklahoma City Thunder,Philadelphia 76ers,103,97,200,6,Oklahoma City Thunder,6,0.273,0.731,53,19,7,3,0.292,0.72,43,21,5,10
2471,21600012,Sacramento Kings,Phoenix Suns,113,94,207,19,Sacramento Kings,19,0.286,0.731,41,24,5,5,0.25,0.667,41,20,6,3
2472,21600013,Houston Rockets,Los Angeles Lakers,114,120,234,6,Los Angeles Lakers,6,0.241,0.704,39,29,10,1,0.343,0.818,39,21,10,4
2473,21600014,Washington Wizards,Atlanta Hawks,99,114,213,15,Atlanta Hawks,15,0.3,0.722,40,25,14,4,0.462,0.778,52,28,13,7
2474,21600015,Boston Celtics,Chicago Bulls,99,105,204,6,Chicago Bulls,6,0.348,0.625,36,22,6,6,0.44,0.733,55,25,5,1
2475,21600016,San Antonio Spurs,Sacramento Kings,102,94,196,8,San Antonio Spurs,8,0.333,0.889,40,23,10,8,0.3,0.842,40,22,7,0
2476,21600017,Los Angeles Clippers,Portland Trail Blazers,114,106,220,8,Los Angeles Clippers,8,0.276,0.696,48,12,10,4,0.222,0.75,48,18,4,4
2477,21600018,Cleveland Cavaliers,Toronto Raptors,94,91,185,3,Cleveland Cavaliers,3,0.375,0.727,40,20,8,3,0.25,0.944,51,12,9,3
2478,21600019,Indiana Pacers,Brooklyn Nets,94,103,197,9,Brooklyn Nets,9,0.292,0.65,49,22,7,6,0.303,0.85,52,20,6,4
2479,21600020,Orlando Magic,Detroit Pistons,82,108,190,26,Detroit Pistons,26,0.308,0.667,44,20,8,3,0.368,0.833,53,27,8,4
2480,21600021,Phoenix Suns,Oklahoma City Thunder,110,113,223,3,Oklahoma City Thunder,3,0.179,0.656,44,15,11,3,0.238,0.737,57,13,11,3
2481,21600022,Charlotte Hornets,Miami Heat,97,91,188,6,Charlotte Hornets,6,0.318,0.833,49,20,10,9,0.412,0.65,52,19,2,4
2482,21600023,Houston Rockets,Dallas Mavericks,106,98,204,8,Houston Rockets,8,0.469,0.806,41,21,6,1,0.276,0.833,34,13,11,2
2483,21600024,Los Angeles Lakers,Utah Jazz,89,96,185,7,Utah Jazz,7,0.391,0.762,43,16,6,7,0.24,0.7,47,14,4,7
2484,21600025,Golden State Warriors,New Orleans Pelicans,122,114,236,8,Golden State Warriors,8,0.321,0.893,49,32,8,2,0.227,0.652,49,29,8,5
2485,21600026,Atlanta Hawks,Philadelphia 76ers,104,72,176,32,Atlanta Hawks,32,0.25,0.652,47,31,11,7,0.278,0.733,39,16,9,5
2486,21600027,Boston Celtics,Charlotte Hornets,104,98,202,6,Boston Celtics,6,0.484,0.647,42,25,4,6,0.281,0.758,38,22,8,6
2487,21600028,Memphis Grizzlies,New York Knicks,104,111,215,7,New York Knicks,7,0.36,0.808,40,19,3,2,0.286,0.641,41,24,4,4
2488,21600029,Orlando Magic,Cleveland Cavaliers,99,105,204,6,Cleveland Cavaliers,6,0.286,0.577,50,21,6,5,0.297,0.733,40,17,8,6
2489,21600030,Indiana Pacers,Chicago Bulls,101,118,219,17,Chicago Bulls,17,0.389,0.889,33,34,8,7,0.429,0.905,47,34,8,6
2490,21600031,Brooklyn Nets,Milwaukee Bucks,108,110,218,2,Milwaukee Bucks,2,0.324,0.821,45,23,12,6,0.364,0.833,44,25,14,5
2491,21600032,New Orleans Pelicans,San Antonio Spurs,79,98,177,19,San Antonio Spurs,19,0.182,0.733,45,14,6,5,0.417,0.783,50,21,6,7
2492,21600033,Portland Trail Blazers,Denver Nuggets,115,113,228,2,Portland Trail Blazers,2,0.313,0.714,45,23,10,8,0.261,0.795,61,19,10,5
2493,21600034,Minnesota Timberwolves,Sacramento Kings,103,106,209,3,Sacramento Kings,3,0.318,0.71,36,19,6,5,0.346,0.76,31,24,6,5
2494,21600035,Utah Jazz,Los Angeles Clippers,75,88,163,13,Los Angeles Clippers,13,0.368,0.769,43,18,8,2,0.222,0.7,49,17,8,4
2495,21600036,Golden State Warriors,Phoenix Suns,106,100,206,6,Golden State Warriors,6,0.276,0.848,43,27,6,5,0.348,0.72,50,19,10,6
2496,21600037,San Antonio Spurs,Miami Heat,106,99,205,7,San Antonio Spurs,7,0.556,0.846,44,20,4,5,0.35,0.692,36,19,7,6
2497,21600038,Milwaukee Bucks,Detroit Pistons,83,98,181,15,Detroit Pistons,15,0.235,0.786,40,22,10,4,0.25,0.75,58,23,8,4
2498,21600039,Washington Wizards,Memphis Grizzlies,103,112,215,9,Memphis Grizzlies,9,0.2,0.88,40,19,8,4,0.484,0.731,47,24,9,2
2499,21600040,Los Angeles Lakers,Oklahoma City Thunder,96,113,209,17,Oklahoma City Thunder,17,0.219,0.792,41,20,15,2,0.346,0.824,45,29,15,6
2500,21600041,Dallas Mavericks,Houston Rockets,92,93,185,1,Houston Rockets,1,0.355,0.85,43,17,8,3,0.355,0.667,47,16,5,4
2501,21600042,Denver Nuggets,Toronto Raptors,102,105,207,3,Toronto Raptors,3,0.409,0.771,46,14,2,9,0.25,0.76,43,16,7,9
2502,21600043,Chicago Bulls,Brooklyn Nets,118,88,206,30,Chicago Bulls,30,0.407,0.944,58,26,9,9,0.161,0.81,45,14,12,3
2503,21600044,Sacramento Kings,Atlanta Hawks,95,106,201,11,Atlanta Hawks,11,0.435,0.684,38,26,10,6,0.367,0.617,43,24,11,6
2504,21600045,Phoenix Suns,Los Angeles Clippers,98,116,214,18,Los Angeles Clippers,18,0.333,0.742,44,19,11,0,0.375,0.789,44,21,8,4
2505,21600046,Orlando Magic,Philadelphia 76ers,103,101,204,2,Orlando Magic,2,0.24,0.765,39,29,7,6,0.45,0.75,42,28,5,8
2506,21600047,Houston Rockets,Cleveland Cavaliers,120,128,248,8,Cleveland Cavaliers,8,0.386,0.68,32,30,5,2,0.5,0.839,46,22,4,2
2507,21600048,Los Angeles Lakers,Indiana Pacers,108,115,223,7,Indiana Pacers,7,0.214,0.88,44,14,8,2,0.357,0.793,43,19,10,8
2508,21600049,Sacramento Kings,Miami Heat,96,108,204,12,Miami Heat,12,0.217,0.852,53,12,4,4,0.448,0.724,45,24,10,9
2509,21600050,New York Knicks,Detroit Pistons,89,102,191,13,Detroit Pistons,13,0.318,0.8,43,18,6,9,0.615,0.571,48,19,7,5
2510,21600051,Milwaukee Bucks,New Orleans Pelicans,117,113,230,4,Milwaukee Bucks,4,0.313,0.905,49,30,9,5,0.346,0.78,42,23,13,5
2511,21600052,Memphis Grizzlies,Minnesota Timberwolves,80,116,196,36,Minnesota Timberwolves,36,0.167,0.759,32,10,17,4,0.6,0.783,50,29,10,5
2512,21600053,Utah Jazz,San Antonio Spurs,106,91,197,15,Utah Jazz,15,0.484,0.833,39,22,5,8,0.3,0.905,34,19,6,5
2513,21600054,Golden State Warriors,Portland Trail Blazers,127,104,231,23,Golden State Warriors,23,0.385,0.739,45,36,14,4,0.359,0.762,32,23,12,4
2514,21600055,Toronto Raptors,Washington Wizards,113,103,216,10,Toronto Raptors,10,0.4,0.68,31,21,16,2,0.3,0.667,36,21,8,5
2515,21600056,Philadelphia 76ers,Charlotte Hornets,93,109,202,16,Charlotte Hornets,16,0.316,0.867,37,23,8,2,0.382,0.692,44,25,8,3
2516,21600057,Detroit Pistons,Brooklyn Nets,101,109,210,8,Brooklyn Nets,8,0.36,0.857,38,21,11,6,0.481,0.824,45,27,10,3
2517,21600058,Houston Rockets,New York Knicks,118,99,217,19,Houston Rockets,19,0.375,0.704,54,25,12,8,0.4,0.68,34,18,10,6
2518,21600059,Los Angeles Lakers,Atlanta Hawks,123,116,239,7,Los Angeles Lakers,7,0.409,0.9,42,24,11,9,0.344,0.793,37,30,10,1
2519,21600060,New Orleans Pelicans,Memphis Grizzlies,83,89,172,6,Memphis Grizzlies,6,0.324,0.75,43,17,8,9,0.296,0.75,52,20,12,5
2520,21600061,Chicago Bulls,Boston Celtics,100,107,207,7,Boston Celtics,7,0.35,0.742,49,21,7,7,0.438,0.647,39,28,10,4
2521,21600062,Dallas Mavericks,Utah Jazz,81,97,178,16,Utah Jazz,16,0.269,0.8,36,18,4,4,0.48,0.577,41,18,6,3
2522,21600063,Portland Trail Blazers,Phoenix Suns,115,118,233,3,Phoenix Suns,3,0.364,0.905,53,25,8,8,0.313,0.833,59,15,10,5
2523,21600064,Oklahoma City Thunder,Los Angeles Clippers,85,83,168,2,Oklahoma City Thunder,2,0.25,0.6,52,14,8,4,0.318,0.444,41,22,13,5
2524,21600065,Sacramento Kings,Orlando Magic,94,102,196,8,Orlando Magic,8,0.389,0.647,39,17,8,1,0.333,0.696,44,24,5,4
2525,21600066,Indiana Pacers,Milwaukee Bucks,107,125,232,18,Milwaukee Bucks,18,0.435,0.778,32,29,14,4,0.444,0.792,41,32,10,6
2526,21600067,Denver Nuggets,Minnesota Timberwolves,102,99,201,3,Denver Nuggets,3,0.273,0.72,44,24,10,2,0.409,0.8,43,20,8,4
2527,21600068,Boston Celtics,Cleveland Cavaliers,122,128,250,6,Cleveland Cavaliers,6,0.344,0.864,39,25,4,6,0.412,0.865,42,24,6,6
2528,21600069,Oklahoma City Thunder,Golden State Warriors,96,122,218,26,Golden State Warriors,26,0.37,0.571,41,20,8,6,0.467,0.8,46,27,9,14
2529,21600070,Atlanta Hawks,Washington Wizards,92,95,187,3,Washington Wizards,3,0.2,0.639,47,22,12,3,0.25,0.8,46,13,7,3
2530,21600071,Miami Heat,Toronto Raptors,87,96,183,9,Toronto Raptors,9,0.321,0.667,43,19,10,5,0.24,0.889,50,14,7,5
2531,21600072,Charlotte Hornets,Brooklyn Nets,99,95,194,4,Charlotte Hornets,4,0.333,0.708,49,24,7,3,0.25,0.762,46,20,12,4
2532,21600073,New York Knicks,Chicago Bulls,117,104,221,13,New York Knicks,13,0.429,0.762,40,32,7,2,0.348,0.815,42,15,4,4
2533,21600074,Los Angeles Clippers,Memphis Grizzlies,99,88,187,11,Los Angeles Clippers,11,0.296,0.818,47,19,17,6,0.346,0.773,48,26,4,9
2534,21600075,Phoenix Suns,New Orleans Pelicans,112,111,223,1,Phoenix Suns,1,0.333,0.857,59,18,7,2,0.333,0.536,43,28,7,13
2535,21600076,Portland Trail Blazers,Dallas Mavericks,105,95,200,10,Portland Trail Blazers,10,0.387,0.808,42,21,9,3,0.357,0.85,44,18,5,3
2536,21600077,San Antonio Spurs,Utah Jazz,100,86,186,14,San Antonio Spurs,14,0.3,0.909,49,17,9,8,0.423,0.625,42,15,7,4
2537,21600078,Golden State Warriors,Los Angeles Lakers,97,117,214,20,Los Angeles Lakers,20,0.156,0.7,40,26,13,3,0.267,0.905,51,26,9,5
2538,21600079,Minnesota Timberwolves,Oklahoma City Thunder,92,112,204,20,Oklahoma City Thunder,20,0.211,0.759,41,12,7,8,0.438,0.625,41,24,9,9
2539,21600080,Cleveland Cavaliers,Philadelphia 76ers,102,101,203,1,Cleveland Cavaliers,1,0.368,0.778,49,23,10,5,0.368,0.583,45,21,9,9
2540,21600081,Washington Wizards,Orlando Magic,86,88,174,2,Orlando Magic,2,0.353,0.706,49,11,4,5,0.321,0.63,43,21,4,6
2541,21600082,Denver Nuggets,Detroit Pistons,86,103,189,17,Detroit Pistons,17,0.28,0.85,48,15,8,2,0.35,0.727,47,22,9,9
2542,21600083,Chicago Bulls,Indiana Pacers,94,111,205,17,Indiana Pacers,17,0.333,0.8,40,17,8,5,0.462,0.583,36,27,8,9
2543,21600084,Houston Rockets,Atlanta Hawks,97,112,209,15,Atlanta Hawks,15,0.333,0.846,43,22,9,7,0.4,0.583,44,29,17,6
2544,21600085,Sacramento Kings,Milwaukee Bucks,91,117,208,26,Milwaukee Bucks,26,0.357,0.789,36,27,8,3,0.424,0.84,53,28,12,10
2545,21600086,Los Angeles Clippers,San Antonio Spurs,116,92,208,24,Los Angeles Clippers,24,0.391,0.929,41,24,8,6,0.4,0.88,40,19,5,5
2546,21600087,Utah Jazz,New York Knicks,114,109,223,5,Utah Jazz,5,0.32,0.857,34,21,6,4,0.4,0.895,39,18,8,5
2547,21600088,Portland Trail Blazers,Memphis Grizzlies,100,94,194,6,Portland Trail Blazers,6,0.424,0.815,37,19,7,5,0.231,0.813,44,15,9,5
2548,21600089,Sacramento Kings,Toronto Raptors,96,91,187,5,Sacramento Kings,5,0.313,0.742,47,21,4,5,0.233,0.774,43,22,6,5
2549,21600090,Milwaukee Bucks,Dallas Mavericks,75,86,161,11,Dallas Mavericks,11,0.207,0.75,51,14,11,2,0.237,0.917,46,14,12,2
2550,21600091,Denver Nuggets,Boston Celtics,123,107,230,16,Denver Nuggets,16,0.478,0.774,47,21,7,6,0.32,0.81,39,31,3,4
2551,21600092,Phoenix Suns,Los Angeles Lakers,108,119,227,11,Los Angeles Lakers,11,0.3,0.786,40,20,8,2,0.435,0.771,53,22,8,5
2552,21600093,Utah Jazz,Philadelphia 76ers,109,84,193,25,Utah Jazz,25,0.579,0.6,45,20,10,11,0.333,0.682,42,16,5,2
2553,21600094,Houston Rockets,Washington Wizards,114,106,220,8,Houston Rockets,8,0.459,0.833,37,28,6,7,0.37,0.9,45,20,12,5
2554,21600095,Indiana Pacers,Charlotte Hornets,100,122,222,22,Charlotte Hornets,22,0.273,0.733,52,23,8,4,0.375,0.875,43,30,12,4
2555,21600096,Orlando Magic,Chicago Bulls,80,112,192,32,Chicago Bulls,32,0.3,0.833,39,28,6,6,0.158,0.806,56,26,7,4
2556,21600097,Miami Heat,Oklahoma City Thunder,85,97,182,12,Oklahoma City Thunder,12,0.235,0.864,41,12,8,7,0.321,0.824,47,24,8,5
2557,21600098,Detroit Pistons,Los Angeles Clippers,82,114,196,32,Los Angeles Clippers,32,0.333,0.692,39,14,5,2,0.52,0.864,46,28,8,7
2558,21600099,New Orleans Pelicans,Golden State Warriors,106,116,222,10,Golden State Warriors,10,0.333,0.778,43,26,8,1,0.457,0.833,38,35,14,4
2559,21600100,Atlanta Hawks,Cleveland Cavaliers,110,106,216,4,Atlanta Hawks,4,0.379,0.708,50,22,1,4,0.262,0.84,39,21,12,1
2560,21600101,Minnesota Timberwolves,Brooklyn Nets,110,119,229,9,Brooklyn Nets,9,0.429,0.714,41,20,11,3,0.364,0.885,43,20,5,5
2561,21600102,Denver Nuggets,Memphis Grizzlies,107,108,215,1,Memphis Grizzlies,1,0.417,0.794,39,24,6,4,0.292,0.684,32,29,14,5
2562,21600103,Phoenix Suns,Portland Trail Blazers,121,124,245,3,Portland Trail Blazers,3,0.333,0.848,41,18,10,2,0.452,0.714,35,22,5,4
2563,21600104,Dallas Mavericks,Los Angeles Lakers,109,97,206,12,Dallas Mavericks,12,0.435,0.867,37,24,11,4,0.385,0.786,37,20,6,1
2564,21600105,New Orleans Pelicans,Sacramento Kings,94,102,196,8,Sacramento Kings,8,0.238,0.722,40,23,5,9,0.32,0.8,39,24,7,5
2565,21600106,Brooklyn Nets,New York Knicks,96,110,206,14,New York Knicks,14,0.333,0.704,40,19,9,4,0.333,0.706,50,25,11,5
2566,21600107,Boston Celtics,Washington Wizards,93,118,211,25,Washington Wizards,25,0.323,0.591,31,21,5,4,0.476,0.8,54,29,9,7
2567,21600108,Utah Jazz,Charlotte Hornets,98,104,202,6,Charlotte Hornets,6,0.235,0.778,46,24,5,6,0.308,0.69,37,24,8,3
2568,21600109,Minnesota Timberwolves,Orlando Magic,123,107,230,16,Minnesota Timberwolves,16,0.565,0.769,45,27,8,5,0.333,0.767,39,20,2,5
2569,21600110,Philadelphia 76ers,Indiana Pacers,115,122,237,7,Indiana Pacers,7,0.389,0.474,43,23,11,6,0.474,0.75,43,25,9,6
2570,21600111,Chicago Bulls,Atlanta Hawks,107,115,222,8,Atlanta Hawks,8,0.333,0.762,31,24,14,3,0.45,0.815,48,24,8,7
2571,21600112,Toronto Raptors,Oklahoma City Thunder,112,102,214,10,Toronto Raptors,10,0.423,0.682,35,25,10,6,0.353,0.903,39,18,6,5
2572,21600113,Detroit Pistons,Phoenix Suns,100,107,207,7,Phoenix Suns,7,0.409,0.844,41,20,11,5,0.364,0.767,49,20,7,6
2573,21600114,Houston Rockets,San Antonio Spurs,101,99,200,2,Houston Rockets,2,0.333,0.773,45,25,7,4,0.304,0.867,39,22,14,5
2574,21600115,Portland Trail Blazers,Los Angeles Clippers,80,111,191,31,Los Angeles Clippers,31,0.2,0.857,47,16,4,3,0.344,0.727,55,24,9,7
2575,21600116,Dallas Mavericks,Golden State Warriors,95,116,211,21,Golden State Warriors,21,0.214,0.75,42,20,10,2,0.515,0.591,39,33,3,5
2576,21600117,New Orleans Pelicans,Milwaukee Bucks,112,106,218,6,New Orleans Pelicans,6,0.36,0.926,47,22,9,7,0.333,0.8,48,23,4,5
2577,21600118,Chicago Bulls,Miami Heat,98,95,193,3,Chicago Bulls,3,0.375,0.9,48,18,7,2,0.448,0.667,46,22,8,5
2578,21600119,Golden State Warriors,Denver Nuggets,125,101,226,24,Golden State Warriors,24,0.467,0.95,44,33,15,6,0.361,0.706,44,26,7,3
2579,21600120,Los Angeles Lakers,Sacramento Kings,101,91,192,10,Los Angeles Lakers,10,0.333,0.727,42,18,8,2,0.381,0.75,43,18,13,3
2580,21600121,Indiana Pacers,Philadelphia 76ers,105,109,214,4,Philadelphia 76ers,4,0.263,0.957,40,23,14,3,0.344,0.839,54,24,7,6
2581,21600122,Cleveland Cavaliers,Washington Wizards,105,94,199,11,Cleveland Cavaliers,11,0.424,0.731,47,16,9,6,0.2,0.789,46,16,7,5
2582,21600123,Toronto Raptors,Charlotte Hornets,113,111,224,2,Toronto Raptors,2,0.273,0.955,45,18,8,5,0.415,0.75,57,22,1,4
2583,21600124,Utah Jazz,Orlando Magic,87,74,161,13,Utah Jazz,13,0.25,0.875,52,19,9,7,0.4,0.737,43,13,11,6
2584,21600125,New York Knicks,Boston Celtics,87,115,202,28,Boston Celtics,28,0.261,0.882,57,19,7,11,0.407,0.791,53,23,16,3
2585,21600126,Los Angeles Clippers,Oklahoma City Thunder,110,108,218,2,Los Angeles Clippers,2,0.407,0.6,45,18,9,3,0.571,0.842,45,21,3,1
2586,21600127,Detroit Pistons,San Antonio Spurs,86,96,182,10,San Antonio Spurs,10,0.2,0.81,42,14,2,4,0.45,0.789,45,24,8,2
2587,21600128,Sacramento Kings,Portland Trail Blazers,120,122,242,2,Portland Trail Blazers,2,0.286,0.8,48,18,7,3,0.394,0.704,36,29,8,4
2588,21600129,Los Angeles Lakers,New Orleans Pelicans,126,99,225,27,Los Angeles Lakers,27,0.533,0.857,47,36,8,5,0.3,0.789,42,20,4,5
2589,21600130,Boston Celtics,Indiana Pacers,105,99,204,6,Boston Celtics,6,0.32,0.818,47,22,7,7,0.222,0.75,40,17,9,9
2590,21600131,New York Knicks,Toronto Raptors,107,118,225,11,Toronto Raptors,11,0.304,0.75,49,19,3,2,0.318,0.868,44,18,10,6
2591,21600132,Philadelphia 76ers,Atlanta Hawks,96,117,213,21,Atlanta Hawks,21,0.379,0.65,39,21,14,4,0.406,0.571,52,31,10,6
2592,21600133,Washington Wizards,Chicago Bulls,95,106,201,11,Chicago Bulls,11,0.308,0.833,49,19,3,7,0.333,0.92,52,21,7,6
2593,21600134,San Antonio Spurs,Houston Rockets,106,100,206,6,San Antonio Spurs,6,0.278,0.792,35,21,6,11,0.319,0.81,46,22,6,4
2594,21600135,Los Angeles Clippers,Minnesota Timberwolves,119,105,224,14,Los Angeles Clippers,14,0.458,0.757,42,25,7,4,0.364,0.81,39,26,11,3
2595,21600136,Utah Jazz,Miami Heat,102,91,193,11,Utah Jazz,11,0.3,0.842,45,12,5,4,0.294,0.526,39,21,5,4
2596,21600137,Memphis Grizzlies,Milwaukee Bucks,96,106,202,10,Milwaukee Bucks,10,0.2,0.952,32,20,8,4,0.389,0.75,35,20,9,5
2597,21600138,Detroit Pistons,Denver Nuggets,106,95,201,11,Detroit Pistons,11,0.222,0.714,37,23,11,1,0.36,0.737,42,15,6,4
2598,21600139,Brooklyn Nets,Phoenix Suns,122,104,226,18,Brooklyn Nets,18,0.432,0.867,55,22,6,10,0.242,0.762,55,23,9,3
2599,21600140,Charlotte Hornets,Cleveland Cavaliers,93,100,193,7,Cleveland Cavaliers,7,0.379,0.833,45,23,7,3,0.368,0.533,53,25,3,8
2600,21600141,Orlando Magic,Oklahoma City Thunder,119,117,236,2,Orlando Magic,2,0.458,0.8,38,24,4,7,0.28,0.615,42,22,4,6
2601,21600142,Los Angeles Lakers,Minnesota Timberwolves,99,125,224,26,Minnesota Timberwolves,26,0.333,0.833,39,16,6,5,0.481,0.667,44,28,10,4
2602,21600143,Phoenix Suns,Golden State Warriors,120,133,253,13,Golden State Warriors,13,0.333,0.769,38,27,10,3,0.485,0.871,43,32,8,7
2603,21600144,Denver Nuggets,Portland Trail Blazers,105,112,217,7,Portland Trail Blazers,7,0.379,0.759,59,11,4,6,0.276,0.813,44,21,8,8
2604,21600145,Orlando Magic,Indiana Pacers,69,88,157,19,Indiana Pacers,19,0.2,0.769,52,12,3,5,0.32,1,49,22,9,9
2605,21600146,Dallas Mavericks,New York Knicks,77,93,170,16,New York Knicks,16,0.185,0.727,40,15,8,7,0.36,0.889,51,18,5,5
2606,21600147,Oklahoma City Thunder,Detroit Pistons,88,104,192,16,Detroit Pistons,16,0.185,0.773,51,16,3,6,0.313,0.813,47,25,4,9
2607,21600148,Boston Celtics,New Orleans Pelicans,105,106,211,1,New Orleans Pelicans,1,0.293,0.85,44,19,9,0,0.286,0.833,46,16,9,4
2608,21600149,Philadelphia 76ers,Houston Rockets,88,115,203,27,Houston Rockets,27,0.227,0.882,39,18,10,7,0.425,0.588,55,20,6,10
2609,21600150,Miami Heat,San Antonio Spurs,90,94,184,4,San Antonio Spurs,4,0.267,0.571,41,22,14,8,0.533,0.741,52,24,4,7
2610,21600151,Memphis Grizzlies,Utah Jazz,102,96,198,6,Memphis Grizzlies,6,0.381,0.846,44,13,4,2,0.286,0.818,29,17,8,1
2611,21600152,Brooklyn Nets,Los Angeles Clippers,95,127,222,32,Los Angeles Clippers,32,0.303,0.773,37,18,6,2,0.56,0.81,43,32,17,6
2612,21600153,Toronto Raptors,Cleveland Cavaliers,117,121,238,4,Cleveland Cavaliers,4,0.448,0.667,40,24,11,5,0.394,0.714,46,26,4,7
2613,21600154,Atlanta Hawks,Miami Heat,93,90,183,3,Atlanta Hawks,3,0.353,0.684,35,18,14,4,0.304,0.786,48,13,11,7
2614,21600155,Charlotte Hornets,Minnesota Timberwolves,115,108,223,7,Charlotte Hornets,7,0.458,0.818,37,25,10,6,0.429,0.81,43,25,4,5
2615,21600156,Chicago Bulls,Portland Trail Blazers,113,88,201,25,Chicago Bulls,25,0.35,0.857,67,16,7,4,0.265,0.611,49,17,8,4
2616,21600157,Brooklyn Nets,Los Angeles Lakers,118,125,243,7,Los Angeles Lakers,7,0.293,0.8,47,23,8,6,0.321,0.791,55,24,9,2
2617,21600158,Washington Wizards,Philadelphia 76ers,102,109,211,7,Philadelphia 76ers,7,0.348,0.72,40,18,8,1,0.357,0.682,41,30,6,1
2618,21600159,New Orleans Pelicans,Orlando Magic,82,89,171,7,Orlando Magic,7,0.333,0.789,48,19,5,9,0.37,0.579,50,17,7,7
2619,21600160,Cleveland Cavaliers,Indiana Pacers,93,103,196,10,Indiana Pacers,10,0.367,0.6,51,19,3,5,0.357,0.636,40,22,8,12
2620,21600161,Dallas Mavericks,Boston Celtics,83,90,173,7,Boston Celtics,7,0.348,0.7,32,16,9,3,0.333,0.739,53,18,6,3
2621,21600162,Detroit Pistons,New York Knicks,102,105,207,3,New York Knicks,3,0.348,0.833,40,19,6,1,0.36,0.632,52,24,8,9
2622,21600163,Milwaukee Bucks,Atlanta Hawks,100,107,207,7,Atlanta Hawks,7,0.25,0.778,47,25,9,2,0.313,0.871,39,29,6,8
2623,21600164,Houston Rockets,Oklahoma City Thunder,103,105,208,2,Oklahoma City Thunder,2,0.35,0.643,47,25,10,4,0.48,0.929,44,25,7,7
2624,21600165,Golden State Warriors,Toronto Raptors,127,121,248,6,Golden State Warriors,6,0.361,0.929,35,33,9,7,0.4,0.902,46,16,8,1
2625,21600166,Phoenix Suns,Denver Nuggets,104,120,224,16,Denver Nuggets,16,0.4,0.621,35,14,8,4,0.471,0.917,49,23,8,4
2626,21600167,Memphis Grizzlies,Los Angeles Clippers,111,107,218,4,Memphis Grizzlies,4,0.577,0.842,43,24,6,2,0.36,0.706,35,15,13,7
2627,21600168,San Antonio Spurs,Sacramento Kings,110,105,215,5,San Antonio Spurs,5,0.367,0.765,37,29,11,7,0.45,0.774,46,21,5,3
2628,21600169,New York Knicks,Washington Wizards,112,119,231,7,Washington Wizards,7,0.414,0.9,36,23,9,1,0.6,0.889,37,26,7,2
2629,21600170,Milwaukee Bucks,Miami Heat,73,96,169,23,Miami Heat,23,0.304,0.769,48,20,4,8,0.233,0.524,59,19,5,8
2630,21600171,Portland Trail Blazers,Houston Rockets,109,126,235,17,Houston Rockets,17,0.357,0.81,41,24,6,4,0.438,0.8,54,26,6,6
2631,21600172,Philadelphia 76ers,Minnesota Timberwolves,86,110,196,24,Minnesota Timberwolves,24,0.281,0.789,40,15,9,2,0.24,0.9,48,18,7,8
2632,21600173,Chicago Bulls,Utah Jazz,85,77,162,8,Chicago Bulls,8,0.294,0.875,46,8,7,6,0.2,0.857,48,11,4,3
2633,21600174,Atlanta Hawks,Charlotte Hornets,96,100,196,4,Charlotte Hornets,4,0.25,0.647,49,25,9,6,0.345,0.667,44,25,11,4
2634,21600175,Detroit Pistons,Cleveland Cavaliers,81,104,185,23,Cleveland Cavaliers,23,0.316,0.85,44,23,5,4,0.44,0.929,52,26,4,8
2635,21600176,Phoenix Suns,Indiana Pacers,116,96,212,20,Phoenix Suns,20,0.346,0.833,46,21,14,7,0.143,0.793,35,18,5,8
2636,21600177,Portland Trail Blazers,New Orleans Pelicans,101,113,214,12,New Orleans Pelicans,12,0.353,0.885,48,19,2,1,0.375,0.7,37,31,9,12
2637,21600178,Brooklyn Nets,Oklahoma City Thunder,105,124,229,19,Oklahoma City Thunder,19,0.379,0.8,30,19,6,2,0.269,0.792,46,23,9,5
2638,21600179,Golden State Warriors,Boston Celtics,104,88,192,16,Golden State Warriors,16,0.321,0.583,50,33,10,7,0.344,0.789,43,19,6,3
2639,21600180,Memphis Grizzlies,Dallas Mavericks,80,64,144,16,Memphis Grizzlies,16,0.36,0.75,48,16,7,3,0.2,0.773,45,9,3,7
2640,21600181,Toronto Raptors,Denver Nuggets,113,111,224,2,Toronto Raptors,2,0.348,0.613,44,23,8,2,0.16,0.744,59,29,7,4
2641,21600182,San Antonio Spurs,Los Angeles Lakers,116,107,223,9,San Antonio Spurs,9,0.417,0.947,34,30,8,6,0.48,0.81,45,24,6,1
2642,21600183,Los Angeles Clippers,Sacramento Kings,121,115,236,6,Los Angeles Clippers,6,0.448,0.824,37,27,7,6,0.385,0.829,37,21,7,4
2643,21600184,Utah Jazz,Houston Rockets,102,111,213,9,Houston Rockets,9,0.444,0.706,43,22,3,5,0.375,0.75,39,28,8,3
2644,21600185,Charlotte Hornets,New Orleans Pelicans,116,121,237,5,New Orleans Pelicans,5,0.349,0.75,52,29,7,5,0.389,0.84,53,27,9,6
2645,21600186,Miami Heat,Washington Wizards,114,111,225,3,Miami Heat,3,0.481,0.577,47,21,6,7,0.407,0.727,40,22,9,2
2646,21600187,Dallas Mavericks,Orlando Magic,87,95,182,8,Orlando Magic,8,0.464,0.815,34,13,8,5,0.381,0.864,50,17,6,8
2647,21600188,Boston Celtics,Detroit Pistons,94,92,186,2,Boston Celtics,2,0.387,0.941,46,22,3,7,0.35,0.688,50,22,5,4
2648,21600189,Phoenix Suns,Philadelphia 76ers,105,120,225,15,Philadelphia 76ers,15,0.286,0.618,44,18,11,7,0.486,0.65,44,33,11,9
2649,21600190,Minnesota Timberwolves,Memphis Grizzlies,71,93,164,22,Memphis Grizzlies,22,0.318,0.636,34,16,5,5,0.111,0.868,46,15,8,7
2650,21600191,Golden State Warriors,Milwaukee Bucks,124,121,245,3,Golden State Warriors,3,0.368,0.813,45,30,8,5,0.5,0.76,41,27,7,1
2651,21600192,Chicago Bulls,Los Angeles Clippers,95,102,197,7,Los Angeles Clippers,7,0.3,0.833,41,17,7,4,0.407,0.826,38,20,6,2
2652,21600193,Atlanta Hawks,New York Knicks,94,104,198,10,New York Knicks,10,0.286,0.69,48,17,7,6,0.37,0.714,50,21,8,1
2653,21600194,Portland Trail Blazers,Brooklyn Nets,129,109,238,20,Portland Trail Blazers,20,0.417,0.762,50,23,4,7,0.286,0.806,36,22,5,3
2654,21600195,Indiana Pacers,Oklahoma City Thunder,115,111,226,4,Indiana Pacers,4,0.5,0.774,51,23,13,2,0.278,0.722,49,28,10,7
2655,21600196,Toronto Raptors,Sacramento Kings,99,102,201,3,Sacramento Kings,3,0.375,0.917,48,16,7,6,0.407,0.76,37,26,8,8
2656,21600197,Utah Jazz,Denver Nuggets,91,105,196,14,Denver Nuggets,14,0.259,0.783,49,15,3,6,0.364,0.433,49,31,4,3
2657,21600198,Chicago Bulls,Los Angeles Lakers,118,110,228,8,Chicago Bulls,8,0.364,0.714,56,27,6,3,0.419,0.714,37,26,11,3
2658,21600199,Miami Heat,Philadelphia 76ers,94,101,195,7,Philadelphia 76ers,7,0.226,0.679,50,17,7,6,0.423,0.8,40,21,8,5
2659,21600200,Phoenix Suns,Washington Wizards,101,106,207,5,Washington Wizards,5,0.407,0.8,52,22,3,7,0.357,0.647,45,25,8,4
2660,21600201,Memphis Grizzlies,Charlotte Hornets,105,90,195,15,Memphis Grizzlies,15,0.462,0.765,40,24,7,8,0.29,0.636,39,20,6,9
2661,21600202,Golden State Warriors,Indiana Pacers,120,83,203,37,Golden State Warriors,37,0.361,0.844,60,31,9,10,0.261,0.917,49,13,5,4
2662,21600203,Houston Rockets,Detroit Pistons,99,96,195,3,Houston Rockets,3,0.323,0.704,46,22,4,6,0.412,0.708,39,19,7,3
2663,21600204,Orlando Magic,Milwaukee Bucks,89,93,182,4,Milwaukee Bucks,4,0.28,0.75,54,21,8,5,0.276,0.714,37,25,16,9
2664,21600205,Boston Celtics,Minnesota Timberwolves,99,93,192,6,Boston Celtics,6,0.316,0.786,39,20,5,4,0.167,0.68,51,23,5,4
2665,21600206,Dallas Mavericks,San Antonio Spurs,91,96,187,5,San Antonio Spurs,5,0.296,0.65,40,16,10,3,0.4,0.72,39,24,9,1
2666,21600207,Toronto Raptors,Los Angeles Clippers,115,123,238,8,Los Angeles Clippers,8,0.421,0.844,32,19,10,2,0.4,0.833,42,23,5,4
2667,21600208,Portland Trail Blazers,New York Knicks,103,107,210,4,New York Knicks,4,0.273,0.808,44,18,5,5,0.31,1,43,26,8,5
2668,21600209,New Orleans Pelicans,Atlanta Hawks,112,94,206,18,New Orleans Pelicans,18,0.44,0.917,40,29,11,9,0.345,0.6,40,22,5,6
2669,21600210,Chicago Bulls,Denver Nuggets,107,110,217,3,Denver Nuggets,3,0.333,0.833,48,22,6,11,0.455,0.824,55,26,5,6
2670,21600211,Oklahoma City Thunder,Los Angeles Lakers,109,111,220,2,Los Angeles Lakers,2,0.407,0.727,40,29,11,6,0.519,0.813,35,25,8,7
2671,21600212,Memphis Grizzlies,Philadelphia 76ers,104,99,203,5,Memphis Grizzlies,5,0.345,0.75,46,24,13,9,0.333,0.739,56,24,9,10
2672,21600213,San Antonio Spurs,Charlotte Hornets,119,114,233,5,San Antonio Spurs,5,0.419,0.9,34,28,9,8,0.55,0.722,44,30,3,3
2673,21600214,Phoenix Suns,Orlando Magic,92,87,179,5,Phoenix Suns,5,0.409,0.773,44,15,6,7,0.28,0.609,44,17,9,8
2674,21600215,Portland Trail Blazers,Cleveland Cavaliers,125,137,262,12,Cleveland Cavaliers,12,0.448,0.947,38,27,6,6,0.583,0.741,41,30,6,3
2675,21600216,Atlanta Hawks,Indiana Pacers,96,85,181,11,Atlanta Hawks,11,0.25,0.864,56,17,11,7,0.259,0.714,37,16,15,5
2676,21600217,Boston Celtics,Brooklyn Nets,111,92,203,19,Boston Celtics,19,0.395,0.75,51,26,13,6,0.323,0.636,45,18,7,7
2677,21600218,Miami Heat,Detroit Pistons,84,107,191,23,Detroit Pistons,23,0.269,0.767,37,19,5,4,0.316,0.84,49,22,8,7
2678,21600219,Toronto Raptors,Houston Rockets,115,102,217,13,Toronto Raptors,13,0.522,0.81,38,28,14,7,0.333,1,39,29,6,7
2679,21600220,Los Angeles Clippers,Dallas Mavericks,124,104,228,20,Los Angeles Clippers,20,0.469,0.742,43,26,11,4,0.458,0.944,44,23,7,3
2680,21600221,Denver Nuggets,Utah Jazz,83,108,191,25,Utah Jazz,25,0.333,0.581,49,14,5,5,0.308,0.71,51,19,4,3
2681,21600222,Minnesota Timberwolves,New Orleans Pelicans,96,117,213,21,New Orleans Pelicans,21,0.176,0.818,41,23,12,3,0.375,0.783,45,27,10,6
2682,21600223,Los Angeles Lakers,Golden State Warriors,106,149,255,43,Golden State Warriors,43,0.4,0.818,37,22,5,1,0.528,0.686,48,47,7,5
2683,21600224,Oklahoma City Thunder,Sacramento Kings,101,116,217,15,Sacramento Kings,15,0.28,0.789,38,18,7,7,0.429,0.941,46,26,4,1
2684,21600225,San Antonio Spurs,Boston Celtics,109,103,212,6,San Antonio Spurs,6,0.458,0.88,45,24,4,8,0.353,0.778,36,32,8,4
2685,21600226,Washington Wizards,Orlando Magic,94,91,185,3,Washington Wizards,3,0.207,0.8,37,26,10,4,0.304,0.7,49,18,5,7
2686,21600227,Dallas Mavericks,Cleveland Cavaliers,90,128,218,38,Cleveland Cavaliers,38,0.229,0.667,39,29,5,4,0.465,0.917,47,30,9,3
2687,21600228,Charlotte Hornets,New York Knicks,111,113,224,2,New York Knicks,2,0.276,0.63,46,25,6,4,0.393,0.923,55,26,9,8
2688,21600229,Chicago Bulls,Philadelphia 76ers,105,89,194,16,Chicago Bulls,16,0.286,0.731,51,24,10,5,0.409,0.818,48,18,7,8
2689,21600230,Los Angeles Clippers,Detroit Pistons,97,108,205,11,Detroit Pistons,11,0.333,0.769,33,26,4,5,0.474,0.714,42,26,7,0
2690,21600231,Atlanta Hawks,Utah Jazz,68,95,163,27,Utah Jazz,27,0.32,0.667,40,11,8,4,0.294,0.833,55,17,9,9
2691,21600232,Toronto Raptors,Milwaukee Bucks,105,99,204,6,Toronto Raptors,6,0.438,0.789,38,18,3,5,0.414,0.583,38,26,4,2
2692,21600233,Miami Heat,Memphis Grizzlies,90,81,171,9,Miami Heat,9,0.387,0.667,44,17,8,8,0.211,0.826,51,14,3,14
2693,21600234,Brooklyn Nets,Indiana Pacers,97,118,215,21,Indiana Pacers,21,0.324,0.609,38,24,8,4,0.423,0.688,47,25,11,5
2694,21600235,Oklahoma City Thunder,Denver Nuggets,132,129,261,3,Oklahoma City Thunder,3,0.5,0.793,40,29,11,4,0.353,0.778,52,34,9,7
2695,21600236,Minnesota Timberwolves,Phoenix Suns,98,85,183,13,Minnesota Timberwolves,13,0.318,0.92,39,16,15,8,0.231,0.714,48,17,11,6
2696,21600237,New Orleans Pelicans,Portland Trail Blazers,104,119,223,15,Portland Trail Blazers,15,0.565,0.655,34,20,3,8,0.375,0.765,52,30,7,5
2697,21600238,Golden State Warriors,Los Angeles Lakers,109,85,194,24,Golden State Warriors,24,0.393,0.706,44,31,10,10,0.227,0.696,45,20,12,3
2698,21600239,Houston Rockets,Sacramento Kings,117,104,221,13,Houston Rockets,13,0.42,0.8,42,27,8,2,0.281,0.81,37,24,7,6
2699,21600240,San Antonio Spurs,Washington Wizards,112,100,212,12,San Antonio Spurs,12,0.375,0.793,38,22,7,6,0.273,0.714,40,21,11,1
2700,21600241,New York Knicks,Charlotte Hornets,102,107,209,5,Charlotte Hornets,5,0.375,0.8,47,26,9,6,0.364,0.69,52,16,3,9
2701,21600242,Detroit Pistons,Oklahoma City Thunder,88,106,194,18,Oklahoma City Thunder,18,0.053,0.765,32,11,7,1,0.348,0.538,43,23,4,3
2702,21600243,Memphis Grizzlies,Miami Heat,110,107,217,3,Memphis Grizzlies,3,0.36,0.818,34,23,5,5,0.355,0.667,39,18,3,6
2703,21600244,Minnesota Timberwolves,Golden State Warriors,102,115,217,13,Golden State Warriors,13,0.286,0.833,32,22,8,3,0.5,0.824,45,25,9,8
2704,21600245,Cleveland Cavaliers,Philadelphia 76ers,112,108,220,4,Cleveland Cavaliers,4,0.3,0.857,46,19,5,3,0.441,0.7,50,29,5,5
2705,21600246,Denver Nuggets,Phoenix Suns,120,114,234,6,Denver Nuggets,6,0.448,0.906,49,21,5,1,0.44,0.861,46,11,5,7
2706,21600247,Sacramento Kings,Brooklyn Nets,122,105,227,17,Sacramento Kings,17,0.565,0.773,45,24,11,3,0.4,0.929,42,19,7,1
2707,21600248,Milwaukee Bucks,Orlando Magic,104,96,200,8,Milwaukee Bucks,8,0.333,0.7,53,24,6,6,0.25,0.765,46,24,6,5
2708,21600249,Los Angeles Clippers,Indiana Pacers,70,91,161,21,Indiana Pacers,21,0.167,0.815,40,11,9,4,0.263,0.857,52,26,8,4
2709,21600250,New Orleans Pelicans,Dallas Mavericks,81,91,172,10,Dallas Mavericks,10,0.25,0.889,42,17,8,3,0.37,0.85,46,19,7,3
2710,21600251,Houston Rockets,Portland Trail Blazers,130,114,244,16,Houston Rockets,16,0.472,0.75,36,26,7,8,0.364,0.759,35,24,7,2
2711,21600252,Atlanta Hawks,Los Angeles Lakers,94,109,203,15,Los Angeles Lakers,15,0.343,0.4,38,25,5,6,0.4,0.85,53,20,7,2
2712,21600253,Sacramento Kings,Washington Wizards,95,101,196,6,Washington Wizards,6,0.143,0.615,44,20,15,4,0.4,0.808,49,22,11,7
2713,21600254,Philadelphia 76ers,Toronto Raptors,95,122,217,27,Toronto Raptors,27,0.412,0.692,38,27,9,4,0.684,0.806,42,22,11,8
2714,21600255,Oklahoma City Thunder,New York Knicks,112,103,215,9,Oklahoma City Thunder,9,0.364,0.667,53,25,4,7,0.316,0.893,40,20,9,11
2715,21600256,Boston Celtics,Miami Heat,112,104,216,8,Boston Celtics,8,0.407,0.808,40,26,4,3,0.2,0.688,41,24,6,2
2716,21600257,Charlotte Hornets,Memphis Grizzlies,104,85,189,19,Charlotte Hornets,19,0.346,0.742,47,24,3,4,0.241,0.462,42,21,10,4
2717,21600258,Utah Jazz,Minnesota Timberwolves,112,103,215,9,Utah Jazz,9,0.222,0.824,42,19,9,3,0.368,0.96,39,26,8,2
2718,21600259,Atlanta Hawks,Golden State Warriors,100,105,205,5,Golden State Warriors,5,0.241,0.7,50,20,11,4,0.343,0.792,41,25,6,10
2719,21600260,Detroit Pistons,Charlotte Hornets,112,89,201,23,Detroit Pistons,23,0.429,0.909,44,21,7,4,0.333,0.857,40,21,7,5
2720,21600261,Los Angeles Clippers,Brooklyn Nets,122,127,249,5,Brooklyn Nets,5,0.325,0.773,56,21,10,3,0.342,0.667,54,22,9,3
2721,21600262,Cleveland Cavaliers,Milwaukee Bucks,101,118,219,17,Milwaukee Bucks,17,0.359,0.742,35,17,7,6,0.368,0.826,43,27,15,6
2722,21600263,Los Angeles Lakers,New Orleans Pelicans,88,105,193,17,New Orleans Pelicans,17,0.167,0.5,47,26,8,5,0.258,0.84,54,24,10,3
2723,21600264,Orlando Magic,San Antonio Spurs,95,83,178,12,Orlando Magic,12,0.4,0.917,40,25,12,4,0.25,0.846,45,19,9,4
2724,21600265,Houston Rockets,Utah Jazz,101,120,221,19,Utah Jazz,19,0.367,0.727,38,14,5,6,0.536,0.852,40,23,4,5
2725,21600266,Sacramento Kings,Philadelphia 76ers,119,122,241,3,Philadelphia 76ers,3,0.448,0.828,33,31,7,3,0.355,0.808,29,32,13,2
2726,21600267,Detroit Pistons,Boston Celtics,121,114,235,7,Detroit Pistons,7,0.45,0.762,52,28,4,8,0.357,0.95,33,26,6,3
2727,21600268,Memphis Grizzlies,Toronto Raptors,105,120,225,15,Toronto Raptors,15,0.407,0.846,30,16,13,1,0.5,0.848,43,23,7,4
2728,21600269,Los Angeles Lakers,Chicago Bulls,96,90,186,6,Los Angeles Lakers,6,0.25,0.683,60,17,12,3,0.19,0.759,46,22,15,11
2729,21600270,Washington Wizards,Oklahoma City Thunder,115,126,241,11,Oklahoma City Thunder,11,0.357,0.654,48,25,8,3,0.4,0.71,47,28,10,4
2730,21600271,New York Knicks,Minnesota Timberwolves,106,104,210,2,New York Knicks,2,0.406,0.733,39,24,8,3,0.211,0.821,40,17,9,5
2731,21600272,San Antonio Spurs,Dallas Mavericks,94,87,181,7,San Antonio Spurs,7,0.579,0.708,42,16,7,6,0.333,0.786,37,16,5,3
2732,21600273,Miami Heat,Denver Nuggets,106,98,204,8,Miami Heat,8,0.375,0.577,48,26,14,7,0.318,0.625,55,28,3,7
2733,21600274,Atlanta Hawks,Phoenix Suns,107,109,216,2,Phoenix Suns,2,0.36,0.8,40,20,9,6,0.476,0.76,41,15,11,4
2734,21600275,Indiana Pacers,Portland Trail Blazers,109,131,240,22,Portland Trail Blazers,22,0.429,0.886,32,19,3,4,0.375,0.895,40,29,13,2
2735,21600276,Dallas Mavericks,Charlotte Hornets,87,97,184,10,Charlotte Hornets,10,0.29,0.778,41,18,6,2,0.278,0.71,39,24,5,6
2736,21600277,Milwaukee Bucks,Brooklyn Nets,111,93,204,18,Milwaukee Bucks,18,0.441,0.828,48,23,8,10,0.3,0.813,40,20,9,9
2737,21600278,Orlando Magic,Memphis Grizzlies,94,95,189,1,Memphis Grizzlies,1,0.25,0.71,42,15,5,9,0.389,0.786,39,18,9,9
2738,21600279,Los Angeles Clippers,Cleveland Cavaliers,113,94,207,19,Los Angeles Clippers,19,0.419,0.667,47,33,7,3,0.375,0.744,36,12,5,3
2739,21600280,Miami Heat,Utah Jazz,111,110,221,1,Miami Heat,1,0.421,0.789,40,16,7,2,0.567,0.765,31,24,5,8
2740,21600281,Houston Rockets,Golden State Warriors,132,127,259,5,Houston Rockets,5,0.318,0.733,56,26,11,4,0.273,0.784,54,31,12,7
2741,21600282,Orlando Magic,Philadelphia 76ers,105,88,193,17,Orlando Magic,17,0.5,0.692,47,24,8,3,0.281,0.7,46,24,3,6
2742,21600283,Sacramento Kings,Boston Celtics,92,97,189,5,Boston Celtics,5,0.231,0.8,51,22,9,10,0.393,0.933,45,25,10,9
2743,21600284,Los Angeles Lakers,Toronto Raptors,80,113,193,33,Toronto Raptors,33,0.231,0.588,46,16,6,2,0.414,0.846,44,25,8,5
2744,21600285,Minnesota Timberwolves,New York Knicks,114,118,232,4,New York Knicks,4,0.357,0.917,43,25,6,6,0.387,0.8,43,26,9,6
2745,21600286,Cleveland Cavaliers,Chicago Bulls,105,111,216,6,Chicago Bulls,6,0.385,0.5,33,30,5,1,0.167,0.824,49,31,11,4
2746,21600287,Los Angeles Clippers,New Orleans Pelicans,114,96,210,18,Los Angeles Clippers,18,0.417,0.875,47,27,6,7,0.25,0.619,40,21,5,4
2747,21600288,Detroit Pistons,Atlanta Hawks,121,85,206,36,Detroit Pistons,36,0.586,0.667,54,28,4,3,0.25,0.75,32,22,6,2
2748,21600289,Washington Wizards,San Antonio Spurs,105,107,212,2,San Antonio Spurs,2,0.636,0.889,43,25,13,3,0.4,0.636,37,27,11,4
2749,21600290,Houston Rockets,Denver Nuggets,128,110,238,18,Houston Rockets,18,0.459,0.84,41,25,11,7,0.29,0.563,54,22,5,4
2750,21600291,Brooklyn Nets,Milwaukee Bucks,103,112,215,9,Milwaukee Bucks,9,0.268,0.727,46,21,6,5,0.25,0.722,46,25,9,10
2751,21600292,Minnesota Timberwolves,Charlotte Hornets,125,120,245,5,Minnesota Timberwolves,5,0.37,0.864,51,32,10,10,0.389,0.692,50,30,6,8
2752,21600293,Atlanta Hawks,Toronto Raptors,84,128,212,44,Toronto Raptors,44,0.25,0.5,38,21,7,5,0.542,0.818,48,28,14,7
2753,21600294,Boston Celtics,Philadelphia 76ers,107,106,213,1,Boston Celtics,1,0.308,0.793,37,22,5,3,0.455,0.808,38,20,5,3
2754,21600295,Los Angeles Lakers,Memphis Grizzlies,100,103,203,3,Memphis Grizzlies,3,0.333,0.793,44,16,7,4,0.333,0.733,43,32,13,7
2755,21600296,Chicago Bulls,Dallas Mavericks,82,107,189,25,Dallas Mavericks,25,0.231,0.714,43,9,4,5,0.419,0.778,42,31,11,2
2756,21600297,Denver Nuggets,Utah Jazz,98,105,203,7,Utah Jazz,7,0.542,0.786,37,19,7,5,0.36,0.929,40,20,8,3
2757,21600298,Miami Heat,Portland Trail Blazers,92,99,191,7,Portland Trail Blazers,7,0.273,0.667,46,23,6,6,0.375,0.75,47,19,6,9
2758,21600299,Phoenix Suns,Golden State Warriors,109,138,247,29,Golden State Warriors,29,0.344,0.762,36,24,8,2,0.667,0.765,38,37,9,5
2759,21600300,Orlando Magic,Detroit Pistons,98,92,190,6,Orlando Magic,6,0.304,0.5,39,23,8,7,0.37,0.462,44,16,8,3
2760,21600301,New Orleans Pelicans,Oklahoma City Thunder,92,101,193,9,Oklahoma City Thunder,9,0.214,0.737,51,15,8,6,0.214,0.5,59,24,7,5
2761,21600302,Sacramento Kings,New York Knicks,98,106,204,8,New York Knicks,8,0.321,0.871,51,18,13,5,0.379,0.708,58,20,5,10
2762,21600303,Indiana Pacers,Los Angeles Clippers,111,102,213,9,Indiana Pacers,9,0.357,0.8,36,21,9,2,0.333,0.714,51,19,5,7
2763,21600304,Denver Nuggets,Philadelphia 76ers,106,98,204,8,Denver Nuggets,8,0.37,0.765,45,17,13,8,0.355,0.739,44,20,12,10
2764,21600305,Cleveland Cavaliers,Toronto Raptors,116,112,228,4,Cleveland Cavaliers,4,0.438,0.815,48,21,4,3,0.406,0.852,33,22,8,5
2765,21600306,Washington Wizards,Brooklyn Nets,118,113,231,5,Washington Wizards,5,0.412,0.778,35,26,17,5,0.407,0.733,50,25,5,3
2766,21600307,Oklahoma City Thunder,Atlanta Hawks,102,99,201,3,Oklahoma City Thunder,3,0.323,0.643,43,26,9,5,0.318,0.75,36,26,13,3
2767,21600308,Portland Trail Blazers,Chicago Bulls,112,110,222,2,Portland Trail Blazers,2,0.375,0.722,38,25,9,8,0.304,0.868,50,16,8,11
2768,21600309,San Antonio Spurs,Milwaukee Bucks,97,96,193,1,San Antonio Spurs,1,0.286,0.643,46,26,6,5,0.25,0.882,43,16,4,7
2769,21600310,Memphis Grizzlies,New Orleans Pelicans,110,108,218,2,Memphis Grizzlies,2,0.382,0.619,61,23,8,4,0.313,0.952,54,21,7,7
2770,21600311,Boston Celtics,Houston Rockets,106,107,213,1,Houston Rockets,1,0.344,0.917,42,27,7,4,0.316,0.871,46,20,8,7
2771,21600312,Charlotte Hornets,Dallas Mavericks,109,101,210,8,Charlotte Hornets,8,0.167,0.929,53,21,2,5,0.361,0.778,35,23,4,2
2772,21600313,Utah Jazz,Los Angeles Lakers,107,101,208,6,Utah Jazz,6,0.406,0.621,39,26,5,7,0.357,0.783,43,15,8,1
2773,21600314,Indiana Pacers,Golden State Warriors,106,142,248,36,Golden State Warriors,36,0.2,0.943,40,20,10,5,0.378,0.769,54,45,12,13
2774,21600315,Orlando Magic,Washington Wizards,124,116,240,8,Orlando Magic,8,0.462,0.722,43,24,7,12,0.478,0.708,42,20,5,2
2775,21600316,New York Knicks,Miami Heat,114,103,217,11,New York Knicks,11,0.28,0.688,53,22,6,6,0.44,0.593,46,21,8,4
2776,21600317,Chicago Bulls,Detroit Pistons,91,102,193,11,Detroit Pistons,11,0.133,0.719,45,15,6,7,0.381,0.667,44,24,10,5
2777,21600318,Philadelphia 76ers,Memphis Grizzlies,91,96,187,5,Memphis Grizzlies,5,0.341,0.5,45,21,5,7,0.118,0.8,53,18,8,5
2778,21600319,San Antonio Spurs,Minnesota Timberwolves,105,91,196,14,San Antonio Spurs,14,0.458,0.842,35,21,8,3,0.35,0.667,41,19,4,2
2779,21600320,Phoenix Suns,Utah Jazz,105,112,217,7,Utah Jazz,7,0.333,0.84,41,14,5,0,0.444,0.875,35,23,7,7
2780,21600321,Detroit Pistons,Charlotte Hornets,77,87,164,10,Charlotte Hornets,10,0.148,0.625,57,21,3,8,0.286,0.724,51,13,7,2
2781,21600322,Boston Celtics,Orlando Magic,117,87,204,30,Boston Celtics,30,0.269,0.828,49,29,7,4,0.423,0.667,37,20,7,1
2782,21600323,Denver Nuggets,Brooklyn Nets,111,116,227,5,Brooklyn Nets,5,0.297,0.762,58,18,7,2,0.346,0.806,42,18,11,5
2783,21600324,Miami Heat,Atlanta Hawks,95,103,198,8,Atlanta Hawks,8,0.407,0.8,33,20,6,6,0.211,0.867,47,27,9,9
2784,21600325,Portland Trail Blazers,Milwaukee Bucks,107,115,222,8,Milwaukee Bucks,8,0.425,0.842,44,25,7,4,0.417,0.676,41,19,8,7
2785,21600326,Los Angeles Lakers,Houston Rockets,95,134,229,39,Houston Rockets,39,0.25,0.815,39,14,13,4,0.417,0.81,52,35,20,2
2786,21600327,Cleveland Cavaliers,New York Knicks,126,94,220,32,Cleveland Cavaliers,32,0.55,0.839,46,23,11,4,0.355,0.867,43,22,6,3
2787,21600328,Sacramento Kings,Dallas Mavericks,120,89,209,31,Sacramento Kings,31,0.455,0.762,40,28,10,3,0.333,0.75,40,17,7,5
2788,21600329,Indiana Pacers,Phoenix Suns,109,94,203,15,Indiana Pacers,15,0.304,0.78,49,16,11,3,0.273,0.944,40,17,14,4
2789,21600330,Golden State Warriors,Los Angeles Clippers,115,98,213,17,Golden State Warriors,17,0.226,0.828,46,32,11,5,0.308,0.75,47,15,3,2
2790,21600331,Minnesota Timberwolves,Toronto Raptors,110,124,234,14,Toronto Raptors,14,0.321,0.733,43,19,3,1,0.444,0.788,42,25,5,5
2791,21600332,Denver Nuggets,Washington Wizards,85,92,177,7,Washington Wizards,7,0.219,0.667,45,24,8,2,0.316,0.941,35,21,11,3
2792,21600333,Portland Trail Blazers,Memphis Grizzlies,86,88,174,2,Memphis Grizzlies,2,0.25,0.725,52,13,6,3,0.3,0.667,58,13,8,2
2793,21600334,Philadelphia 76ers,New Orleans Pelicans,99,88,187,11,Philadelphia 76ers,11,0.3,0.692,46,27,8,8,0.28,0.682,47,18,3,2
2794,21600335,Golden State Warriors,Utah Jazz,106,99,205,7,Golden State Warriors,7,0.414,0.696,47,26,10,4,0.263,0.714,46,20,8,2
2795,21600336,San Antonio Spurs,Chicago Bulls,91,95,186,4,Chicago Bulls,4,0.321,0.8,43,21,12,8,0.235,0.778,51,24,7,5
2796,21600337,Orlando Magic,Charlotte Hornets,88,109,197,21,Charlotte Hornets,21,0.265,0.786,40,22,6,2,0.409,0.783,59,23,4,5
2797,21600338,Miami Heat,Cleveland Cavaliers,84,114,198,30,Cleveland Cavaliers,30,0.222,0.762,46,18,6,3,0.375,0.684,47,23,7,9
2798,21600339,Toronto Raptors,Boston Celtics,101,94,195,7,Toronto Raptors,7,0.45,0.889,50,12,9,2,0.405,0.682,46,24,5,4
2799,21600340,Atlanta Hawks,Milwaukee Bucks,114,110,224,4,Atlanta Hawks,4,0.353,0.759,46,32,7,8,0.429,0.714,43,26,11,5
2800,21600341,Houston Rockets,Oklahoma City Thunder,102,99,201,3,Houston Rockets,3,0.262,0.633,52,26,9,1,0.25,0.774,46,18,9,5
2801,21600342,Detroit Pistons,Minnesota Timberwolves,117,90,207,27,Detroit Pistons,27,0.483,0.826,42,23,6,1,0.188,0.65,37,19,4,2
2802,21600343,Indiana Pacers,Dallas Mavericks,103,111,214,8,Dallas Mavericks,8,0.56,0.962,38,21,5,4,0.469,0.75,33,23,8,1
2803,21600344,Phoenix Suns,Los Angeles Lakers,119,115,234,4,Phoenix Suns,4,0.433,0.762,44,26,8,8,0.346,0.765,49,18,4,2
2804,21600345,New York Knicks,Sacramento Kings,103,100,203,3,New York Knicks,3,0.345,0.84,54,22,3,6,0.25,0.852,39,24,10,1
2805,21600346,Milwaukee Bucks,Washington Wizards,105,110,215,5,Washington Wizards,5,0.52,0.8,40,22,1,3,0.381,0.786,40,29,10,3
2806,21600347,Denver Nuggets,Orlando Magic,121,113,234,8,Denver Nuggets,8,0.421,0.76,44,25,2,4,0.407,0.667,31,27,7,5
2807,21600348,Portland Trail Blazers,Indiana Pacers,111,118,229,7,Indiana Pacers,7,0.432,0.938,41,22,6,4,0.517,0.821,39,24,11,9
2808,21600349,Charlotte Hornets,Cleveland Cavaliers,105,116,221,11,Cleveland Cavaliers,11,0.37,0.708,39,24,5,0,0.419,0.679,40,25,8,2
2809,21600350,Miami Heat,Chicago Bulls,100,105,205,5,Chicago Bulls,5,0.25,0.611,43,25,5,5,0.125,0.903,47,17,8,6
2810,21600351,Golden State Warriors,Memphis Grizzlies,89,110,199,21,Memphis Grizzlies,21,0.333,0.6,42,15,6,8,0.308,0.897,47,23,10,5
2811,21600352,Dallas Mavericks,Houston Rockets,87,109,196,22,Houston Rockets,22,0.324,0.857,32,18,7,3,0.514,0.727,48,31,4,1
2812,21600353,Brooklyn Nets,San Antonio Spurs,101,130,231,29,San Antonio Spurs,29,0.259,0.88,47,21,6,2,0.538,0.889,49,38,11,7
2813,21600354,Sacramento Kings,Utah Jazz,84,104,188,20,Utah Jazz,20,0.346,0.538,34,17,10,4,0.448,0.944,54,23,9,10
2814,21600355,New Orleans Pelicans,Los Angeles Clippers,105,133,238,28,Los Angeles Clippers,28,0.421,0.654,34,25,3,1,0.472,0.889,40,34,10,2
2815,21600356,Philadelphia 76ers,Detroit Pistons,97,79,176,18,Philadelphia 76ers,18,0.412,0.824,42,24,11,4,0.263,0.714,34,15,15,2
2816,21600357,Boston Celtics,Oklahoma City Thunder,96,99,195,3,Oklahoma City Thunder,3,0.344,0.625,40,28,9,4,0.143,0.519,49,17,9,7
2817,21600358,Golden State Warriors,Minnesota Timberwolves,116,108,224,8,Golden State Warriors,8,0.406,0.9,37,30,9,4,0.375,0.75,51,17,3,2
2818,21600359,New Orleans Pelicans,Phoenix Suns,120,119,239,1,New Orleans Pelicans,1,0.4,0.8,49,24,12,4,0.341,0.654,57,21,6,3
2819,21600360,New York Knicks,Los Angeles Lakers,118,112,230,6,New York Knicks,6,0.455,0.839,44,21,9,11,0.357,0.818,41,26,7,1
2820,21600361,Charlotte Hornets,Indiana Pacers,94,110,204,16,Indiana Pacers,16,0.385,0.875,46,16,8,4,0.472,0.7,42,24,4,11
2821,21600362,Milwaukee Bucks,Toronto Raptors,100,122,222,22,Toronto Raptors,22,0.167,0.706,37,27,8,3,0.56,0.857,46,26,7,2
2822,21600363,Washington Wizards,Miami Heat,101,112,213,11,Miami Heat,11,0.217,0.818,37,17,8,1,0.346,0.684,47,25,6,3
2823,21600364,Brooklyn Nets,Houston Rockets,118,122,240,4,Houston Rockets,4,0.35,0.75,41,21,9,4,0.395,0.583,39,23,10,5
2824,21600365,Denver Nuggets,Dallas Mavericks,92,112,204,20,Dallas Mavericks,20,0.28,0.833,43,19,6,3,0.462,0.833,34,22,9,7
2825,21600366,Portland Trail Blazers,Los Angeles Clippers,120,121,241,1,Los Angeles Clippers,1,0.476,0.88,42,25,6,7,0.478,0.929,38,26,9,8
2826,21600367,Los Angeles Lakers,Sacramento Kings,92,116,208,24,Sacramento Kings,24,0.435,0.762,39,18,12,3,0.435,0.571,47,23,16,6
2827,21600368,Memphis Grizzlies,Cleveland Cavaliers,86,103,189,17,Cleveland Cavaliers,17,0.182,0.8,43,19,10,6,0.387,0.739,46,21,8,4
2828,21600369,Orlando Magic,Atlanta Hawks,131,120,251,11,Orlando Magic,11,0.441,0.7,28,36,8,5,0.393,0.905,45,29,6,4
2829,21600370,Minnesota Timberwolves,Chicago Bulls,99,94,193,5,Minnesota Timberwolves,5,0.286,0.773,48,24,3,8,0.267,0.737,42,20,7,6
2830,21600371,Golden State Warriors,New Orleans Pelicans,113,109,222,4,Golden State Warriors,4,0.412,0.789,45,30,6,5,0.4,0.81,45,26,12,11
2831,21600372,New York Knicks,Phoenix Suns,111,113,224,2,Phoenix Suns,2,0.35,0.737,43,23,10,4,0.3,0.848,61,13,9,7
2832,21600373,Oklahoma City Thunder,Portland Trail Blazers,95,114,209,19,Portland Trail Blazers,19,0.296,0.75,43,18,10,2,0.348,0.741,37,23,11,9
2833,21600374,Toronto Raptors,Philadelphia 76ers,123,114,237,9,Toronto Raptors,9,0.345,0.861,39,21,9,3,0.31,0.76,43,29,5,4
2834,21600375,Charlotte Hornets,Washington Wizards,106,109,215,3,Washington Wizards,3,0.424,0.762,33,25,7,8,0.278,0.824,41,27,15,3
2835,21600376,Los Angeles Clippers,Orlando Magic,113,108,221,5,Los Angeles Clippers,5,0.52,0.703,42,21,6,5,0.424,0.5,39,29,5,1
2836,21600377,Indiana Pacers,Miami Heat,89,95,184,6,Miami Heat,6,0.333,0.824,38,14,8,5,0.28,0.56,58,23,4,6
2837,21600378,Los Angeles Lakers,Brooklyn Nets,97,107,204,10,Brooklyn Nets,10,0.222,0.618,49,11,8,6,0.314,0.75,61,19,7,4
2838,21600379,Cleveland Cavaliers,Memphis Grizzlies,85,93,178,8,Memphis Grizzlies,8,0.36,0.645,39,10,10,2,0.522,0.688,55,22,9,3
2839,21600380,Sacramento Kings,Houston Rockets,98,132,230,34,Houston Rockets,34,0.344,0.818,40,27,8,7,0.524,0.625,47,40,8,5
2840,21600381,Detroit Pistons,Dallas Mavericks,95,85,180,10,Detroit Pistons,10,0.294,0.818,50,18,4,2,0.32,0.813,30,19,13,3
2841,21600382,Oklahoma City Thunder,Utah Jazz,89,109,198,20,Utah Jazz,20,0.316,0.852,38,14,4,3,0.565,0.8,38,22,4,6
2842,21600383,Boston Celtics,San Antonio Spurs,101,108,209,7,San Antonio Spurs,7,0.323,0.85,35,25,12,3,0.364,0.857,38,33,9,3
2843,21600384,Chicago Bulls,Milwaukee Bucks,97,108,205,11,Milwaukee Bucks,11,0.25,0.759,41,23,5,3,0.55,0.538,42,32,8,5
2844,21600385,Indiana Pacers,New Orleans Pelicans,95,102,197,7,New Orleans Pelicans,7,0.143,0.833,46,23,6,4,0.37,0.714,55,23,7,8
2845,21600386,Portland Trail Blazers,Denver Nuggets,120,132,252,12,Denver Nuggets,12,0.348,0.833,41,22,6,4,0.484,0.886,36,27,10,4
2846,21600387,San Antonio Spurs,Phoenix Suns,107,92,199,15,San Antonio Spurs,15,0.313,0.923,50,19,6,2,0.37,0.778,35,15,9,3
2847,21600388,New York Knicks,Golden State Warriors,90,103,193,13,Golden State Warriors,13,0.238,0.474,49,19,10,5,0.281,0.5,57,41,7,10
2848,21600389,Detroit Pistons,Washington Wizards,108,122,230,14,Washington Wizards,14,0.357,0.667,40,22,3,1,0.48,0.815,36,30,6,1
2849,21600390,Brooklyn Nets,Orlando Magic,111,118,229,7,Orlando Magic,7,0.407,0.846,45,21,5,6,0.241,0.786,49,22,8,11
2850,21600391,Charlotte Hornets,Boston Celtics,88,96,184,8,Boston Celtics,8,0.267,0.842,53,21,10,4,0.321,0.731,46,26,7,8
2851,21600392,Atlanta Hawks,Toronto Raptors,125,121,246,4,Atlanta Hawks,4,0.44,0.688,44,26,6,6,0.476,0.654,28,20,7,5
2852,21600393,Milwaukee Bucks,Chicago Bulls,95,69,164,26,Milwaukee Bucks,26,0.4,0.692,53,26,7,4,0.238,0.533,50,17,7,2
2853,21600394,Sacramento Kings,Memphis Grizzlies,96,92,188,4,Sacramento Kings,4,0.292,0.73,45,18,5,6,0.2,0.806,47,19,7,8
2854,21600395,New Orleans Pelicans,Houston Rockets,100,122,222,22,Houston Rockets,22,0.333,0.55,47,17,4,6,0.393,0.737,57,27,7,4
2855,21600396,Los Angeles Lakers,Philadelphia 76ers,100,89,189,11,Los Angeles Lakers,11,0.3,0.864,46,19,10,4,0.194,0.792,48,22,7,4
2856,21600397,Los Angeles Clippers,Miami Heat,102,98,200,4,Los Angeles Clippers,4,0.28,0.793,50,17,1,3,0.222,0.64,47,20,5,5
2857,21600398,Dallas Mavericks,Utah Jazz,100,103,203,3,Utah Jazz,3,0.429,0.857,27,18,9,0,0.364,0.778,41,18,4,3
2858,21600399,Phoenix Suns,Oklahoma City Thunder,101,114,215,13,Oklahoma City Thunder,13,0.364,0.75,43,16,5,5,0.438,0.735,42,28,12,4
2859,21600400,Indiana Pacers,Detroit Pistons,105,90,195,15,Indiana Pacers,15,0.316,0.76,51,20,6,3,0.333,0.727,40,22,6,1
2860,21600401,Charlotte Hornets,Atlanta Hawks,107,99,206,8,Charlotte Hornets,8,0.444,0.692,43,26,8,3,0.385,0.563,47,26,4,2
2861,21600402,Los Angeles Lakers,Cleveland Cavaliers,108,119,227,11,Cleveland Cavaliers,11,0.432,0.769,41,30,3,2,0.455,0.667,44,30,8,3
2862,21600403,Houston Rockets,Minnesota Timberwolves,111,109,220,2,Houston Rockets,2,0.333,0.8,47,25,14,4,0.333,0.741,55,29,9,6
2863,21600404,New York Knicks,Denver Nuggets,114,127,241,13,Denver Nuggets,13,0.348,0.923,35,18,6,4,0.37,0.586,41,26,6,7
2864,21600405,Portland Trail Blazers,Golden State Warriors,90,135,225,45,Golden State Warriors,45,0.286,0.7,31,16,7,4,0.5,0.731,56,36,7,5
2865,21600406,Los Angeles Clippers,Washington Wizards,110,117,227,7,Washington Wizards,7,0.292,0.708,40,28,7,1,0.526,0.7,33,24,10,4
2866,21600407,Utah Jazz,Memphis Grizzlies,82,73,155,9,Utah Jazz,9,0.296,0.56,42,18,4,11,0.087,0.833,48,12,8,1
2867,21600408,Brooklyn Nets,Philadelphia 76ers,107,108,215,1,Philadelphia 76ers,1,0.353,0.742,43,26,8,5,0.429,0.87,47,23,5,5
2868,21600409,Toronto Raptors,Orlando Magic,109,79,188,30,Toronto Raptors,30,0.259,0.762,47,20,10,7,0.143,0.889,42,13,5,3
2869,21600410,Boston Celtics,Miami Heat,105,95,200,10,Boston Celtics,10,0.321,0.737,37,21,13,2,0.375,0.56,41,23,7,5
2870,21600411,Sacramento Kings,Dallas Mavericks,79,99,178,20,Dallas Mavericks,20,0.258,0.647,42,16,7,4,0.394,0.818,44,20,10,6
2871,21600412,New Orleans Pelicans,San Antonio Spurs,100,113,213,13,San Antonio Spurs,13,0.385,0.571,37,29,8,6,0.5,0.818,49,31,6,6
2872,21600413,Washington Wizards,Indiana Pacers,105,107,212,2,Indiana Pacers,2,0.242,0.808,49,19,5,6,0.333,0.857,41,18,6,5
2873,21600414,Detroit Pistons,Chicago Bulls,82,113,195,31,Chicago Bulls,31,0.13,0.846,32,19,8,3,0.5,1,46,34,9,5
2874,21600415,Atlanta Hawks,Oklahoma City Thunder,110,108,218,2,Atlanta Hawks,2,0.391,0.792,35,24,5,2,0.286,0.769,44,13,8,3
2875,21600416,Phoenix Suns,Minnesota Timberwolves,108,115,223,7,Minnesota Timberwolves,7,0.429,0.714,34,16,11,5,0.368,0.96,41,26,8,7
2876,21600417,Dallas Mavericks,Denver Nuggets,107,117,224,10,Denver Nuggets,10,0.56,0.778,29,21,4,4,0.52,0.778,41,32,7,0
2877,21600418,New Orleans Pelicans,Philadelphia 76ers,108,93,201,15,New Orleans Pelicans,15,0.588,0.692,56,28,2,3,0.333,0.762,43,18,6,8
2878,21600419,Los Angeles Lakers,Charlotte Hornets,113,117,230,4,Charlotte Hornets,4,0.485,0.818,40,29,5,12,0.44,0.833,44,30,5,2
2879,21600420,Brooklyn Nets,Toronto Raptors,104,116,220,12,Toronto Raptors,12,0.286,0.786,52,20,9,5,0.444,0.774,48,19,13,9
2880,21600421,Indiana Pacers,New York Knicks,111,118,229,7,New York Knicks,7,0.261,0.818,44,22,10,5,0.565,0.81,45,24,6,8
2881,21600422,Orlando Magic,Miami Heat,136,130,266,6,Orlando Magic,6,0.5,0.677,47,24,3,5,0.4,0.692,48,22,4,6
2882,21600423,Cleveland Cavaliers,Milwaukee Bucks,114,108,222,6,Cleveland Cavaliers,6,0.425,0.852,43,19,5,2,0.259,0.724,51,22,6,6
2883,21600424,Boston Celtics,Memphis Grizzlies,112,109,221,3,Boston Celtics,3,0.324,0.895,41,22,7,5,0.4,0.808,52,23,10,3
2884,21600425,San Antonio Spurs,Houston Rockets,102,100,202,2,San Antonio Spurs,2,0.522,0.72,43,21,13,5,0.158,0.889,51,22,10,5
2885,21600426,Denver Nuggets,Los Angeles Clippers,102,119,221,17,Los Angeles Clippers,17,0.282,0.65,46,22,5,1,0.444,0.692,37,32,7,2
2886,21600427,Utah Jazz,Golden State Warriors,74,104,178,30,Golden State Warriors,30,0.3,0.55,44,13,5,3,0.391,0.882,50,24,13,3
2887,21600428,Portland Trail Blazers,Sacramento Kings,121,126,247,5,Sacramento Kings,5,0.143,0.725,41,30,5,4,0.435,0.837,31,20,3,4
2888,21600429,Milwaukee Bucks,Cleveland Cavaliers,102,113,215,11,Cleveland Cavaliers,11,0.409,0.724,39,24,7,8,0.556,0.632,42,30,3,7
2889,21600430,Minnesota Timberwolves,Atlanta Hawks,92,84,176,8,Minnesota Timberwolves,8,0.31,0.929,52,21,6,6,0.269,0.692,35,19,9,8
2890,21600431,Memphis Grizzlies,Detroit Pistons,98,86,184,12,Memphis Grizzlies,12,0.4,0.842,38,25,9,4,0.261,0.757,46,17,2,3
2891,21600432,Washington Wizards,Chicago Bulls,107,97,204,10,Washington Wizards,10,0.167,0.72,44,23,7,3,0.286,0.789,49,25,4,5
2892,21600433,Oklahoma City Thunder,New Orleans Pelicans,121,110,231,11,Oklahoma City Thunder,11,0.393,0.833,49,22,8,6,0.4,0.783,33,25,4,3
2893,21600434,Sacramento Kings,Utah Jazz,94,93,187,1,Sacramento Kings,1,0.476,0.667,41,13,5,3,0.333,0.818,43,19,7,6
2894,21600435,Houston Rockets,Phoenix Suns,125,111,236,14,Houston Rockets,14,0.474,0.577,37,30,4,8,0.36,0.7,44,20,7,6
2895,21600436,Dallas Mavericks,Portland Trail Blazers,96,95,191,1,Dallas Mavericks,1,0.226,0.826,38,14,12,5,0.37,0.75,43,15,6,4
2896,21600437,Golden State Warriors,Brooklyn Nets,117,101,218,16,Golden State Warriors,16,0.324,0.786,51,29,19,7,0.371,0.75,46,22,6,6
2897,21600438,Orlando Magic,New York Knicks,95,106,201,11,New York Knicks,11,0.185,0.75,41,21,7,7,0.45,0.882,52,26,9,9
2898,21600439,Los Angeles Lakers,Miami Heat,107,115,222,8,Miami Heat,8,0.368,0.867,40,18,7,2,0.5,0.667,47,25,7,6
2899,21600440,Boston Celtics,Indiana Pacers,109,102,211,7,Boston Celtics,7,0.256,0.852,44,19,10,2,0.304,0.862,50,20,5,3
2900,21600441,San Antonio Spurs,Los Angeles Clippers,101,106,207,5,Los Angeles Clippers,5,0.316,0.84,55,19,8,7,0.393,0.773,40,18,8,6
2901,21600442,Chicago Bulls,Charlotte Hornets,91,103,194,12,Charlotte Hornets,12,0.318,0.8,52,20,5,6,0.278,0.857,48,25,6,13
2902,21600443,Los Angeles Lakers,Orlando Magic,90,109,199,19,Orlando Magic,19,0.348,0.833,46,16,8,6,0.407,0.571,47,25,10,11
2903,21600444,Brooklyn Nets,Cleveland Cavaliers,99,119,218,20,Cleveland Cavaliers,20,0.267,0.833,44,22,6,7,0.229,0.875,51,28,12,4
2904,21600445,Oklahoma City Thunder,Boston Celtics,117,112,229,5,Oklahoma City Thunder,5,0.423,0.667,44,27,5,6,0.321,0.808,39,29,8,2
2905,21600446,Golden State Warriors,Detroit Pistons,119,113,232,6,Golden State Warriors,6,0.407,0.917,41,35,9,2,0.345,0.607,36,22,12,3
2906,21600447,Washington Wizards,Milwaukee Bucks,96,123,219,27,Milwaukee Bucks,27,0.292,0.833,30,24,2,2,0.36,0.889,41,29,8,6
2907,21600448,Houston Rockets,Memphis Grizzlies,109,115,224,6,Memphis Grizzlies,6,0.385,0.867,40,27,5,3,0.52,0.8,38,23,8,3
2908,21600449,Miami Heat,New Orleans Pelicans,87,91,178,4,New Orleans Pelicans,4,0.4,0.538,59,19,4,4,0.393,0.667,51,17,9,7
2909,21600450,Sacramento Kings,Minnesota Timberwolves,109,105,214,4,Sacramento Kings,4,0.517,0.714,34,27,7,3,0.375,0.808,42,18,5,4
2910,21600451,Atlanta Hawks,Denver Nuggets,109,108,217,1,Atlanta Hawks,1,0.32,0.818,40,26,10,4,0.32,0.743,46,27,3,7
2911,21600452,Toronto Raptors,Utah Jazz,104,98,202,6,Toronto Raptors,6,0.381,0.667,36,12,12,4,0.37,0.857,40,21,7,2
2912,21600453,Philadelphia 76ers,Phoenix Suns,116,123,239,7,Phoenix Suns,7,0.419,0.864,28,23,7,6,0.462,0.73,43,25,7,6
2913,21600454,San Antonio Spurs,Portland Trail Blazers,110,90,200,20,San Antonio Spurs,20,0.6,0.952,45,19,9,3,0.4,0.5,33,21,8,2
2914,21600455,Dallas Mavericks,Los Angeles Clippers,90,88,178,2,Dallas Mavericks,2,0.241,0.6,42,21,13,4,0.448,0.636,41,17,9,4
2915,21600456,Boston Celtics,New York Knicks,119,114,233,5,Boston Celtics,5,0.389,0.75,39,25,10,2,0.348,0.889,49,11,5,6
2916,21600457,Golden State Warriors,Cleveland Cavaliers,108,109,217,1,Cleveland Cavaliers,1,0.3,0.862,42,25,8,4,0.343,0.719,44,20,14,2
2917,21600458,Chicago Bulls,San Antonio Spurs,100,119,219,19,San Antonio Spurs,19,0.389,0.75,38,20,9,1,0.5,0.737,43,30,7,3
2918,21600459,Minnesota Timberwolves,Oklahoma City Thunder,100,112,212,12,Oklahoma City Thunder,12,0.333,0.783,36,19,11,2,0.333,0.833,42,26,8,4
2919,21600460,Los Angeles Clippers,Los Angeles Lakers,102,111,213,9,Los Angeles Lakers,9,0.345,0.818,42,24,9,5,0.32,0.767,48,18,7,3
2920,21600461,Milwaukee Bucks,Washington Wizards,102,107,209,5,Washington Wizards,5,0.3,0.696,42,27,8,2,0.414,0.75,40,29,7,6
2921,21600462,Memphis Grizzlies,Orlando Magic,102,112,214,10,Orlando Magic,10,0.4,0.786,35,17,7,4,0.5,0.688,43,23,5,3
2922,21600463,Charlotte Hornets,Brooklyn Nets,118,120,238,2,Brooklyn Nets,2,0.308,0.88,44,23,11,3,0.484,0.806,39,26,4,8
2923,21600464,Cleveland Cavaliers,Detroit Pistons,90,106,196,16,Detroit Pistons,16,0.393,0.826,47,19,8,3,0.571,0.533,45,25,12,4
2924,21600465,Indiana Pacers,Chicago Bulls,85,90,175,5,Chicago Bulls,5,0.36,0.8,40,26,5,5,0.24,0.714,48,17,10,3
2925,21600466,Dallas Mavericks,New Orleans Pelicans,104,111,215,7,New Orleans Pelicans,7,0.406,0.773,32,27,4,1,0.48,0.833,41,24,6,3
2926,21600467,Phoenix Suns,Houston Rockets,115,131,246,16,Houston Rockets,16,0.233,0.815,53,17,14,6,0.349,0.8,47,28,11,4
2927,21600468,Atlanta Hawks,Minnesota Timberwolves,90,104,194,14,Minnesota Timberwolves,14,0.25,0.706,46,20,8,7,0.484,0.833,40,26,11,3
2928,21600469,Toronto Raptors,Portland Trail Blazers,95,91,186,4,Toronto Raptors,4,0.353,0.792,52,17,11,4,0.348,0.722,54,22,8,4
2929,21600470,Denver Nuggets,Los Angeles Clippers,106,102,208,4,Denver Nuggets,4,0.355,0.821,51,22,10,1,0.36,0.75,38,22,6,6
2930,21600471,Philadelphia 76ers,Sacramento Kings,100,102,202,2,Sacramento Kings,2,0.36,0.722,38,20,13,5,0.28,0.81,42,24,11,4
2931,21600472,Memphis Grizzlies,Boston Celtics,103,113,216,10,Boston Celtics,10,0.3,0.69,37,22,14,5,0.387,0.905,47,30,6,7
2932,21600473,Oklahoma City Thunder,Miami Heat,106,94,200,12,Oklahoma City Thunder,12,0.263,0.68,46,21,3,4,0.318,0.714,32,14,10,4
2933,21600474,Houston Rockets,Dallas Mavericks,123,107,230,16,Houston Rockets,16,0.531,0.857,47,23,7,5,0.395,0.8,38,22,6,5
2934,21600475,Utah Jazz,Los Angeles Lakers,102,100,202,2,Utah Jazz,2,0.346,0.708,39,19,6,4,0.25,0.818,40,19,8,3
2935,21600476,Indiana Pacers,Washington Wizards,105,111,216,6,Washington Wizards,6,0.393,0.828,34,24,10,4,0.364,0.73,54,21,8,1
2936,21600477,Charlotte Hornets,Orlando Magic,120,101,221,19,Charlotte Hornets,19,0.417,0.947,46,25,7,3,0.265,0.8,33,25,7,7
2937,21600478,New York Knicks,Atlanta Hawks,98,102,200,4,Atlanta Hawks,4,0.259,0.808,55,20,8,7,0.259,0.778,55,19,8,3
2938,21600479,Milwaukee Bucks,Detroit Pistons,119,94,213,25,Milwaukee Bucks,25,0.5,0.75,38,36,8,5,0.25,0.625,44,28,4,1
2939,21600480,Brooklyn Nets,Chicago Bulls,99,101,200,2,Chicago Bulls,2,0.406,0.75,37,21,9,6,0.231,0.966,54,20,8,8
2940,21600481,Los Angeles Clippers,New Orleans Pelicans,98,102,200,4,New Orleans Pelicans,4,0.297,0.722,58,15,6,4,0.345,0.571,45,23,11,5
2941,21600482,Phoenix Suns,San Antonio Spurs,98,119,217,21,San Antonio Spurs,21,0.438,0.792,33,20,11,4,0.294,0.8,46,20,11,7
2942,21600483,Minnesota Timberwolves,Denver Nuggets,103,105,208,2,Denver Nuggets,2,0.28,0.706,43,29,8,3,0.357,0.786,38,29,6,4
2943,21600484,Sacramento Kings,Portland Trail Blazers,89,102,191,13,Portland Trail Blazers,13,0.321,0.783,39,20,8,3,0.48,0.909,45,19,6,4
2944,21600485,Toronto Raptors,Golden State Warriors,111,121,232,10,Golden State Warriors,10,0.371,0.818,45,24,13,6,0.609,0.833,51,33,4,9
2945,21600486,Miami Heat,Charlotte Hornets,82,91,173,9,Charlotte Hornets,9,0.357,0.462,46,26,6,10,0.192,0.778,54,18,9,8
2946,21600487,Oklahoma City Thunder,Memphis Grizzlies,80,114,194,34,Memphis Grizzlies,34,0.182,0.684,39,9,5,7,0.591,0.75,39,24,8,9
2947,21600488,Boston Celtics,Cleveland Cavaliers,118,124,242,6,Cleveland Cavaliers,6,0.324,0.952,29,26,15,4,0.368,0.727,46,29,7,3
2948,21600489,Philadelphia 76ers,Utah Jazz,83,100,183,17,Utah Jazz,17,0.25,0.875,41,16,6,1,0.577,0.536,43,21,9,6
2949,21600490,Toronto Raptors,Phoenix Suns,91,99,190,8,Phoenix Suns,8,0.259,0.828,43,10,12,5,0.429,0.696,47,20,10,4
2950,21600491,Dallas Mavericks,Los Angeles Lakers,101,89,190,12,Dallas Mavericks,12,0.452,0.786,42,24,8,2,0.368,0.72,34,15,8,1
2951,21600492,Chicago Bulls,Indiana Pacers,101,111,212,10,Indiana Pacers,10,0.261,0.806,47,17,8,5,0.368,0.867,42,26,7,6
2952,21600493,Brooklyn Nets,Washington Wizards,95,118,213,23,Washington Wizards,23,0.4,0.84,32,18,9,0,0.5,0.929,44,28,12,7
2953,21600494,Miami Heat,Boston Celtics,114,117,231,3,Boston Celtics,3,0.393,0.7,39,35,7,8,0.531,0.828,30,28,6,2
2954,21600495,New York Knicks,New Orleans Pelicans,92,104,196,12,New Orleans Pelicans,12,0.304,0.938,50,18,7,6,0.414,0.941,42,22,4,5
2955,21600496,Los Angeles Clippers,Houston Rockets,116,140,256,24,Houston Rockets,24,0.394,0.813,38,22,8,4,0.35,0.837,45,29,12,5
2956,21600497,Milwaukee Bucks,Minnesota Timberwolves,99,116,215,17,Minnesota Timberwolves,17,0.444,0.647,29,22,4,4,0.52,0.81,34,30,8,5
2957,21600498,Detroit Pistons,Atlanta Hawks,98,105,203,7,Atlanta Hawks,7,0.29,0.905,43,22,9,7,0.308,0.76,44,29,10,2
2958,21600499,Portland Trail Blazers,San Antonio Spurs,94,110,204,16,San Antonio Spurs,16,0.3,0.857,25,19,10,3,0.5,0.84,48,22,7,5
2959,21600500,Philadelphia 76ers,Denver Nuggets,124,122,246,2,Philadelphia 76ers,2,0.485,0.8,44,25,5,5,0.407,0.805,45,29,5,1
2960,21600501,Dallas Mavericks,Golden State Warriors,99,108,207,9,Golden State Warriors,9,0.25,0.867,40,22,11,7,0.333,0.867,43,31,5,4
2961,21600502,Memphis Grizzlies,Sacramento Kings,112,98,210,14,Memphis Grizzlies,14,0.486,0.778,40,25,6,3,0.393,0.893,39,17,6,3
2962,21600503,Milwaukee Bucks,Chicago Bulls,116,96,212,20,Milwaukee Bucks,20,0.6,0.778,42,29,7,8,0.37,0.714,37,23,9,5
2963,21600504,New York Knicks,Houston Rockets,122,129,251,7,Houston Rockets,7,0.313,0.72,48,21,7,3,0.382,0.828,46,30,3,2
2964,21600505,Cleveland Cavaliers,Charlotte Hornets,121,109,230,12,Cleveland Cavaliers,12,0.452,0.84,35,17,6,1,0.375,0.87,39,24,3,7
2965,21600506,Phoenix Suns,Utah Jazz,86,91,177,5,Utah Jazz,5,0.412,0.7,41,9,6,2,0.4,0.65,46,17,3,4
2966,21600507,Los Angeles Clippers,Oklahoma City Thunder,88,114,202,26,Oklahoma City Thunder,26,0.267,0.857,38,14,4,4,0.345,0.857,44,25,9,6
2967,21600508,San Antonio Spurs,Atlanta Hawks,112,114,226,2,Atlanta Hawks,2,0.333,0.864,47,27,5,6,0.5,0.593,46,25,6,6
2968,21600509,Detroit Pistons,Miami Heat,107,98,205,9,Detroit Pistons,9,0.409,0.636,48,16,7,5,0.538,0.778,34,25,6,4
2969,21600510,Orlando Magic,Indiana Pacers,104,117,221,13,Indiana Pacers,13,0.263,0.909,42,25,6,7,0.409,0.917,46,28,5,5
2970,21600511,Portland Trail Blazers,Minnesota Timberwolves,95,89,184,6,Portland Trail Blazers,6,0.273,0.607,41,13,10,8,0.304,0.667,47,21,11,5
2971,21600512,Toronto Raptors,Los Angeles Lakers,123,114,237,9,Toronto Raptors,9,0.588,0.906,40,18,5,9,0.469,0.806,43,19,8,3
2972,21600513,Oklahoma City Thunder,Milwaukee Bucks,94,98,192,4,Milwaukee Bucks,4,0.333,0.684,40,20,7,5,0.368,0.625,39,21,4,4
2973,21600514,New Orleans Pelicans,Cleveland Cavaliers,82,90,172,8,Cleveland Cavaliers,8,0.423,0.7,45,26,6,6,0.194,0.727,56,16,9,4
2974,21600515,Utah Jazz,Brooklyn Nets,101,89,190,12,Utah Jazz,12,0.292,0.8,46,11,9,5,0.222,0.739,44,13,5,5
2975,21600516,Orlando Magic,New York Knicks,115,103,218,12,Orlando Magic,12,0.484,0.714,39,35,10,4,0.381,0.708,46,18,7,5
2976,21600517,Charlotte Hornets,Chicago Bulls,111,118,229,7,Chicago Bulls,7,0.474,0.909,34,24,7,3,0.304,0.931,45,23,10,9
2977,21600518,Washington Wizards,Houston Rockets,91,101,192,10,Houston Rockets,10,0.231,0.75,45,23,9,2,0.308,0.714,41,25,9,9
2978,21600519,Phoenix Suns,Los Angeles Clippers,98,109,207,11,Los Angeles Clippers,11,0.133,0.818,48,22,11,4,0.438,0.737,51,17,1,11
2979,21600520,Denver Nuggets,Golden State Warriors,119,127,246,8,Golden State Warriors,8,0.257,0.778,48,33,10,2,0.44,0.762,43,33,7,2
2980,21600521,Minnesota Timberwolves,Philadelphia 76ers,91,93,184,2,Philadelphia 76ers,2,0.292,0.9,47,20,7,6,0.219,0.8,48,19,10,7
2981,21600522,Utah Jazz,Boston Celtics,104,115,219,11,Boston Celtics,11,0.423,0.81,35,27,7,3,0.548,0.941,32,31,5,6
2982,21600523,Indiana Pacers,Detroit Pistons,121,116,237,5,Indiana Pacers,5,0.563,0.867,34,26,7,7,0.345,0.833,42,31,5,5
2983,21600524,Washington Wizards,Dallas Mavericks,105,113,218,8,Dallas Mavericks,8,0.367,0.857,38,27,6,7,0.531,0.917,42,20,4,3
2984,21600525,Toronto Raptors,San Antonio Spurs,82,110,192,28,San Antonio Spurs,28,0.222,0.727,43,8,8,4,0.542,0.733,43,32,7,15
2985,21600526,Sacramento Kings,Denver Nuggets,120,113,233,7,Sacramento Kings,7,0.379,0.944,33,26,7,2,0.474,1,32,29,6,4
2986,21600527,Miami Heat,Phoenix Suns,90,99,189,9,Phoenix Suns,9,0.261,0.75,43,18,8,4,0.391,0.818,49,21,7,7
2987,21600528,Memphis Grizzlies,Los Angeles Lakers,102,116,218,14,Los Angeles Lakers,14,0.323,0.914,39,18,6,1,0.515,0.536,43,34,5,2
2988,21600529,Oklahoma City Thunder,Charlotte Hornets,112,123,235,11,Charlotte Hornets,11,0.3,0.826,51,22,6,3,0.375,0.816,43,25,8,10
2989,21600530,Atlanta Hawks,Orlando Magic,111,92,203,19,Atlanta Hawks,19,0.526,0.722,39,27,12,3,0.321,0.9,40,19,9,6
2990,21600531,Milwaukee Bucks,New York Knicks,105,104,209,1,Milwaukee Bucks,1,0.321,0.71,42,20,7,5,0.464,0.583,46,26,9,3
2991,21600532,Chicago Bulls,Cleveland Cavaliers,106,94,200,12,Chicago Bulls,12,0.433,0.733,43,23,8,3,0.32,0.75,44,13,6,2
2992,21600533,Memphis Grizzlies,Los Angeles Clippers,106,115,221,9,Los Angeles Clippers,9,0.393,0.76,43,30,6,5,0.391,0.711,45,23,5,5
2993,21600534,Portland Trail Blazers,Golden State Warriors,117,125,242,8,Golden State Warriors,8,0.462,0.893,44,23,8,5,0.361,0.828,39,31,14,9
2994,21600535,Miami Heat,Sacramento Kings,107,102,209,5,Miami Heat,5,0.429,0.862,39,24,8,9,0.4,0.824,26,26,8,3
2995,21600536,Brooklyn Nets,Indiana Pacers,109,121,230,12,Indiana Pacers,12,0.447,0.769,45,22,5,8,0.455,0.789,44,23,7,9
2996,21600537,Utah Jazz,Toronto Raptors,93,101,194,8,Toronto Raptors,8,0.35,0.857,46,16,2,4,0.381,0.75,45,14,10,6
2997,21600538,Charlotte Hornets,Detroit Pistons,114,115,229,1,Detroit Pistons,1,0.385,0.882,49,20,4,5,0.357,0.844,56,24,2,6
2998,21600539,Atlanta Hawks,New Orleans Pelicans,99,94,193,5,Atlanta Hawks,5,0.391,0.824,55,23,9,6,0.429,0.786,52,19,8,4
2999,21600540,Oklahoma City Thunder,Houston Rockets,116,118,234,2,Houston Rockets,2,0.4,0.815,54,15,6,9,0.385,0.7,43,27,6,3
3000,21600541,Phoenix Suns,Dallas Mavericks,102,95,197,7,Phoenix Suns,7,0.412,0.864,53,15,4,3,0.31,0.824,31,18,6,7
3001,21600542,Los Angeles Lakers,Portland Trail Blazers,109,118,227,9,Portland Trail Blazers,9,0.323,0.818,40,15,7,3,0.364,0.667,47,29,6,5
3002,21600543,San Antonio Spurs,Denver Nuggets,127,99,226,28,San Antonio Spurs,28,0.5,0.765,41,34,5,8,0.28,0.824,38,25,7,3
3003,21600544,Minnesota Timberwolves,Washington Wizards,105,112,217,7,Washington Wizards,7,0.389,0.824,38,22,6,2,0.545,0.889,33,31,3,7
3004,21600545,Houston Rockets,Orlando Magic,100,93,193,7,Houston Rockets,7,0.306,0.583,45,26,12,1,0.348,0.692,49,18,8,2
3005,21600546,Philadelphia 76ers,Boston Celtics,106,110,216,4,Boston Celtics,4,0.321,0.885,41,30,9,11,0.475,0.84,42,28,6,11
3006,21600547,Cleveland Cavaliers,Brooklyn Nets,116,108,224,8,Cleveland Cavaliers,8,0.273,0.721,46,19,14,3,0.3,0.895,52,21,6,1
3007,21600548,New York Knicks,Milwaukee Bucks,116,111,227,5,New York Knicks,5,0.565,0.778,40,29,5,6,0.545,0.75,35,24,9,11
3008,21600549,Miami Heat,Los Angeles Lakers,100,127,227,27,Los Angeles Lakers,27,0.25,0.593,41,17,5,7,0.357,0.724,62,22,6,2
3009,21600550,Memphis Grizzlies,Golden State Warriors,128,119,247,9,Memphis Grizzlies,9,0.394,0.789,47,29,13,0,0.267,0.744,44,23,7,5
3010,21600551,Los Angeles Clippers,Sacramento Kings,106,98,204,8,Los Angeles Clippers,8,0.419,0.714,45,28,6,5,0.3,0.773,50,23,4,3
3011,21600552,New York Knicks,Indiana Pacers,109,123,232,14,Indiana Pacers,14,0.387,0.708,32,25,9,7,0.458,0.929,53,25,11,0
3012,21600553,New Orleans Pelicans,Boston Celtics,108,117,225,9,Boston Celtics,9,0.323,0.783,42,22,7,7,0.5,0.905,47,26,6,5
3013,21600554,Toronto Raptors,Chicago Bulls,118,123,241,5,Chicago Bulls,5,0.258,0.837,41,20,11,5,0.393,0.923,60,25,5,2
3014,21600555,Denver Nuggets,Oklahoma City Thunder,106,121,227,15,Oklahoma City Thunder,15,0.375,0.708,53,18,7,4,0.333,0.793,49,23,8,11
3015,21600556,Utah Jazz,Minnesota Timberwolves,94,92,186,2,Utah Jazz,2,0.348,0.786,39,23,12,6,0.35,0.714,48,23,3,3
3016,21600557,Atlanta Hawks,Dallas Mavericks,97,82,179,15,Atlanta Hawks,15,0.5,0.813,47,19,8,1,0.25,0.9,41,18,7,3
3017,21600558,Charlotte Hornets,San Antonio Spurs,85,102,187,17,San Antonio Spurs,17,0.19,0.84,48,18,5,4,0.382,0.85,43,29,9,8
3018,21600559,Detroit Pistons,Portland Trail Blazers,125,124,249,1,Detroit Pistons,1,0.32,0.75,41,19,14,3,0.429,0.583,42,36,5,5
3019,21600560,Philadelphia 76ers,Brooklyn Nets,105,95,200,10,Philadelphia 76ers,10,0.296,0.852,46,19,11,5,0.37,0.765,40,21,6,8
3020,21600561,Miami Heat,Los Angeles Clippers,86,98,184,12,Los Angeles Clippers,12,0.259,0.81,50,14,6,5,0.3,0.68,51,27,8,3
3021,21600562,Washington Wizards,Milwaukee Bucks,107,101,208,6,Washington Wizards,6,0.313,0.833,49,23,10,4,0.391,0.9,32,25,14,3
3022,21600563,Houston Rockets,Toronto Raptors,129,122,251,7,Houston Rockets,7,0.289,0.839,39,27,9,6,0.44,0.9,39,19,7,3
3023,21600564,Utah Jazz,Memphis Grizzlies,79,88,167,9,Memphis Grizzlies,9,0.391,0.609,43,14,8,3,0.375,0.786,37,19,11,2
3024,21600565,Cleveland Cavaliers,Phoenix Suns,120,116,236,4,Cleveland Cavaliers,4,0.441,0.895,38,15,8,5,0.333,0.789,36,23,12,7
3025,21600566,Golden State Warriors,Sacramento Kings,117,106,223,11,Golden State Warriors,11,0.345,0.85,46,33,11,6,0.393,0.793,31,21,13,5
3026,21600567,Orlando Magic,Los Angeles Lakers,95,111,206,16,Los Angeles Lakers,16,0.269,0.69,54,24,5,3,0.25,0.792,47,23,8,5
3027,21600568,New Orleans Pelicans,New York Knicks,110,96,206,14,New Orleans Pelicans,14,0.444,0.842,39,24,11,7,0.379,0.813,45,17,5,4
3028,21600569,Oklahoma City Thunder,Chicago Bulls,109,94,203,15,Oklahoma City Thunder,15,0.292,0.727,42,30,5,5,0.368,0.864,38,18,7,2
3029,21600570,Dallas Mavericks,Minnesota Timberwolves,92,101,193,9,Minnesota Timberwolves,9,0.464,0.778,25,24,3,2,0.375,0.714,42,30,11,4
3030,21600571,Chicago Bulls,Washington Wizards,99,101,200,2,Washington Wizards,2,0.37,0.905,44,19,10,2,0.5,0.667,42,24,8,6
3031,21600572,Boston Celtics,Toronto Raptors,106,114,220,8,Toronto Raptors,8,0.333,0.85,33,21,7,3,0.455,0.815,50,17,9,7
3032,21600573,Atlanta Hawks,Brooklyn Nets,117,97,214,20,Atlanta Hawks,20,0.304,0.579,53,25,11,12,0.345,0.739,48,22,5,4
3033,21600574,Charlotte Hornets,Houston Rockets,114,121,235,7,Houston Rockets,7,0.442,0.778,43,30,3,4,0.436,0.727,44,25,8,5
3034,21600575,Milwaukee Bucks,San Antonio Spurs,109,107,216,2,Milwaukee Bucks,2,0.526,0.846,38,32,8,6,0.4,0.786,41,22,5,7
3035,21600576,Cleveland Cavaliers,Utah Jazz,92,100,192,8,Utah Jazz,8,0.29,0.84,42,15,6,2,0.382,0.579,46,22,8,4
3036,21600577,Portland Trail Blazers,Los Angeles Lakers,108,87,195,21,Portland Trail Blazers,21,0.333,0.75,50,25,6,9,0.375,0.538,38,18,7,5
3037,21600578,Miami Heat,Golden State Warriors,95,107,202,12,Golden State Warriors,12,0.2,0.765,46,25,6,4,0.407,0.818,48,28,6,7
3038,21600579,Detroit Pistons,Sacramento Kings,94,100,194,6,Sacramento Kings,6,0.444,0.625,35,14,12,9,0.565,0.793,45,21,6,3
3039,21600580,New York Knicks,Philadelphia 76ers,97,98,195,1,Philadelphia 76ers,1,0.182,0.9,40,20,7,8,0.25,0.81,47,27,7,1
3040,21600581,Memphis Grizzlies,Oklahoma City Thunder,95,103,198,8,Oklahoma City Thunder,8,0.292,0.571,39,18,11,5,0.308,0.793,53,21,5,4
3041,21600582,Houston Rockets,Minnesota Timberwolves,105,119,224,14,Minnesota Timberwolves,14,0.357,0.818,32,23,7,4,0.348,0.92,49,31,8,9
3042,21600583,Washington Wizards,Boston Celtics,108,117,225,9,Boston Celtics,9,0.385,0.667,44,28,10,3,0.415,0.778,45,20,5,7
3043,21600584,Orlando Magic,Los Angeles Clippers,96,105,201,9,Los Angeles Clippers,9,0.222,0.667,35,21,8,3,0.346,0.692,49,23,11,5
3044,21600585,Cleveland Cavaliers,Portland Trail Blazers,86,102,188,16,Portland Trail Blazers,16,0.3,0.75,48,14,5,4,0.333,0.75,51,29,6,9
3045,21600586,New Orleans Pelicans,Brooklyn Nets,104,95,199,9,New Orleans Pelicans,9,0.344,0.68,50,16,12,4,0.214,0.545,50,22,10,6
3046,21600587,Chicago Bulls,New York Knicks,89,104,193,15,New York Knicks,15,0.167,0.762,43,20,5,4,0.304,0.818,48,21,3,7
3047,21600588,Los Angeles Lakers,San Antonio Spurs,94,134,228,40,San Antonio Spurs,40,0.3,0.72,29,23,6,3,0.476,0.897,46,32,5,5
3048,21600589,Indiana Pacers,Denver Nuggets,112,140,252,28,Denver Nuggets,28,0.414,0.923,34,26,9,4,0.469,0.913,47,37,10,5
3049,21600590,Detroit Pistons,Golden State Warriors,107,127,234,20,Golden State Warriors,20,0.214,0.75,40,20,10,4,0.517,0.667,37,39,14,4
3050,21600591,Dallas Mavericks,Phoenix Suns,113,108,221,5,Dallas Mavericks,5,0.441,0.706,32,29,11,7,0.556,0.815,47,15,2,4
3051,21600592,Brooklyn Nets,Toronto Raptors,113,132,245,19,Toronto Raptors,19,0.472,0.8,35,26,5,1,0.393,0.81,49,21,7,9
3052,21600593,Charlotte Hornets,Philadelphia 76ers,93,102,195,9,Philadelphia 76ers,9,0.261,0.969,41,11,12,2,0.368,0.8,38,26,12,9
3053,21600594,Miami Heat,Milwaukee Bucks,108,116,224,8,Milwaukee Bucks,8,0.375,0.778,27,33,6,8,0.6,0.871,46,28,8,6
3054,21600595,Memphis Grizzlies,Houston Rockets,110,105,215,5,Memphis Grizzlies,5,0.37,0.667,45,25,8,3,0.244,0.806,31,19,9,2
3055,21600596,Oklahoma City Thunder,Minnesota Timberwolves,86,96,182,10,Minnesota Timberwolves,10,0.15,0.81,47,19,10,2,0.278,0.929,42,21,11,6
3056,21600597,Boston Celtics,Atlanta Hawks,103,101,204,2,Boston Celtics,2,0.386,0.737,43,22,7,3,0.367,0.857,43,22,5,5
3057,21600598,Orlando Magic,Portland Trail Blazers,115,109,224,6,Orlando Magic,6,0.556,0.885,45,21,5,5,0.294,0.84,43,19,6,9
3058,21600599,Cleveland Cavaliers,Sacramento Kings,120,108,228,12,Cleveland Cavaliers,12,0.405,0.773,39,27,11,3,0.36,0.789,42,23,7,5
3059,21600600,Detroit Pistons,Utah Jazz,77,110,187,33,Utah Jazz,33,0.353,0.688,35,15,5,4,0.516,0.615,47,22,10,6
3060,21600601,Los Angeles Lakers,Los Angeles Clippers,97,113,210,16,Los Angeles Clippers,16,0.476,0.556,40,21,3,2,0.357,0.875,42,28,6,6
3061,21600602,New Orleans Pelicans,Chicago Bulls,99,107,206,8,Chicago Bulls,8,0.304,0.667,42,27,3,6,0.4,0.565,63,22,10,6
3062,21600603,Philadelphia 76ers,Washington Wizards,93,109,202,16,Washington Wizards,16,0.323,0.524,49,20,6,2,0.471,0.722,50,18,9,2
3063,21600604,Orlando Magic,Utah Jazz,107,114,221,7,Utah Jazz,7,0.353,0.704,40,23,10,2,0.269,0.694,44,28,6,2
3064,21600605,San Antonio Spurs,Phoenix Suns,105,108,213,3,Phoenix Suns,3,0.45,0.706,33,15,8,1,0.381,0.917,45,18,10,0
3065,21600606,New York Knicks,Toronto Raptors,101,116,217,15,Toronto Raptors,15,0.414,0.704,41,21,7,7,0.364,0.87,42,21,9,4
3066,21600607,Milwaukee Bucks,Atlanta Hawks,98,111,209,13,Atlanta Hawks,13,0.316,0.778,36,25,11,4,0.5,0.778,37,29,9,4
3067,21600608,Minnesota Timberwolves,Dallas Mavericks,87,98,185,11,Dallas Mavericks,11,0.238,0.667,44,20,7,1,0.414,0.737,41,21,8,8
3068,21600609,Houston Rockets,Brooklyn Nets,137,112,249,25,Houston Rockets,25,0.477,0.75,52,30,9,3,0.341,0.789,38,29,9,5
3069,21600610,Oklahoma City Thunder,Sacramento Kings,122,118,240,4,Oklahoma City Thunder,4,0.321,0.805,44,20,14,4,0.36,0.875,44,24,13,6
3070,21600611,Chicago Bulls,Memphis Grizzlies,108,104,212,4,Chicago Bulls,4,0.235,0.686,47,18,8,5,0.344,1,50,24,6,3
3071,21600612,Detroit Pistons,Los Angeles Lakers,102,97,199,5,Detroit Pistons,5,0.36,0.688,46,24,6,6,0.231,0.792,50,19,2,4
3072,21600613,Atlanta Hawks,New York Knicks,108,107,215,1,Atlanta Hawks,1,0.375,0.696,36,26,11,3,0.308,0.652,53,21,8,3
3073,21600614,Portland Trail Blazers,Washington Wizards,101,120,221,19,Washington Wizards,19,0.308,0.76,45,22,6,5,0.565,0.92,51,26,10,5
3074,21600615,Philadelphia 76ers,Milwaukee Bucks,113,104,217,9,Philadelphia 76ers,9,0.378,0.806,51,25,8,9,0.357,0.682,38,23,8,5
3075,21600616,New Orleans Pelicans,Indiana Pacers,95,98,193,3,Indiana Pacers,3,0.4,0.722,38,18,7,6,0.263,0.688,45,26,11,6
3076,21600617,Orlando Magic,Denver Nuggets,112,125,237,13,Denver Nuggets,13,0.32,0.778,34,28,6,1,0.333,0.8,39,33,11,3
3077,21600618,Charlotte Hornets,Boston Celtics,98,108,206,10,Boston Celtics,10,0.32,0.824,42,25,4,4,0.385,0.9,44,29,6,3
3078,21600619,Cleveland Cavaliers,Golden State Warriors,91,126,217,35,Golden State Warriors,35,0.265,0.741,35,11,7,4,0.441,0.792,58,37,10,11
3079,21600620,Utah Jazz,Phoenix Suns,106,101,207,5,Utah Jazz,5,0.348,0.667,46,22,4,6,0.227,0.941,39,13,4,5
3080,21600621,Oklahoma City Thunder,Los Angeles Clippers,98,120,218,22,Los Angeles Clippers,22,0.333,0.842,36,18,10,4,0.429,0.818,47,27,9,5
3081,21600622,Toronto Raptors,Brooklyn Nets,119,109,228,10,Toronto Raptors,10,0.526,0.813,44,18,8,6,0.269,0.917,41,20,7,6
3082,21600623,Houston Rockets,Miami Heat,103,109,212,6,Miami Heat,6,0.231,0.786,49,21,8,3,0.31,0.667,52,21,11,1
3083,21600624,Dallas Mavericks,Chicago Bulls,99,98,197,1,Dallas Mavericks,1,0.393,0.778,36,27,5,2,0.429,0.818,43,23,6,3
3084,21600625,Minnesota Timberwolves,San Antonio Spurs,114,122,236,8,San Antonio Spurs,8,0.462,0.878,39,26,5,6,0.444,0.8,34,27,9,3
3085,21600626,Denver Nuggets,Los Angeles Lakers,127,121,248,6,Denver Nuggets,6,0.423,0.615,45,29,5,9,0.367,0.889,43,28,11,5
3086,21600627,Toronto Raptors,Philadelphia 76ers,89,94,183,5,Philadelphia 76ers,5,0.25,0.652,43,17,10,2,0.333,0.75,46,20,5,7
3087,21600628,Memphis Grizzlies,Washington Wizards,101,104,205,3,Washington Wizards,3,0.32,0.794,45,20,8,1,0.276,0.923,45,27,7,3
3088,21600629,Portland Trail Blazers,Charlotte Hornets,85,107,192,22,Charlotte Hornets,22,0.258,1,50,18,10,12,0.423,0.824,51,28,11,7
3089,21600630,New York Knicks,Boston Celtics,117,106,223,11,New York Knicks,11,0.4,0.833,57,27,2,8,0.273,0.931,33,25,8,8
3090,21600631,Orlando Magic,New Orleans Pelicans,98,118,216,20,New Orleans Pelicans,20,0.344,0.818,47,18,6,5,0.417,0.733,45,28,11,5
3091,21600632,Milwaukee Bucks,Houston Rockets,92,111,203,19,Houston Rockets,19,0.25,0.786,50,26,8,8,0.318,0.733,46,25,9,12
3092,21600633,Atlanta Hawks,Detroit Pistons,95,118,213,23,Detroit Pistons,23,0.24,0.784,32,22,1,4,0.4,0.643,60,27,6,0
3093,21600634,Oklahoma City Thunder,Golden State Warriors,100,121,221,21,Golden State Warriors,21,0.286,0.842,36,23,11,6,0.476,0.704,46,35,11,8
3094,21600635,Indiana Pacers,Sacramento Kings,106,100,206,6,Indiana Pacers,6,0.333,0.84,32,22,11,3,0.429,0.778,36,28,9,5
3095,21600636,Phoenix Suns,Cleveland Cavaliers,103,118,221,15,Cleveland Cavaliers,15,0.211,0.806,46,23,10,4,0.452,0.684,36,29,7,6
3096,21600637,Dallas Mavericks,Miami Heat,95,99,194,4,Miami Heat,4,0.389,0.636,33,17,4,3,0.45,0.69,40,16,4,1
3097,21600638,Washington Wizards,New York Knicks,113,110,223,3,Washington Wizards,3,0.406,0.857,40,29,7,5,0.292,0.864,41,20,7,4
3098,21600639,Denver Nuggets,San Antonio Spurs,104,118,222,14,San Antonio Spurs,14,0.323,0.769,43,27,5,7,0.409,0.84,43,28,12,5
3099,21600640,Minnesota Timberwolves,Los Angeles Clippers,104,101,205,3,Minnesota Timberwolves,3,0.313,0.76,43,25,3,2,0.182,0.542,41,24,9,6
3100,21600641,Portland Trail Blazers,Philadelphia 76ers,92,93,185,1,Philadelphia 76ers,1,0.316,0.714,46,16,8,6,0.414,0.563,53,25,6,8
3101,21600642,Toronto Raptors,Charlotte Hornets,78,113,191,35,Charlotte Hornets,35,0.233,0.929,33,10,7,5,0.48,0.84,51,24,9,4
3102,21600643,Milwaukee Bucks,Orlando Magic,96,112,208,16,Orlando Magic,16,0.4,0.692,40,21,6,3,0.286,0.774,53,25,9,6
3103,21600644,Sacramento Kings,Memphis Grizzlies,91,107,198,16,Memphis Grizzlies,16,0.207,0.719,35,18,9,6,0.393,0.8,58,21,6,4
3104,21600645,Brooklyn Nets,New Orleans Pelicans,143,114,257,29,Brooklyn Nets,29,0.5,0.914,52,24,5,6,0.324,0.739,47,21,8,8
3105,21600646,Golden State Warriors,Houston Rockets,125,108,233,17,Golden State Warriors,17,0.395,0.762,41,30,8,7,0.2,0.833,41,26,8,3
3106,21600647,Chicago Bulls,Atlanta Hawks,93,102,195,9,Atlanta Hawks,9,0.25,0.947,41,18,12,5,0.409,0.789,40,23,16,3
3107,21600648,Utah Jazz,Dallas Mavericks,112,107,219,5,Utah Jazz,5,0.348,0.718,53,17,8,5,0.348,0.75,43,21,4,2
3108,21600649,Indiana Pacers,Los Angeles Lakers,95,108,203,13,Los Angeles Lakers,13,0.391,0.72,37,24,17,6,0.424,0.8,51,27,15,3
3109,21600650,Portland Trail Blazers,Boston Celtics,127,123,250,4,Portland Trail Blazers,4,0.4,0.861,37,26,12,4,0.371,0.839,47,26,6,2
3110,21600651,Washington Wizards,Detroit Pistons,112,113,225,1,Detroit Pistons,1,0.308,0.788,47,23,12,3,0.393,0.727,49,25,9,4
3111,21600652,Brooklyn Nets,Charlotte Hornets,105,112,217,7,Charlotte Hornets,7,0.415,0.8,40,30,9,3,0.467,0.909,46,26,7,4
3112,21600653,Philadelphia 76ers,Atlanta Hawks,93,110,203,17,Atlanta Hawks,17,0.414,0.833,39,27,8,6,0.35,0.565,47,24,8,5
3113,21600654,Phoenix Suns,New York Knicks,107,105,212,2,Phoenix Suns,2,0.375,0.889,44,15,9,4,0.524,0.875,46,20,6,3
3114,21600655,Milwaukee Bucks,Miami Heat,97,109,206,12,Miami Heat,12,0.333,0.781,41,17,6,2,0.433,0.636,39,18,8,3
3115,21600656,Houston Rockets,Memphis Grizzlies,119,95,214,24,Houston Rockets,24,0.381,0.84,46,27,11,6,0.265,0.714,41,19,10,4
3116,21600657,San Antonio Spurs,Cleveland Cavaliers,118,115,233,3,San Antonio Spurs,3,0.385,0.857,46,32,6,6,0.382,0.545,47,25,7,1
3117,21600658,Los Angeles Clippers,Denver Nuggets,98,123,221,25,Denver Nuggets,25,0.313,1,35,23,5,2,0.417,0.808,45,30,4,0
3118,21600659,Indiana Pacers,Utah Jazz,100,109,209,9,Utah Jazz,9,0.5,0.706,36,17,10,3,0.25,0.781,42,24,11,3
3119,21600660,Sacramento Kings,Chicago Bulls,99,102,201,3,Chicago Bulls,3,0.346,0.762,40,20,7,5,0.353,0.848,48,22,7,7
3120,21600661,Golden State Warriors,Orlando Magic,118,98,216,20,Golden State Warriors,20,0.452,0.789,52,27,8,4,0.25,0.438,41,25,9,7
3121,21600662,Los Angeles Lakers,Dallas Mavericks,73,122,195,49,Dallas Mavericks,49,0.143,0.824,32,11,3,4,0.436,1,49,27,9,4
3122,21600663,Phoenix Suns,Toronto Raptors,115,103,218,12,Phoenix Suns,12,0.409,0.929,45,20,6,1,0.259,0.857,35,19,9,8
3123,21600664,Denver Nuggets,Minnesota Timberwolves,108,111,219,3,Minnesota Timberwolves,3,0.292,0.81,41,26,6,7,0.4,0.714,36,29,11,8
3124,21600665,Washington Wizards,Charlotte Hornets,109,99,208,10,Washington Wizards,10,0.4,0.765,47,22,5,3,0.25,0.84,43,24,7,5
3125,21600666,San Antonio Spurs,Brooklyn Nets,112,86,198,26,San Antonio Spurs,26,0.409,0.813,50,22,7,5,0.2,0.944,38,14,2,5
3126,21600667,Los Angeles Clippers,Atlanta Hawks,115,105,220,10,Los Angeles Clippers,10,0.583,0.773,46,23,4,8,0.31,0.846,40,28,8,2
3127,21600668,Golden State Warriors,Miami Heat,102,105,207,3,Miami Heat,3,0.267,0.6,43,27,9,4,0.433,0.593,45,20,9,4
3128,21600669,Sacramento Kings,Detroit Pistons,109,104,213,5,Sacramento Kings,5,0.429,0.769,43,25,10,3,0.357,0.706,38,27,8,1
3129,21600670,Houston Rockets,Milwaukee Bucks,114,127,241,13,Milwaukee Bucks,13,0.4,0.786,28,26,11,4,0.478,0.815,37,31,17,6
3130,21600671,Cleveland Cavaliers,New Orleans Pelicans,122,124,246,2,New Orleans Pelicans,2,0.405,0.84,45,24,6,3,0.41,0.733,42,26,8,11
3131,21600672,New York Knicks,Indiana Pacers,109,103,212,6,New York Knicks,6,0.364,0.886,43,19,8,7,0.269,0.8,37,18,7,4
3132,21600673,Oklahoma City Thunder,Utah Jazz,97,95,192,2,Oklahoma City Thunder,2,0.3,0.76,45,17,6,6,0.238,0.692,42,16,10,7
3133,21600674,San Antonio Spurs,Toronto Raptors,108,106,214,2,San Antonio Spurs,2,0.292,0.758,36,20,7,6,0.24,0.857,45,10,9,8
3134,21600675,Los Angeles Clippers,Philadelphia 76ers,110,121,231,11,Philadelphia 76ers,11,0.529,0.634,46,17,4,1,0.345,0.955,38,35,8,7
3135,21600676,Boston Celtics,Washington Wizards,108,123,231,15,Washington Wizards,15,0.303,0.917,32,24,10,3,0.45,0.857,43,21,7,4
3136,21600677,Chicago Bulls,Orlando Magic,100,92,192,8,Chicago Bulls,8,0.318,0.767,44,12,13,6,0.318,0.75,48,18,7,2
3137,21600678,Utah Jazz,Denver Nuggets,93,103,196,10,Denver Nuggets,10,0.318,0.762,40,19,6,3,0.385,0.742,43,28,7,6
3138,21600679,Minnesota Timberwolves,Phoenix Suns,112,111,223,1,Minnesota Timberwolves,1,0.353,0.75,42,24,8,4,0.368,0.875,44,20,7,4
3139,21600680,Sacramento Kings,Cleveland Cavaliers,116,112,228,4,Sacramento Kings,4,0.355,0.864,47,29,13,3,0.395,0.5,47,29,9,6
3140,21600681,Houston Rockets,Boston Celtics,109,120,229,11,Boston Celtics,11,0.323,0.711,30,28,8,5,0.344,0.938,48,33,10,3
3141,21600682,Miami Heat,Brooklyn Nets,109,106,215,3,Miami Heat,3,0.478,0.72,40,23,7,6,0.371,0.885,33,20,3,4
3142,21600683,Atlanta Hawks,Chicago Bulls,119,114,233,5,Atlanta Hawks,5,0.567,0.842,39,29,5,5,0.296,0.769,41,18,6,5
3143,21600684,Philadelphia 76ers,Milwaukee Bucks,114,109,223,5,Philadelphia 76ers,5,0.462,0.88,43,32,9,4,0.25,0.783,37,26,11,4
3144,21600685,Toronto Raptors,Memphis Grizzlies,99,101,200,2,Memphis Grizzlies,2,0.294,0.579,45,16,6,4,0.455,0.76,45,18,3,7
3145,21600686,Oklahoma City Thunder,New Orleans Pelicans,114,105,219,9,Oklahoma City Thunder,9,0.37,0.714,55,24,6,11,0.407,0.632,46,23,7,9
3146,21600687,Golden State Warriors,Charlotte Hornets,113,103,216,10,Golden State Warriors,10,0.393,0.889,41,23,7,14,0.304,0.952,43,26,6,6
3147,21600688,New York Knicks,Dallas Mavericks,95,103,198,8,Dallas Mavericks,8,0.304,0.833,55,17,4,2,0.231,0.792,36,19,10,7
3148,21600689,Los Angeles Lakers,Portland Trail Blazers,98,105,203,7,Portland Trail Blazers,7,0.367,0.929,51,16,5,9,0.267,0.75,49,17,5,4
3149,21600690,Dallas Mavericks,Oklahoma City Thunder,98,109,207,11,Oklahoma City Thunder,11,0.423,0.846,36,17,10,2,0.409,0.722,43,13,7,2
3150,21600691,Indiana Pacers,Minnesota Timberwolves,109,103,212,6,Indiana Pacers,6,0.556,0.882,44,21,7,4,0.37,0.778,34,27,13,5
3151,21600692,Phoenix Suns,Denver Nuggets,120,127,247,7,Denver Nuggets,7,0.417,0.824,28,21,8,2,0.391,0.857,46,29,5,6
3152,21600693,Los Angeles Lakers,Utah Jazz,88,96,184,8,Utah Jazz,8,0.286,0.923,48,13,5,2,0.231,0.857,44,13,7,6
3153,21600694,Houston Rockets,Philadelphia 76ers,123,118,241,5,Houston Rockets,5,0.387,0.964,41,25,10,4,0.4,0.75,29,29,14,6
3154,21600695,Brooklyn Nets,Cleveland Cavaliers,116,124,240,8,Cleveland Cavaliers,8,0.485,0.875,37,23,9,2,0.361,0.65,47,26,4,5
3155,21600696,Sacramento Kings,Indiana Pacers,111,115,226,4,Indiana Pacers,4,0.52,0.778,43,22,7,1,0.357,0.879,29,19,14,4
3156,21600697,Orlando Magic,Boston Celtics,98,128,226,30,Boston Celtics,30,0.36,0.722,38,29,7,2,0.471,0.8,47,39,8,5
3157,21600698,Milwaukee Bucks,Toronto Raptors,86,102,188,16,Toronto Raptors,16,0.304,0.708,43,19,6,7,0.4,0.783,47,20,9,10
3158,21600699,Charlotte Hornets,New York Knicks,107,110,217,3,New York Knicks,3,0.351,0.933,47,18,5,4,0.333,0.692,48,22,8,9
3159,21600700,Miami Heat,Chicago Bulls,100,88,188,12,Miami Heat,12,0.375,0.818,40,25,14,2,0.231,0.76,43,19,7,9
3160,21600701,San Antonio Spurs,New Orleans Pelicans,103,119,222,16,New Orleans Pelicans,16,0.429,0.862,44,20,10,4,0.433,0.714,53,29,8,6
3161,21600702,Washington Wizards,Atlanta Hawks,112,86,198,26,Washington Wizards,26,0.419,0.684,52,26,12,10,0.29,0.68,41,18,9,8
3162,21600703,Memphis Grizzlies,Portland Trail Blazers,109,112,221,3,Portland Trail Blazers,3,0.346,0.788,42,24,6,5,0.457,0.952,33,24,2,3
3163,21600704,Sacramento Kings,Charlotte Hornets,109,106,215,3,Sacramento Kings,3,0.407,0.615,38,27,6,5,0.324,0.917,34,24,4,7
3164,21600705,Detroit Pistons,Miami Heat,103,116,219,13,Miami Heat,13,0.333,0.583,42,11,6,3,0.5,0.783,38,18,6,6
3165,21600706,Boston Celtics,Milwaukee Bucks,112,108,220,4,Boston Celtics,4,0.341,0.8,44,26,6,7,0.429,0.781,47,23,6,6
3166,21600707,Los Angeles Clippers,Golden State Warriors,98,144,242,46,Golden State Warriors,46,0.429,0.636,32,24,7,2,0.5,0.813,48,35,9,7
3167,21600708,Memphis Grizzlies,Utah Jazz,102,95,197,7,Memphis Grizzlies,7,0.423,0.9,31,13,8,1,0.4,0.931,31,19,3,4
3168,21600709,Denver Nuggets,Phoenix Suns,123,112,235,11,Denver Nuggets,11,0.32,0.881,48,17,7,3,0.286,0.75,43,20,9,3
3169,21600710,Brooklyn Nets,Minnesota Timberwolves,109,129,238,20,Minnesota Timberwolves,20,0.333,0.8,40,20,6,6,0.45,0.813,49,27,8,8
3170,21600711,New York Knicks,Atlanta Hawks,139,142,281,3,Atlanta Hawks,3,0.353,0.826,63,32,9,11,0.323,0.7,64,36,4,2
3171,21600712,Oklahoma City Thunder,Cleveland Cavaliers,91,107,198,16,Cleveland Cavaliers,16,0.231,0.688,55,20,5,4,0.276,0.773,51,22,9,6
3172,21600713,Houston Rockets,Indiana Pacers,101,120,221,19,Indiana Pacers,19,0.282,0.88,41,21,7,6,0.238,0.808,42,28,9,7
3173,21600714,Washington Wizards,New Orleans Pelicans,107,94,201,13,Washington Wizards,13,0.476,0.7,45,28,9,3,0.313,0.533,42,25,8,3
3174,21600715,Orlando Magic,Toronto Raptors,114,113,227,1,Orlando Magic,1,0.435,0.769,36,25,6,6,0.429,0.806,40,19,8,3
3175,21600716,Philadelphia 76ers,Chicago Bulls,108,121,229,13,Chicago Bulls,13,0.357,0.714,43,26,8,8,0.571,0.821,49,29,8,5
3176,21600717,Dallas Mavericks,San Antonio Spurs,105,101,206,4,Dallas Mavericks,4,0.353,0.938,41,20,6,5,0.364,0.652,45,26,2,4
3177,21600718,Golden State Warriors,Portland Trail Blazers,113,111,224,2,Golden State Warriors,2,0.308,0.846,39,28,13,6,0.37,0.75,42,26,11,2
3178,21600719,Brooklyn Nets,Miami Heat,96,104,200,8,Miami Heat,8,0.154,0.818,53,16,7,4,0.423,0.652,34,22,9,8
3179,21600720,Orlando Magic,Minnesota Timberwolves,105,111,216,6,Minnesota Timberwolves,6,0.286,0.684,48,22,7,3,0.414,0.731,50,29,3,11
3180,21600721,Detroit Pistons,Boston Celtics,109,113,222,4,Boston Celtics,4,0.111,0.69,51,18,6,7,0.406,0.848,44,23,6,5
3181,21600722,Cleveland Cavaliers,Dallas Mavericks,97,104,201,7,Dallas Mavericks,7,0.375,0.714,42,17,6,3,0.281,0.944,40,19,11,2
3182,21600723,Memphis Grizzlies,Phoenix Suns,115,96,211,19,Memphis Grizzlies,19,0.571,0.875,44,25,13,2,0.263,0.744,42,11,8,8
3183,21600724,New York Knicks,Washington Wizards,101,117,218,16,Washington Wizards,16,0.208,0.8,51,18,8,2,0.318,0.8,46,27,4,4
3184,21600725,New Orleans Pelicans,Toronto Raptors,106,108,214,2,Toronto Raptors,2,0.4,0.737,47,17,11,7,0.323,0.8,54,19,5,6
3185,21600726,Sacramento Kings,Houston Rockets,83,105,188,22,Houston Rockets,22,0.276,0.577,45,22,9,7,0.311,0.682,60,28,4,4
3186,21600727,Oklahoma City Thunder,San Antonio Spurs,94,108,202,14,San Antonio Spurs,14,0.25,0.844,50,21,12,7,0.333,0.711,50,16,12,13
3187,21600728,Charlotte Hornets,Portland Trail Blazers,98,115,213,17,Portland Trail Blazers,17,0.355,0.84,42,20,3,6,0.355,0.87,51,23,8,2
3188,21600729,Denver Nuggets,Los Angeles Lakers,116,120,236,4,Los Angeles Lakers,4,0.556,0.826,51,26,12,5,0.462,0.778,44,25,7,10
3189,21600730,Indiana Pacers,Orlando Magic,98,88,186,10,Indiana Pacers,10,0.45,0.885,38,25,5,1,0.25,0.714,35,17,12,3
3190,21600731,Minnesota Timberwolves,Cleveland Cavaliers,97,125,222,28,Cleveland Cavaliers,28,0.333,0.8,38,26,7,3,0.405,0.636,48,37,10,10
3191,21600732,Toronto Raptors,Boston Celtics,104,109,213,5,Boston Celtics,5,0.258,0.56,41,17,6,5,0.333,0.833,39,24,6,2
3192,21600733,New York Knicks,Brooklyn Nets,95,90,185,5,New York Knicks,5,0.222,0.613,58,23,16,7,0.2,0.688,49,17,4,7
3193,21600734,Atlanta Hawks,Miami Heat,93,116,209,23,Miami Heat,23,0.269,0.857,43,13,10,6,0.375,0.737,47,23,10,11
3194,21600735,New Orleans Pelicans,Detroit Pistons,98,118,216,20,Detroit Pistons,20,0.238,0.786,35,21,6,5,0.385,0.706,42,28,9,0
3195,21600736,Philadelphia 76ers,Dallas Mavericks,95,113,208,18,Dallas Mavericks,18,0.273,0.731,39,21,5,2,0.385,0.821,51,22,10,4
3196,21600737,Memphis Grizzlies,Denver Nuggets,119,99,218,20,Memphis Grizzlies,20,0.467,0.75,46,28,6,4,0.36,0.743,45,25,7,2
3197,21600738,Milwaukee Bucks,Utah Jazz,88,104,192,16,Utah Jazz,16,0.391,0.6,39,19,10,7,0.379,0.778,46,22,11,2
3198,21600739,Los Angeles Clippers,Phoenix Suns,124,114,238,10,Los Angeles Clippers,10,0.263,0.816,46,20,9,8,0.35,0.829,44,21,5,3
3199,21600740,Chicago Bulls,Oklahoma City Thunder,128,100,228,28,Chicago Bulls,28,0.4,0.8,42,25,7,2,0.27,0.824,37,17,6,4
3200,21600741,Charlotte Hornets,Golden State Warriors,111,126,237,15,Golden State Warriors,15,0.29,0.923,45,33,4,3,0.438,0.786,47,35,9,13
3201,21600742,Los Angeles Lakers,Washington Wizards,108,116,224,8,Washington Wizards,8,0.308,0.727,47,19,6,8,0.364,0.762,45,27,11,6
3202,21600743,Atlanta Hawks,Houston Rockets,113,108,221,5,Atlanta Hawks,5,0.267,0.739,56,26,8,5,0.255,0.758,37,19,11,4
3203,21600744,Philadelphia 76ers,San Antonio Spurs,86,102,188,16,San Antonio Spurs,16,0.36,0.739,46,21,10,5,0.286,0.741,59,26,13,9
3204,21600745,Golden State Warriors,Los Angeles Clippers,133,120,253,13,Golden State Warriors,13,0.412,0.833,46,38,10,2,0.4,0.769,37,24,7,7
3205,21600746,Toronto Raptors,Orlando Magic,94,102,196,8,Orlando Magic,8,0.357,0.762,44,15,5,5,0.357,0.719,46,22,4,7
3206,21600747,Indiana Pacers,Brooklyn Nets,106,97,203,9,Indiana Pacers,9,0.4,0.774,49,20,11,10,0.393,0.957,44,20,7,4
3207,21600748,Minnesota Timberwolves,Detroit Pistons,108,116,224,8,Detroit Pistons,8,0.294,0.789,40,25,5,6,0.423,0.773,49,24,7,4
3208,21600749,Chicago Bulls,Houston Rockets,117,121,238,4,Houston Rockets,4,0.32,0.722,53,30,7,7,0.372,0.68,48,24,7,3
3209,21600750,Memphis Grizzlies,Oklahoma City Thunder,102,114,216,12,Oklahoma City Thunder,12,0.158,0.864,29,21,10,5,0.5,0.758,47,21,7,3
3210,21600751,Los Angeles Lakers,Boston Celtics,107,113,220,6,Boston Celtics,6,0.368,0.731,52,24,9,3,0.371,0.786,47,28,8,1
3211,21600752,Milwaukee Bucks,Denver Nuggets,117,121,238,4,Denver Nuggets,4,0.375,0.783,38,26,9,13,0.321,0.727,48,31,8,5
3212,21600753,Phoenix Suns,Sacramento Kings,105,103,208,2,Phoenix Suns,2,0.414,0.829,39,11,7,3,0.37,0.773,43,23,5,4
3213,21600754,Dallas Mavericks,Portland Trail Blazers,108,104,212,4,Dallas Mavericks,4,0.548,0.826,36,15,3,4,0.3,0.75,44,16,3,4
3214,21600755,New Orleans Pelicans,Washington Wizards,91,105,196,14,Washington Wizards,14,0.294,0.545,42,18,4,6,0.323,0.864,46,20,10,6
3215,21600756,Orlando Magic,Atlanta Hawks,86,113,199,27,Atlanta Hawks,27,0.259,0.893,33,17,8,4,0.357,0.778,48,28,8,2
3216,21600757,Detroit Pistons,Indiana Pacers,84,105,189,21,Indiana Pacers,21,0.353,0.8,43,18,2,6,0.292,0.667,41,22,11,4
3217,21600758,Philadelphia 76ers,Miami Heat,102,125,227,23,Miami Heat,23,0.261,0.839,33,20,10,1,0.545,0.739,49,28,6,5
3218,21600759,Cleveland Cavaliers,New York Knicks,111,104,215,7,Cleveland Cavaliers,7,0.4,0.722,49,20,3,0,0.387,0.5,42,23,9,7
3219,21600760,Charlotte Hornets,Utah Jazz,98,105,203,7,Utah Jazz,7,0.394,0.833,38,20,7,3,0.394,0.667,51,16,5,4
3220,21600761,Milwaukee Bucks,Phoenix Suns,137,112,249,25,Milwaukee Bucks,25,0.412,0.743,44,29,9,11,0.393,0.833,40,22,9,3
3221,21600762,Denver Nuggets,San Antonio Spurs,97,121,218,24,San Antonio Spurs,24,0.385,0.5,42,22,7,1,0.476,0.808,38,29,13,8
3222,21600763,Memphis Grizzlies,Minnesota Timberwolves,107,99,206,8,Memphis Grizzlies,8,0.357,0.846,42,17,7,3,0.385,0.792,45,22,4,3
3223,21600764,Golden State Warriors,Sacramento Kings,106,109,215,3,Sacramento Kings,3,0.341,0.792,40,22,10,10,0.304,0.842,46,25,11,4
3224,21600765,Toronto Raptors,Brooklyn Nets,103,95,198,8,Toronto Raptors,8,0.263,0.9,45,21,8,4,0.382,0.857,42,19,8,7
3225,21600766,Los Angeles Clippers,Boston Celtics,102,107,209,5,Boston Celtics,5,0.345,0.786,46,22,4,0,0.308,0.85,45,24,9,3
3226,21600767,Portland Trail Blazers,Oklahoma City Thunder,99,105,204,6,Oklahoma City Thunder,6,0.357,0.905,44,15,6,4,0.222,0.75,56,18,9,5
3227,21600768,Los Angeles Lakers,New York Knicks,121,107,228,14,Los Angeles Lakers,14,0.286,0.806,55,19,9,5,0.333,0.788,40,16,4,4
3228,21600769,Cleveland Cavaliers,Washington Wizards,140,135,275,5,Cleveland Cavaliers,5,0.5,0.821,46,31,7,2,0.414,0.885,43,29,9,5
3229,21600770,Oklahoma City Thunder,Indiana Pacers,90,93,183,3,Indiana Pacers,3,0.25,0.714,61,17,6,11,0.308,0.655,37,19,7,10
3230,21600771,Los Angeles Clippers,Toronto Raptors,109,118,227,9,Toronto Raptors,9,0.371,0.667,39,24,7,5,0.417,0.897,47,20,6,1
3231,21600772,Utah Jazz,Atlanta Hawks,120,95,215,25,Utah Jazz,25,0.385,0.667,44,31,9,7,0.353,0.719,30,16,6,3
3232,21600773,Philadelphia 76ers,Detroit Pistons,96,113,209,17,Detroit Pistons,17,0.179,0.679,41,19,8,0,0.227,0.941,60,22,8,4
3233,21600774,Phoenix Suns,New Orleans Pelicans,106,111,217,5,New Orleans Pelicans,5,0.185,0.84,49,26,7,10,0.346,0.818,48,20,11,11
3234,21600775,Miami Heat,Minnesota Timberwolves,115,113,228,2,Miami Heat,2,0.536,0.714,38,27,5,5,0.455,0.786,34,25,13,1
3235,21600776,Dallas Mavericks,Denver Nuggets,87,110,197,23,Denver Nuggets,23,0.308,0.647,29,25,8,3,0.393,0.938,49,28,7,10
3236,21600777,San Antonio Spurs,Memphis Grizzlies,74,89,163,15,Memphis Grizzlies,15,0.211,0.556,44,11,8,6,0.211,0.84,50,18,8,11
3237,21600778,Chicago Bulls,Sacramento Kings,112,107,219,5,Chicago Bulls,5,0.316,0.645,35,21,10,3,0.393,0.875,40,27,4,5
3238,21600779,Brooklyn Nets,Charlotte Hornets,107,111,218,4,Charlotte Hornets,4,0.333,0.81,45,26,3,8,0.269,0.828,51,19,6,7
3239,21600780,Orlando Magic,Houston Rockets,104,128,232,24,Houston Rockets,24,0.24,0.7,47,28,7,4,0.421,0.667,42,31,9,2
3240,21600781,Portland Trail Blazers,Dallas Mavericks,114,113,227,1,Portland Trail Blazers,1,0.393,0.792,55,17,6,2,0.429,0.844,30,16,6,6
3241,21600782,San Antonio Spurs,Philadelphia 76ers,111,103,214,8,San Antonio Spurs,8,0.5,0.88,48,24,2,6,0.382,0.759,35,23,8,2
3242,21600783,Cleveland Cavaliers,Indiana Pacers,132,117,249,15,Cleveland Cavaliers,15,0.444,0.923,39,24,7,5,0.52,0.846,38,24,7,2
3243,21600784,Washington Wizards,Brooklyn Nets,114,110,224,4,Washington Wizards,4,0.36,0.758,54,21,9,5,0.273,0.694,55,20,6,5
3244,21600785,Denver Nuggets,Atlanta Hawks,106,117,223,11,Atlanta Hawks,11,0.295,0.619,49,25,8,4,0.296,0.833,48,31,6,4
3245,21600786,Los Angeles Lakers,Detroit Pistons,102,121,223,19,Detroit Pistons,19,0.261,0.846,41,21,7,3,0.25,0.625,52,32,11,6
3246,21600787,Miami Heat,Milwaukee Bucks,106,88,194,18,Miami Heat,18,0.333,0.722,48,23,5,5,0.4,0.571,33,18,10,4
3247,21600788,Phoenix Suns,Memphis Grizzlies,91,110,201,19,Memphis Grizzlies,19,0.217,0.824,46,13,12,5,0.583,0.765,41,24,6,8
3248,21600789,Utah Jazz,New Orleans Pelicans,127,94,221,33,Utah Jazz,33,0.438,0.81,48,25,9,2,0.208,0.76,37,17,6,6
3249,21600790,Toronto Raptors,Minnesota Timberwolves,109,112,221,3,Minnesota Timberwolves,3,0.393,0.7,36,19,6,3,0.368,0.9,36,22,8,3
3250,21600791,Los Angeles Clippers,New York Knicks,119,115,234,4,Los Angeles Clippers,4,0.4,0.679,47,22,8,3,0.296,0.833,41,25,9,5
3251,21600792,Chicago Bulls,Golden State Warriors,92,123,215,31,Golden State Warriors,31,0.167,0.737,44,25,7,2,0.536,0.923,45,37,9,5
3252,21600793,Boston Celtics,Sacramento Kings,92,108,200,16,Sacramento Kings,16,0.313,0.889,39,18,8,2,0.4,0.933,40,24,11,1
3253,21600794,Houston Rockets,Charlotte Hornets,107,95,202,12,Houston Rockets,12,0.325,0.8,42,22,13,5,0.308,0.929,47,26,8,5
3254,21600795,Philadelphia 76ers,Orlando Magic,112,111,223,1,Philadelphia 76ers,1,0.393,0.778,45,25,13,5,0.476,0.792,47,27,4,8
3255,21600796,Cleveland Cavaliers,Oklahoma City Thunder,109,118,227,9,Oklahoma City Thunder,9,0.476,0.767,35,14,9,6,0.296,0.769,51,24,10,5
3256,21600797,Utah Jazz,Dallas Mavericks,105,112,217,7,Dallas Mavericks,7,0.448,0.824,43,26,8,3,0.25,0.76,37,21,12,3
3257,21600798,Boston Celtics,Portland Trail Blazers,120,111,231,9,Boston Celtics,9,0.333,0.815,43,23,8,1,0.346,0.774,41,23,4,6
3258,21600799,Miami Heat,Brooklyn Nets,108,99,207,9,Miami Heat,9,0.304,0.905,46,16,11,7,0.4,0.75,48,19,4,6
3259,21600800,Denver Nuggets,New York Knicks,131,123,254,8,Denver Nuggets,8,0.5,0.7,44,30,6,5,0.421,0.6,33,36,10,5
3260,21600801,San Antonio Spurs,Detroit Pistons,103,92,195,11,San Antonio Spurs,11,0.474,0.8,52,27,4,5,0.294,0.692,35,22,8,3
3261,21600802,Los Angeles Lakers,Milwaukee Bucks,122,114,236,8,Los Angeles Lakers,8,0.484,0.829,33,25,9,3,0.286,0.839,34,27,11,5
3262,21600803,Golden State Warriors,Memphis Grizzlies,122,107,229,15,Golden State Warriors,15,0.455,0.763,34,31,14,13,0.346,0.811,47,20,6,4
3263,21600804,New Orleans Pelicans,Minnesota Timberwolves,122,106,228,16,New Orleans Pelicans,16,0.48,0.741,43,27,8,3,0.222,0.75,34,22,11,0
3264,21600805,Indiana Pacers,Washington Wizards,107,112,219,5,Washington Wizards,5,0.19,0.867,42,29,3,5,0.345,0.667,46,29,8,4
3265,21600806,Atlanta Hawks,Sacramento Kings,107,108,215,1,Sacramento Kings,1,0.367,0.774,37,19,6,5,0.5,0.667,39,27,12,2
3266,21600807,Chicago Bulls,Phoenix Suns,97,115,212,18,Phoenix Suns,18,0.263,0.818,41,20,7,5,0.421,0.846,43,25,4,8
3267,21600808,Los Angeles Clippers,Charlotte Hornets,107,102,209,5,Los Angeles Clippers,5,0.412,0.65,50,26,3,6,0.351,0.75,40,24,6,4
3268,21600809,Milwaukee Bucks,Indiana Pacers,116,100,216,16,Milwaukee Bucks,16,0.548,0.784,37,28,7,6,0.455,0.833,36,19,2,6
3269,21600810,Miami Heat,Philadelphia 76ers,109,117,226,8,Philadelphia 76ers,8,0.292,0.857,49,15,4,4,0.36,0.789,38,27,15,8
3270,21600811,Denver Nuggets,Cleveland Cavaliers,109,125,234,16,Cleveland Cavaliers,16,0.324,0.864,45,23,8,4,0.5,0.818,45,30,9,3
3271,21600812,Phoenix Suns,Houston Rockets,102,133,235,31,Houston Rockets,31,0.364,0.769,42,20,8,4,0.5,0.795,55,27,8,4
3272,21600813,Golden State Warriors,Oklahoma City Thunder,130,114,244,16,Golden State Warriors,16,0.419,0.714,40,28,10,3,0.25,0.778,43,20,7,8
3273,21600814,Orlando Magic,Dallas Mavericks,80,112,192,32,Dallas Mavericks,32,0.13,0.722,40,16,8,5,0.486,0.833,51,32,10,3
3274,21600815,Boston Celtics,Utah Jazz,112,104,216,8,Boston Celtics,8,0.433,0.652,37,20,6,4,0.258,0.867,39,16,9,2
3275,21600816,Chicago Bulls,Minnesota Timberwolves,89,117,206,28,Minnesota Timberwolves,28,0.4,0.692,35,22,7,2,0.25,0.885,46,27,11,4
3276,21600817,San Antonio Spurs,New York Knicks,90,94,184,4,New York Knicks,4,0.207,0.818,46,17,11,1,0.643,0.81,44,18,5,8
3277,21600818,Detroit Pistons,Toronto Raptors,102,101,203,1,Detroit Pistons,1,0.258,0.759,41,12,8,5,0.5,0.68,38,18,4,5
3278,21600819,New Orleans Pelicans,Sacramento Kings,99,105,204,6,Sacramento Kings,6,0.419,0.857,36,23,10,2,0.355,0.889,46,23,11,5
3279,21600820,Oklahoma City Thunder,Washington Wizards,98,120,218,22,Washington Wizards,22,0.206,0.767,47,16,10,2,0.65,0.821,40,27,4,9
3280,21600821,Philadelphia 76ers,Charlotte Hornets,105,99,204,6,Philadelphia 76ers,6,0.364,0.647,51,24,9,5,0.355,0.769,33,19,11,5
3281,21600822,Memphis Grizzlies,Brooklyn Nets,112,103,215,9,Memphis Grizzlies,9,0.409,0.926,41,25,7,1,0.324,0.833,32,23,8,0
3282,21600823,Orlando Magic,Miami Heat,116,107,223,9,Orlando Magic,9,0.571,0.69,52,18,9,3,0.273,0.852,37,14,7,7
3283,21600824,Detroit Pistons,Milwaukee Bucks,89,102,191,13,Milwaukee Bucks,13,0.333,0.737,44,17,4,1,0.286,1,33,26,9,2
3284,21600825,San Antonio Spurs,Indiana Pacers,110,106,216,4,San Antonio Spurs,4,0.467,0.852,49,18,7,4,0.45,0.7,37,21,8,3
3285,21600826,Boston Celtics,Dallas Mavericks,111,98,209,13,Boston Celtics,13,0.471,0.833,41,28,5,3,0.333,0.76,37,21,7,2
3286,21600827,Golden State Warriors,Denver Nuggets,110,132,242,22,Denver Nuggets,22,0.25,0.923,27,25,12,6,0.585,0.75,52,34,6,1
3287,21600828,Los Angeles Clippers,Utah Jazz,88,72,160,16,Los Angeles Clippers,16,0.36,0.636,49,16,7,7,0.174,0.667,49,14,5,4
3288,21600829,New Orleans Pelicans,Phoenix Suns,110,108,218,2,New Orleans Pelicans,2,0.286,0.8,37,19,8,5,0.348,0.833,43,14,7,3
3289,21600830,Atlanta Hawks,Portland Trail Blazers,109,104,213,5,Atlanta Hawks,5,0.286,0.771,52,20,9,11,0.381,0.56,66,22,4,4
3290,21600831,Toronto Raptors,Chicago Bulls,94,105,199,11,Chicago Bulls,11,0.25,0.792,34,15,9,1,0.412,0.8,37,22,8,5
3291,21600832,Cleveland Cavaliers,Minnesota Timberwolves,116,108,224,8,Cleveland Cavaliers,8,0.333,0.682,43,27,3,4,0.391,0.789,41,27,6,2
3292,21600833,Sacramento Kings,Los Angeles Lakers,97,96,193,1,Sacramento Kings,1,0.292,0.72,38,23,9,3,0.414,0.533,43,22,10,3
3293,21600834,San Antonio Spurs,Orlando Magic,107,79,186,28,San Antonio Spurs,28,0.258,0.789,50,25,12,8,0.222,0.789,33,15,5,5
3294,21600835,Indiana Pacers,Cleveland Cavaliers,104,113,217,9,Cleveland Cavaliers,9,0.5,0.857,43,30,2,1,0.462,0.895,40,23,6,2
3295,21600836,Philadelphia 76ers,Boston Celtics,108,116,224,8,Boston Celtics,8,0.258,0.667,47,23,16,5,0.464,0.75,39,21,13,4
3296,21600837,Charlotte Hornets,Toronto Raptors,85,90,175,5,Toronto Raptors,5,0.342,0.889,44,21,9,6,0.375,0.737,46,19,8,4
3297,21600838,Milwaukee Bucks,Brooklyn Nets,129,125,254,4,Milwaukee Bucks,4,0.467,0.688,39,27,16,3,0.389,0.826,42,30,7,8
3298,21600839,Dallas Mavericks,Detroit Pistons,91,98,189,7,Detroit Pistons,7,0.27,1,39,22,10,2,0.316,0.909,55,15,2,4
3299,21600840,New Orleans Pelicans,Memphis Grizzlies,95,91,186,4,New Orleans Pelicans,4,0.444,0.591,38,18,10,5,0.182,0.76,48,22,8,3
3300,21600841,Miami Heat,Houston Rockets,117,109,226,8,Miami Heat,8,0.371,0.667,46,27,3,7,0.325,0.774,41,22,6,1
3301,21600842,Minnesota Timberwolves,Denver Nuggets,112,99,211,13,Minnesota Timberwolves,13,0.333,0.857,45,20,12,4,0.324,0.667,49,25,4,5
3302,21600843,Portland Trail Blazers,Utah Jazz,88,111,199,23,Utah Jazz,23,0.409,0.75,41,14,9,3,0.5,0.696,46,19,9,5
3303,21600844,Los Angeles Lakers,Phoenix Suns,101,137,238,36,Phoenix Suns,36,0.346,0.786,36,16,9,3,0.417,0.853,59,32,7,10
3304,21600845,New York Knicks,Oklahoma City Thunder,105,116,221,11,Oklahoma City Thunder,11,0.524,0.857,39,19,8,12,0.522,0.71,48,21,10,4
3305,21600846,Atlanta Hawks,Los Angeles Clippers,84,99,183,15,Los Angeles Clippers,15,0.269,0.684,45,20,5,1,0.378,0.917,40,24,18,3
3306,21600847,Sacramento Kings,Golden State Warriors,86,109,195,23,Golden State Warriors,23,0.292,0.765,50,23,4,6,0.361,0.667,46,32,10,10
3307,21600848,Washington Wizards,Indiana Pacers,111,98,209,13,Washington Wizards,13,0.517,0.667,39,23,5,3,0.222,0.778,35,21,7,1
3308,21600849,Boston Celtics,Chicago Bulls,103,104,207,1,Chicago Bulls,1,0.378,0.85,31,24,2,4,0.24,1,51,23,2,6
3309,21600850,Portland Trail Blazers,Orlando Magic,112,103,215,9,Portland Trail Blazers,9,0.5,0.778,45,20,8,7,0.318,0.718,40,18,8,4
3310,21600851,Charlotte Hornets,Detroit Pistons,108,114,222,6,Detroit Pistons,6,0.233,0.962,50,19,5,7,0.405,0.917,57,29,5,2
3311,21600852,Houston Rockets,New Orleans Pelicans,129,99,228,30,Houston Rockets,30,0.392,0.792,48,28,12,5,0.194,0.808,44,24,10,8
3312,21600853,New York Knicks,Cleveland Cavaliers,104,119,223,15,Cleveland Cavaliers,15,0.308,0.706,50,24,4,7,0.395,0.8,44,29,5,10
3313,21600854,Los Angeles Clippers,Golden State Warriors,113,123,236,10,Golden State Warriors,10,0.393,0.703,38,23,11,0,0.52,0.923,53,31,11,11
3314,21600855,Denver Nuggets,Sacramento Kings,100,116,216,16,Sacramento Kings,16,0.343,0.714,43,23,10,2,0.5,0.895,46,26,8,4
3315,21600856,Washington Wizards,Philadelphia 76ers,112,120,232,8,Philadelphia 76ers,8,0.208,0.775,43,19,8,6,0.345,0.8,48,28,9,7
3316,21600857,Memphis Grizzlies,Indiana Pacers,92,102,194,10,Indiana Pacers,10,0.333,0.565,39,20,11,5,0.423,1,50,23,8,7
3317,21600858,Boston Celtics,Toronto Raptors,97,107,204,10,Toronto Raptors,10,0.316,0.864,36,19,4,3,0.333,0.759,41,15,7,4
3318,21600859,Phoenix Suns,Chicago Bulls,121,128,249,7,Chicago Bulls,7,0.333,0.6,43,27,8,6,0.462,0.774,46,31,14,4
3319,21600860,Utah Jazz,Milwaukee Bucks,109,95,204,14,Utah Jazz,14,0.348,0.9,41,23,8,5,0.389,0.828,35,15,5,1
3320,21600861,Los Angeles Lakers,Oklahoma City Thunder,93,110,203,17,Oklahoma City Thunder,17,0.2,0.429,51,23,15,8,0.417,0.706,59,28,9,6
3321,21600862,Dallas Mavericks,Minnesota Timberwolves,84,97,181,13,Minnesota Timberwolves,13,0.242,0.667,35,16,9,5,0.385,0.714,44,24,9,4
3322,21600863,Miami Heat,Atlanta Hawks,108,90,198,18,Miami Heat,18,0.459,0.846,54,30,7,5,0.3,0.667,45,14,7,6
3323,21600864,Brooklyn Nets,Denver Nuggets,109,129,238,20,Denver Nuggets,20,0.333,0.548,42,27,7,4,0.452,0.708,51,32,11,2
3324,21600865,San Antonio Spurs,Los Angeles Clippers,105,97,202,8,San Antonio Spurs,8,0.346,0.867,51,23,9,7,0.304,0.833,36,18,9,2
3325,21600866,Charlotte Hornets,Sacramento Kings,99,85,184,14,Charlotte Hornets,14,0.368,0.944,50,26,10,3,0.393,0.8,41,18,3,6
3326,21600867,Atlanta Hawks,Orlando Magic,86,105,191,19,Orlando Magic,19,0.32,0.538,48,21,4,4,0.296,0.958,47,21,11,8
3327,21600868,Philadelphia 76ers,New York Knicks,109,110,219,1,New York Knicks,1,0.226,0.815,50,19,6,5,0.286,0.783,44,21,6,7
3328,21600869,Indiana Pacers,Miami Heat,95,113,208,18,Miami Heat,18,0.333,0.885,43,21,8,4,0.419,0.774,43,23,9,5
3329,21600870,New Orleans Pelicans,Dallas Mavericks,83,96,179,13,Dallas Mavericks,13,0.208,0.64,45,21,7,2,0.462,0.75,43,24,12,4
3330,21600871,Chicago Bulls,Cleveland Cavaliers,117,99,216,18,Chicago Bulls,18,0.5,0.625,47,34,6,0,0.378,0.733,40,24,5,3
3331,21600872,Minnesota Timberwolves,Houston Rockets,130,142,272,12,Houston Rockets,12,0.346,0.821,58,28,10,2,0.379,0.762,32,32,15,6
3332,21600873,Brooklyn Nets,Golden State Warriors,95,112,207,17,Golden State Warriors,17,0.286,0.647,52,25,8,3,0.355,0.773,52,30,10,11
3333,21600874,San Antonio Spurs,Los Angeles Lakers,119,98,217,21,San Antonio Spurs,21,0.476,0.846,46,37,12,5,0.318,0.611,44,16,8,2
3334,21600875,Phoenix Suns,Milwaukee Bucks,96,100,196,4,Milwaukee Bucks,4,0.357,0.688,42,26,12,5,0.3,0.889,33,26,10,6
3335,21600876,Memphis Grizzlies,Denver Nuggets,105,98,203,7,Memphis Grizzlies,7,0.333,0.88,49,21,9,2,0.324,0.765,39,26,9,3
3336,21600877,Utah Jazz,Washington Wizards,102,92,194,10,Utah Jazz,10,0.458,0.719,50,18,10,11,0.364,0.769,28,21,16,1
3337,21600878,Portland Trail Blazers,Toronto Raptors,106,112,218,6,Toronto Raptors,6,0.429,0.771,39,16,6,5,0.35,0.778,39,16,7,5
3338,21600879,Boston Celtics,Detroit Pistons,104,98,202,6,Boston Celtics,6,0.343,0.8,52,22,9,1,0.364,0.457,45,22,8,4
3339,21600880,New Orleans Pelicans,Oklahoma City Thunder,110,118,228,8,Oklahoma City Thunder,8,0.381,0.811,35,17,10,1,0.286,0.757,53,17,4,0
3340,21600881,Charlotte Hornets,Los Angeles Clippers,121,124,245,3,Los Angeles Clippers,3,0.45,0.9,43,16,1,1,0.313,0.706,47,27,14,3
3341,21600882,Toronto Raptors,New York Knicks,92,91,183,1,Toronto Raptors,1,0.269,0.826,41,12,9,3,0.375,0.842,40,17,10,6
3342,21600883,Golden State Warriors,Philadelphia 76ers,119,108,227,11,Golden State Warriors,11,0.207,0.846,45,31,14,4,0.294,0.889,42,24,11,3
3343,21600884,Milwaukee Bucks,Cleveland Cavaliers,95,102,197,7,Cleveland Cavaliers,7,0.367,0.625,33,27,3,5,0.357,0.846,45,20,4,2
3344,21600885,Atlanta Hawks,Boston Celtics,114,98,212,16,Atlanta Hawks,16,0.24,0.8,55,22,10,10,0.294,0.8,40,21,9,7
3345,21600886,Indiana Pacers,Houston Rockets,117,108,225,9,Indiana Pacers,9,0.433,0.88,55,29,7,5,0.222,0.81,39,22,8,5
3346,21600887,Miami Heat,Dallas Mavericks,89,96,185,7,Dallas Mavericks,7,0.346,0.462,45,21,11,4,0.5,0.913,42,18,5,2
3347,21600888,Minnesota Timberwolves,Sacramento Kings,102,88,190,14,Minnesota Timberwolves,14,0.348,0.7,52,25,11,7,0.353,0.667,42,23,6,4
3348,21600889,Golden State Warriors,Washington Wizards,108,112,220,4,Washington Wizards,4,0.276,0.815,41,28,10,6,0.429,0.9,46,29,11,6
3349,21600890,Portland Trail Blazers,Detroit Pistons,113,120,233,7,Detroit Pistons,7,0.4,0.682,50,25,5,5,0.28,0.742,48,23,13,2
3350,21600891,Denver Nuggets,Chicago Bulls,125,107,232,18,Denver Nuggets,18,0.433,0.917,45,26,6,2,0.385,0.9,35,26,10,3
3351,21600892,Phoenix Suns,Memphis Grizzlies,112,130,242,18,Memphis Grizzlies,18,0.333,0.792,32,22,6,5,0.48,0.759,39,24,6,3
3352,21600893,Utah Jazz,Oklahoma City Thunder,106,109,215,3,Oklahoma City Thunder,3,0.409,0.846,33,22,8,4,0.682,0.696,42,20,5,7
3353,21600894,Charlotte Hornets,Los Angeles Lakers,109,104,213,5,Charlotte Hornets,5,0.41,0.708,45,25,3,5,0.375,0.769,39,22,9,5
3354,21600895,New York Knicks,Orlando Magic,101,90,191,11,New York Knicks,11,0.276,0.806,50,21,9,3,0.2,0.773,43,11,3,3
3355,21600896,Washington Wizards,Toronto Raptors,105,96,201,9,Washington Wizards,9,0.36,0.842,44,32,6,6,0.35,0.885,50,11,8,4
3356,21600897,Dallas Mavericks,Atlanta Hawks,95,100,195,5,Atlanta Hawks,5,0.424,0.846,33,22,10,5,0.476,0.75,34,24,12,4
3357,21600898,Philadelphia 76ers,Miami Heat,98,125,223,27,Miami Heat,27,0.353,0.818,40,16,7,4,0.433,0.667,42,24,9,12
3358,21600899,Denver Nuggets,Milwaukee Bucks,110,98,208,12,Denver Nuggets,12,0.303,0.9,45,21,8,2,0.5,0.867,34,26,8,5
3359,21600900,Detroit Pistons,New Orleans Pelicans,86,109,195,23,New Orleans Pelicans,23,0.13,0.176,50,13,11,3,0.36,0.957,53,18,6,4
3360,21600901,Cleveland Cavaliers,Boston Celtics,99,103,202,4,Boston Celtics,4,0.303,0.682,41,20,3,5,0.419,0.783,47,28,4,6
3361,21600902,Indiana Pacers,San Antonio Spurs,99,100,199,1,San Antonio Spurs,1,0.304,0.72,41,22,13,1,0.31,0.875,36,20,8,7
3362,21600903,Minnesota Timberwolves,Utah Jazz,107,80,187,27,Minnesota Timberwolves,27,0.5,0.808,48,23,11,7,0.211,0.545,46,18,6,5
3363,21600904,Houston Rockets,Los Angeles Clippers,122,103,225,19,Houston Rockets,19,0.385,0.848,62,21,3,2,0.353,0.538,36,26,8,3
3364,21600905,Brooklyn Nets,Sacramento Kings,109,100,209,9,Brooklyn Nets,9,0.393,0.833,43,16,8,2,0.5,0.864,38,12,8,3
3365,21600906,Golden State Warriors,Chicago Bulls,87,94,181,7,Chicago Bulls,7,0.2,0.929,41,23,10,6,0.263,0.81,49,19,9,5
3366,21600907,Charlotte Hornets,Phoenix Suns,103,120,223,17,Phoenix Suns,17,0.294,0.821,34,19,14,1,0.368,0.84,42,30,8,7
3367,21600908,Oklahoma City Thunder,Portland Trail Blazers,109,114,223,5,Portland Trail Blazers,5,0.379,0.938,40,11,9,7,0.4,0.743,45,19,9,7
3368,21600909,New York Knicks,Philadelphia 76ers,102,105,207,3,Philadelphia 76ers,3,0.333,0.879,41,14,10,3,0.321,0.774,50,20,5,9
3369,21600910,Toronto Raptors,Washington Wizards,114,106,220,8,Toronto Raptors,8,0.44,0.778,51,16,5,9,0.333,0.875,45,23,8,6
3370,21600911,Miami Heat,Orlando Magic,99,110,209,11,Orlando Magic,11,0.286,0.84,46,20,7,5,0.294,0.789,47,27,7,6
3371,21600912,Los Angeles Clippers,Milwaukee Bucks,101,112,213,11,Milwaukee Bucks,11,0.421,0.583,38,23,4,1,0.4,0.933,25,35,11,4
3372,21600913,Cleveland Cavaliers,Atlanta Hawks,135,130,265,5,Cleveland Cavaliers,5,0.543,0.8,33,31,7,5,0.385,0.733,43,30,7,4
3373,21600914,Memphis Grizzlies,Dallas Mavericks,100,104,204,4,Dallas Mavericks,4,0.321,0.682,39,16,4,0,0.185,0.778,45,23,5,3
3374,21600915,Brooklyn Nets,Utah Jazz,97,112,209,15,Utah Jazz,15,0.233,0.75,42,12,6,3,0.462,0.706,45,25,7,5
3375,21600916,Oklahoma City Thunder,Phoenix Suns,111,118,229,7,Phoenix Suns,7,0.257,0.8,47,14,10,5,0.238,0.806,45,28,10,7
3376,21600917,San Antonio Spurs,New Orleans Pelicans,101,98,199,3,San Antonio Spurs,3,0.222,0.6,53,20,6,4,0.32,0.833,48,20,2,2
3377,21600918,Boston Celtics,Los Angeles Lakers,115,95,210,20,Boston Celtics,20,0.303,0.76,46,30,7,2,0.25,0.75,34,23,11,7
3378,21600919,Detroit Pistons,Philadelphia 76ers,136,106,242,30,Detroit Pistons,30,0.435,0.857,44,26,11,10,0.412,0.857,36,30,5,2
3379,21600920,Toronto Raptors,Milwaukee Bucks,94,101,195,7,Milwaukee Bucks,7,0.333,0.85,36,20,2,4,0.222,0.826,42,16,3,4
3380,21600921,Cleveland Cavaliers,Miami Heat,92,120,212,28,Miami Heat,28,0.407,0.611,33,20,4,1,0.529,0.833,48,20,6,4
3381,21600922,Los Angeles Clippers,Chicago Bulls,101,91,192,10,Los Angeles Clippers,10,0.24,0.813,37,20,7,5,0.353,0.75,45,26,11,0
3382,21600923,Charlotte Hornets,Denver Nuggets,112,102,214,10,Charlotte Hornets,10,0.593,0.824,43,25,8,6,0.3,0.84,45,21,5,3
3383,21600924,Memphis Grizzlies,Houston Rockets,108,123,231,15,Houston Rockets,15,0.286,0.667,46,26,8,6,0.429,0.75,43,25,10,4
3384,21600925,Minnesota Timberwolves,San Antonio Spurs,90,97,187,7,San Antonio Spurs,7,0.25,0.727,55,24,6,3,0.25,0.625,49,16,10,8
3385,21600926,Brooklyn Nets,Portland Trail Blazers,116,130,246,14,Portland Trail Blazers,14,0.467,0.706,31,24,7,6,0.64,0.727,37,29,9,6
3386,21600927,Indiana Pacers,Atlanta Hawks,97,96,193,1,Indiana Pacers,1,0.455,0.571,44,24,6,4,0.333,0.613,44,21,12,1
3387,21600928,Golden State Warriors,New York Knicks,112,105,217,7,Golden State Warriors,7,0.371,0.826,35,21,11,3,0.318,0.8,47,18,5,6
3388,21600929,Boston Celtics,Phoenix Suns,106,109,215,3,Phoenix Suns,3,0.351,0.725,54,19,6,6,0.2,0.808,50,16,7,10
3389,21600930,Orlando Magic,Washington Wizards,114,115,229,1,Washington Wizards,1,0.4,0.632,43,16,9,3,0.538,0.92,38,26,9,6
3390,21600931,Utah Jazz,Sacramento Kings,110,109,219,1,Utah Jazz,1,0.303,0.667,47,24,8,3,0.471,0.75,37,24,8,3
3391,21600932,Oklahoma City Thunder,Dallas Mavericks,89,104,193,15,Dallas Mavericks,15,0.091,0.7,49,19,4,2,0.28,0.813,37,24,6,2
3392,21600933,New Orleans Pelicans,Los Angeles Lakers,105,97,202,8,New Orleans Pelicans,8,0.375,0.686,44,23,12,5,0.357,0.733,49,22,7,5
3393,21600934,Milwaukee Bucks,Philadelphia 76ers,112,98,210,14,Milwaukee Bucks,14,0.424,0.8,41,28,7,7,0.267,0.632,42,30,5,3
3394,21600935,New York Knicks,Orlando Magic,113,105,218,8,New York Knicks,8,0.429,0.964,45,26,6,1,0.281,0.667,42,23,4,5
3395,21600936,Miami Heat,Cleveland Cavaliers,106,98,204,8,Miami Heat,8,0.457,0.857,38,23,7,6,0.333,0.655,52,15,3,6
3396,21600937,Golden State Warriors,Atlanta Hawks,119,111,230,8,Golden State Warriors,8,0.455,0.773,43,33,10,4,0.464,0.71,47,19,6,6
3397,21600938,Chicago Bulls,Detroit Pistons,95,109,204,14,Detroit Pistons,14,0.286,0.905,37,21,3,5,0.286,0.65,48,26,7,3
3398,21600939,Brooklyn Nets,Memphis Grizzlies,122,109,231,13,Brooklyn Nets,13,0.467,0.789,41,16,12,5,0.4,0.795,37,23,7,2
3399,21600940,Portland Trail Blazers,Minnesota Timberwolves,109,110,219,1,Minnesota Timberwolves,1,0.344,0.88,35,24,7,9,0.444,0.857,44,26,3,5
3400,21600941,Indiana Pacers,Charlotte Hornets,88,100,188,12,Charlotte Hornets,12,0.4,0.667,41,29,3,5,0.355,0.905,50,21,10,2
3401,21600942,Houston Rockets,San Antonio Spurs,110,112,222,2,San Antonio Spurs,2,0.359,0.824,43,19,3,3,0.393,0.913,44,24,6,6
3402,21600943,Sacramento Kings,Denver Nuggets,96,108,204,12,Denver Nuggets,12,0.375,0.857,40,20,9,1,0.433,0.75,40,28,11,2
3403,21600944,New Orleans Pelicans,Utah Jazz,83,88,171,5,Utah Jazz,5,0.303,0.722,47,16,11,3,0.37,0.8,46,16,10,2
3404,21600945,Boston Celtics,Los Angeles Clippers,102,116,218,14,Los Angeles Clippers,14,0.286,0.828,37,22,9,2,0.45,0.617,47,23,7,5
3405,21600946,Portland Trail Blazers,Oklahoma City Thunder,126,121,247,5,Portland Trail Blazers,5,0.478,0.778,36,24,7,5,0.4,0.767,39,16,4,1
3406,21600947,Los Angeles Lakers,Dallas Mavericks,111,122,233,11,Dallas Mavericks,11,0.367,0.727,44,25,9,3,0.548,0.789,41,25,5,5
3407,21600948,Washington Wizards,Phoenix Suns,131,127,258,4,Washington Wizards,4,0.389,0.792,44,19,15,4,0.481,0.788,49,23,5,8
3408,21600949,Chicago Bulls,Orlando Magic,91,98,189,7,Orlando Magic,7,0.429,0.636,44,24,3,4,0.28,0.81,48,21,10,4
3409,21600950,Brooklyn Nets,Atlanta Hawks,105,110,215,5,Atlanta Hawks,5,0.333,0.8,40,28,7,11,0.2,0.75,47,19,12,7
3410,21600951,Charlotte Hornets,Miami Heat,101,108,209,7,Miami Heat,7,0.333,0.952,39,14,7,8,0.415,0.708,46,22,8,7
3411,21600952,New York Knicks,Milwaukee Bucks,93,104,197,11,Milwaukee Bucks,11,0.333,0.667,43,22,4,6,0.308,0.786,46,26,9,4
3412,21600953,Toronto Raptors,New Orleans Pelicans,94,87,181,7,Toronto Raptors,7,0.381,0.609,42,21,6,6,0.31,0.769,40,22,6,3
3413,21600954,Utah Jazz,Houston Rockets,115,108,223,7,Utah Jazz,7,0.387,0.875,45,21,2,4,0.25,0.75,31,22,9,4
3414,21600955,Los Angeles Clippers,Minnesota Timberwolves,91,107,198,16,Minnesota Timberwolves,16,0.375,0.667,36,18,9,3,0.25,0.9,50,26,10,4
3415,21600956,Detroit Pistons,Indiana Pacers,98,115,213,17,Indiana Pacers,17,0.269,0.591,45,20,4,4,0.478,0.842,46,27,3,2
3416,21600957,Sacramento Kings,San Antonio Spurs,104,114,218,10,San Antonio Spurs,10,0.368,0.813,42,20,7,3,0.483,0.762,43,33,9,5
3417,21600958,Washington Wizards,Denver Nuggets,123,113,236,10,Washington Wizards,10,0.423,0.632,43,31,10,0,0.464,0.471,39,31,6,2
3418,21600959,Boston Celtics,Golden State Warriors,99,86,185,13,Boston Celtics,13,0.345,0.789,45,28,12,1,0.2,0.667,46,23,8,12
3419,21600960,Cleveland Cavaliers,Detroit Pistons,101,106,207,5,Detroit Pistons,5,0.282,0.632,42,24,4,1,0.346,0.789,45,22,6,1
3420,21600961,Los Angeles Clippers,Memphis Grizzlies,114,98,212,16,Los Angeles Clippers,16,0.367,0.821,47,24,2,4,0.35,0.773,34,26,6,2
3421,21600962,San Antonio Spurs,Oklahoma City Thunder,92,102,194,10,Oklahoma City Thunder,10,0.316,0.8,41,15,8,8,0.3,0.667,48,23,10,3
3422,21600963,Philadelphia 76ers,Portland Trail Blazers,108,114,222,6,Portland Trail Blazers,6,0.379,0.75,44,18,10,3,0.286,0.848,55,25,8,12
3423,21600964,Los Angeles Lakers,Phoenix Suns,122,110,232,12,Los Angeles Lakers,12,0.444,0.667,42,21,11,7,0.316,0.8,54,20,7,10
3424,21600965,Orlando Magic,Charlotte Hornets,81,121,202,40,Charlotte Hornets,40,0.185,0.636,31,19,4,2,0.476,0.85,43,34,6,5
3425,21600966,Houston Rockets,Chicago Bulls,115,94,209,21,Houston Rockets,21,0.319,0.813,54,26,11,4,0.231,0.75,49,24,9,4
3426,21600967,Indiana Pacers,Milwaukee Bucks,85,99,184,14,Milwaukee Bucks,14,0.111,0.773,36,15,14,3,0.412,0.867,34,17,13,6
3427,21600968,Golden State Warriors,Minnesota Timberwolves,102,103,205,1,Minnesota Timberwolves,1,0.292,0.765,43,25,9,5,0.286,0.778,46,21,6,3
3428,21600969,Toronto Raptors,Atlanta Hawks,99,105,204,6,Atlanta Hawks,6,0.16,0.778,46,19,17,5,0.364,0.655,45,24,8,6
3429,21600970,Boston Celtics,Denver Nuggets,99,119,218,20,Denver Nuggets,20,0.364,0.826,34,19,11,2,0.387,0.773,50,24,11,4
3430,21600971,Brooklyn Nets,Dallas Mavericks,96,105,201,9,Dallas Mavericks,9,0.29,0.826,35,23,9,2,0.424,0.893,47,16,5,0
3431,21600972,Washington Wizards,Sacramento Kings,130,122,252,8,Washington Wizards,8,0.346,0.895,52,29,7,5,0.522,0.786,40,27,5,1
3432,21600973,Utah Jazz,Oklahoma City Thunder,104,112,216,8,Oklahoma City Thunder,8,0.45,0.821,36,15,9,2,0.348,0.75,43,23,7,7
3433,21600974,Philadelphia 76ers,Los Angeles Clippers,100,112,212,12,Los Angeles Clippers,12,0.333,0.714,41,28,11,1,0.32,0.828,41,25,13,3
3434,21600975,New York Knicks,Detroit Pistons,92,112,204,20,Detroit Pistons,20,0.433,0.636,44,26,4,7,0.333,0.579,51,27,14,6
3435,21600976,New Orleans Pelicans,Charlotte Hornets,125,122,247,3,New Orleans Pelicans,3,0.412,0.688,47,33,4,4,0.283,0.85,50,32,5,1
3436,21600977,Cleveland Cavaliers,Orlando Magic,116,104,220,12,Cleveland Cavaliers,12,0.385,0.6,52,30,1,6,0.19,0.857,52,17,6,1
3437,21600978,Minnesota Timberwolves,Milwaukee Bucks,95,102,197,7,Milwaukee Bucks,7,0.385,0.762,38,21,4,4,0.4,0.87,40,19,5,6
3438,21600979,Toronto Raptors,Miami Heat,89,104,193,15,Miami Heat,15,0.133,0.84,48,7,6,5,0.393,0.697,35,21,8,10
3439,21600980,Golden State Warriors,San Antonio Spurs,85,107,192,22,San Antonio Spurs,22,0.294,0.609,49,19,10,4,0.444,0.833,46,27,6,7
3440,21600981,Atlanta Hawks,Memphis Grizzlies,107,90,197,17,Atlanta Hawks,17,0.5,0.769,46,22,9,6,0.172,0.739,41,22,11,3
3441,21600982,Phoenix Suns,Dallas Mavericks,100,98,198,2,Phoenix Suns,2,0.286,0.9,40,18,5,7,0.346,0.917,48,17,2,4
3442,21600983,Washington Wizards,Portland Trail Blazers,125,124,249,1,Washington Wizards,1,0.48,0.679,46,27,5,4,0.5,0.75,43,26,4,5
3443,21600984,Denver Nuggets,Sacramento Kings,105,92,197,13,Denver Nuggets,13,0.265,0.889,44,21,8,8,0.348,0.6,41,24,4,2
3444,21600985,Chicago Bulls,Boston Celtics,80,100,180,20,Boston Celtics,20,0.28,0.778,40,18,13,3,0.432,1,51,22,14,5
3445,21600986,New York Knicks,Brooklyn Nets,112,120,232,8,Brooklyn Nets,8,0.348,0.813,43,22,5,8,0.5,0.724,55,23,7,3
3446,21600987,Miami Heat,Indiana Pacers,98,102,200,4,Indiana Pacers,4,0.281,0.688,54,18,4,4,0.333,0.844,46,12,2,4
3447,21600988,Portland Trail Blazers,Phoenix Suns,110,101,211,9,Portland Trail Blazers,9,0.318,0.68,49,14,7,5,0.357,0.7,41,20,5,3
3448,21600989,Cleveland Cavaliers,Houston Rockets,112,117,229,5,Houston Rockets,5,0.395,0.846,38,24,3,7,0.356,0.679,52,25,10,4
3449,21600990,Philadelphia 76ers,Los Angeles Lakers,118,116,234,2,Philadelphia 76ers,2,0.417,0.813,34,28,8,4,0.2,0.857,40,24,10,10
3450,21600991,Chicago Bulls,Charlotte Hornets,115,109,224,6,Chicago Bulls,6,0.35,0.864,50,29,6,5,0.241,0.842,44,25,4,3
3451,21600992,Dallas Mavericks,Toronto Raptors,78,100,178,22,Toronto Raptors,22,0.28,0.692,34,21,4,6,0.36,0.944,55,19,7,6
3452,21600993,Milwaukee Bucks,Memphis Grizzlies,93,113,206,20,Memphis Grizzlies,20,0.538,0.85,32,21,6,5,0.519,0.739,37,30,11,0
3453,21600994,Atlanta Hawks,San Antonio Spurs,99,107,206,8,San Antonio Spurs,8,0.273,0.633,36,27,13,3,0.471,0.765,44,31,6,9
3454,21600995,Washington Wizards,Minnesota Timberwolves,104,119,223,15,Minnesota Timberwolves,15,0.269,0.806,38,15,10,2,0.476,0.864,46,27,8,7
3455,21600996,Los Angeles Clippers,Utah Jazz,108,114,222,6,Utah Jazz,6,0.4,0.783,28,16,4,2,0.667,0.818,42,22,1,3
3456,21600997,Orlando Magic,Sacramento Kings,115,120,235,5,Sacramento Kings,5,0.382,1,44,32,10,4,0.533,0.762,41,24,8,6
3457,21600998,Los Angeles Lakers,Denver Nuggets,101,129,230,28,Denver Nuggets,28,0.3,0.579,46,17,10,3,0.447,0.88,42,36,9,7
3458,21600999,Detroit Pistons,Cleveland Cavaliers,96,128,224,32,Cleveland Cavaliers,32,0.211,0.947,45,20,6,1,0.633,0.739,41,29,4,3
3459,21601000,Oklahoma City Thunder,Brooklyn Nets,122,104,226,18,Oklahoma City Thunder,18,0.455,0.706,44,30,13,6,0.5,0.867,32,20,6,6
3460,21601001,Indiana Pacers,New York Knicks,81,87,168,6,New York Knicks,6,0.276,0.6,53,16,6,3,0.321,0.615,52,21,8,4
3461,21601002,Portland Trail Blazers,New Orleans Pelicans,77,100,177,23,New Orleans Pelicans,23,0.344,0.769,48,13,3,1,0.286,0.6,49,19,10,8
3462,21601003,Philadelphia 76ers,Golden State Warriors,104,106,210,2,Golden State Warriors,2,0.296,0.667,52,28,10,10,0.438,0.8,43,24,12,11
3463,21601004,Dallas Mavericks,Washington Wizards,112,107,219,5,Dallas Mavericks,5,0.438,0.72,40,24,5,1,0.4,0.714,42,30,4,1
3464,21601005,Charlotte Hornets,Indiana Pacers,77,98,175,21,Indiana Pacers,21,0.13,0.769,30,15,9,4,0.429,0.889,42,26,8,6
3465,21601006,Minnesota Timberwolves,Boston Celtics,104,117,221,13,Boston Celtics,13,0.296,0.8,42,26,4,1,0.394,0.857,37,34,2,5
3466,21601007,New Orleans Pelicans,Miami Heat,112,120,232,8,Miami Heat,8,0.409,0.679,38,21,9,5,0.457,0.842,45,23,9,3
3467,21601008,Utah Jazz,Detroit Pistons,97,83,180,14,Utah Jazz,14,0.464,0.75,43,28,6,5,0.231,0.667,39,14,6,4
3468,21601009,Memphis Grizzlies,Chicago Bulls,98,91,189,7,Memphis Grizzlies,7,0.355,0.833,52,26,2,3,0.393,0.8,45,22,6,6
3469,21601010,Los Angeles Lakers,Houston Rockets,100,139,239,39,Houston Rockets,39,0.12,0.722,38,16,10,0,0.419,0.656,50,37,13,4
3470,21601011,Portland Trail Blazers,San Antonio Spurs,110,106,216,4,Portland Trail Blazers,4,0.409,0.893,39,21,10,1,0.423,0.733,41,28,7,5
3471,21601012,Sacramento Kings,Phoenix Suns,107,101,208,6,Sacramento Kings,6,0.429,0.735,48,22,8,11,0.24,0.643,47,24,9,11
3472,21601013,Milwaukee Bucks,Los Angeles Clippers,97,96,193,1,Milwaukee Bucks,1,0.345,0.76,36,22,8,2,0.208,0.724,42,23,3,4
3473,21601014,Utah Jazz,Cleveland Cavaliers,83,91,174,8,Cleveland Cavaliers,8,0.238,0.714,47,18,6,3,0.273,0.526,52,14,6,2
3474,21601015,Oklahoma City Thunder,Toronto Raptors,123,102,225,21,Oklahoma City Thunder,21,0.56,0.789,47,33,10,1,0.25,0.767,32,15,10,10
3475,21601016,Brooklyn Nets,New York Knicks,121,110,231,11,Brooklyn Nets,11,0.313,0.829,51,19,5,2,0.167,0.962,34,20,6,4
3476,21601017,Memphis Grizzlies,Atlanta Hawks,103,91,194,12,Memphis Grizzlies,12,0.357,0.833,48,29,7,5,0.296,0.735,38,19,6,9
3477,21601018,Los Angeles Clippers,Denver Nuggets,114,129,243,15,Denver Nuggets,15,0.5,0.667,34,26,5,4,0.536,0.846,48,31,7,2
3478,21601019,Orlando Magic,Golden State Warriors,92,122,214,30,Golden State Warriors,30,0.259,0.714,49,15,7,4,0.385,0.522,47,36,14,9
3479,21601020,Dallas Mavericks,Philadelphia 76ers,74,116,190,42,Philadelphia 76ers,42,0.217,0.529,34,21,6,4,0.414,0.87,55,32,8,6
3480,21601021,Chicago Bulls,Washington Wizards,107,112,219,5,Washington Wizards,5,0.259,0.667,53,28,5,5,0.385,0.833,40,34,5,6
3481,21601022,Boston Celtics,Brooklyn Nets,98,95,193,3,Boston Celtics,3,0.241,0.793,51,20,7,6,0.314,0.8,41,23,7,7
3482,21601023,Toronto Raptors,Detroit Pistons,87,75,162,12,Toronto Raptors,12,0.333,0.9,53,19,5,2,0.15,0.667,49,14,5,5
3483,21601024,Houston Rockets,New Orleans Pelicans,112,128,240,16,New Orleans Pelicans,16,0.325,0.781,46,18,6,3,0.353,0.75,54,29,8,7
3484,21601025,Minnesota Timberwolves,Miami Heat,105,123,228,18,Miami Heat,18,0.167,0.955,28,14,6,6,0.308,0.789,40,29,6,9
3485,21601026,Orlando Magic,Phoenix Suns,109,103,212,6,Orlando Magic,6,0.304,0.857,43,21,10,4,0.143,0.833,49,18,9,8
3486,21601027,Milwaukee Bucks,Los Angeles Lakers,107,103,210,4,Milwaukee Bucks,4,0.167,0.767,43,22,7,9,0.379,0.615,40,24,7,4
3487,21601028,Sacramento Kings,Oklahoma City Thunder,94,110,204,16,Oklahoma City Thunder,16,0.238,0.826,35,16,9,2,0.385,0.72,49,23,7,4
3488,21601029,Portland Trail Blazers,Atlanta Hawks,113,97,210,16,Portland Trail Blazers,16,0.444,0.895,54,23,9,9,0.269,0.813,35,22,13,7
3489,21601030,Washington Wizards,Charlotte Hornets,93,98,191,5,Charlotte Hornets,5,0.333,0.774,44,21,6,7,0.375,0.704,41,23,8,8
3490,21601031,Cleveland Cavaliers,Los Angeles Clippers,78,108,186,30,Los Angeles Clippers,30,0.185,0.692,40,15,5,0,0.308,0.69,54,27,4,3
3491,21601032,Utah Jazz,Chicago Bulls,86,95,181,9,Chicago Bulls,9,0.28,0.68,49,15,6,8,0.368,0.857,39,24,7,9
3492,21601033,San Antonio Spurs,Memphis Grizzlies,96,104,200,8,Memphis Grizzlies,8,0.321,0.955,42,18,2,5,0.433,0.871,35,20,7,3
3493,21601034,Houston Rockets,Denver Nuggets,109,105,214,4,Houston Rockets,4,0.208,0.8,48,20,5,5,0.323,0.633,45,28,9,3
3494,21601035,Milwaukee Bucks,Golden State Warriors,92,117,209,25,Golden State Warriors,25,0.333,0.786,35,19,8,7,0.522,0.789,44,30,5,6
3495,21601036,Dallas Mavericks,Brooklyn Nets,111,104,215,7,Dallas Mavericks,7,0.4,0.76,33,20,8,3,0.419,0.763,41,16,2,1
3496,21601037,Boston Celtics,Philadelphia 76ers,99,105,204,6,Philadelphia 76ers,6,0.207,0.862,41,27,8,5,0.364,0.733,43,29,9,7
3497,21601038,Phoenix Suns,Detroit Pistons,95,112,207,17,Detroit Pistons,17,0.273,0.633,47,16,10,4,0.48,0.667,63,26,2,4
3498,21601039,Minnesota Timberwolves,New Orleans Pelicans,109,123,232,14,New Orleans Pelicans,14,0.36,0.706,35,30,11,6,0.467,0.733,43,31,7,2
3499,21601040,Indiana Pacers,Toronto Raptors,91,116,207,25,Toronto Raptors,25,0.261,0.731,33,22,7,2,0.444,0.875,51,25,7,7
3500,21601041,Portland Trail Blazers,Miami Heat,115,104,219,11,Portland Trail Blazers,11,0.5,0.75,43,13,4,6,0.3,0.65,39,18,8,8
3501,21601042,Sacramento Kings,San Antonio Spurs,102,118,220,16,San Antonio Spurs,16,0.7,0.765,40,29,4,4,0.393,0.778,45,31,9,3
3502,21601043,Cleveland Cavaliers,Los Angeles Lakers,125,120,245,5,Cleveland Cavaliers,5,0.361,0.815,44,19,4,2,0.407,0.789,40,23,5,1
3503,21601044,Atlanta Hawks,Charlotte Hornets,90,105,195,15,Charlotte Hornets,15,0.324,0.4,45,26,3,5,0.4,0.65,33,28,12,4
3504,21601045,Philadelphia 76ers,Orlando Magic,109,112,221,3,Orlando Magic,3,0.265,0.917,53,26,15,7,0.174,0.826,55,19,10,4
3505,21601046,Utah Jazz,Indiana Pacers,100,107,207,7,Indiana Pacers,7,0.24,0.7,49,20,5,11,0.5,0.913,43,21,9,9
3506,21601047,Washington Wizards,Boston Celtics,102,110,212,8,Boston Celtics,8,0.229,0.769,39,24,6,4,0.303,0.714,53,19,10,6
3507,21601048,Denver Nuggets,Houston Rockets,124,125,249,1,Houston Rockets,1,0.414,0.923,48,26,7,3,0.447,0.783,35,27,12,2
3508,21601049,Golden State Warriors,Oklahoma City Thunder,111,95,206,16,Golden State Warriors,16,0.455,0.762,46,28,8,8,0.19,0.548,40,18,10,2
3509,21601050,New York Knicks,Los Angeles Clippers,105,114,219,9,Los Angeles Clippers,9,0.25,0.792,48,24,6,1,0.323,0.75,43,25,8,4
3510,21601051,Chicago Bulls,Toronto Raptors,120,122,242,2,Toronto Raptors,2,0.378,0.815,39,25,9,10,0.348,0.741,50,18,6,4
3511,21601052,Detroit Pistons,Brooklyn Nets,96,98,194,2,Brooklyn Nets,2,0.217,0.688,51,17,8,8,0.345,0.632,46,22,1,6
3512,21601053,Phoenix Suns,Miami Heat,97,112,209,15,Miami Heat,15,0.25,0.724,41,14,5,5,0.407,0.739,49,17,13,5
3513,21601054,Memphis Grizzlies,New Orleans Pelicans,82,95,177,13,New Orleans Pelicans,13,0.257,0.692,41,17,7,3,0.31,0.842,51,16,8,3
3514,21601055,Golden State Warriors,Dallas Mavericks,112,87,199,25,Golden State Warriors,25,0.433,0.813,46,34,10,2,0.324,0.833,39,24,8,2
3515,21601056,San Antonio Spurs,Minnesota Timberwolves,100,93,193,7,San Antonio Spurs,7,0.333,0.818,33,22,12,5,0.467,0.88,39,20,10,2
3516,21601057,Milwaukee Bucks,Portland Trail Blazers,93,90,183,3,Milwaukee Bucks,3,0.438,0.833,49,16,8,8,0.19,0.615,49,15,8,6
3517,21601058,Los Angeles Clippers,Los Angeles Lakers,133,109,242,24,Los Angeles Clippers,24,0.455,0.875,48,23,4,4,0.3,0.63,41,23,8,3
3518,21601059,Charlotte Hornets,Orlando Magic,109,102,211,7,Charlotte Hornets,7,0.333,0.889,43,24,9,3,0.35,0.8,43,26,5,3
3519,21601060,Indiana Pacers,Boston Celtics,100,109,209,9,Boston Celtics,9,0.393,0.684,45,20,13,6,0.407,0.857,43,27,5,2
3520,21601061,Detroit Pistons,Chicago Bulls,95,117,212,22,Chicago Bulls,22,0.35,0.588,44,18,6,1,0.478,0.632,36,36,12,2
3521,21601062,Philadelphia 76ers,Oklahoma City Thunder,97,122,219,25,Oklahoma City Thunder,25,0.32,0.882,25,19,8,4,0.25,0.733,54,26,7,8
3522,21601063,Atlanta Hawks,Washington Wizards,100,104,204,4,Washington Wizards,4,0.32,0.828,44,20,11,5,0.324,0.739,54,23,9,6
3523,21601064,Cleveland Cavaliers,Denver Nuggets,113,126,239,13,Denver Nuggets,13,0.405,0.857,38,22,4,4,0.423,1,44,35,7,0
3524,21601065,Milwaukee Bucks,Sacramento Kings,116,98,214,18,Milwaukee Bucks,18,0.457,0.737,38,28,9,4,0.385,0.6,37,19,6,6
3525,21601066,New York Knicks,Utah Jazz,101,108,209,7,Utah Jazz,7,0.429,0.889,36,19,5,1,0.25,0.655,48,18,5,7
3526,21601067,Phoenix Suns,Brooklyn Nets,98,126,224,28,Brooklyn Nets,28,0.28,0.676,50,16,14,3,0.276,0.762,61,25,11,5
3527,21601068,Toronto Raptors,Miami Heat,101,84,185,17,Toronto Raptors,17,0.261,0.781,51,10,9,3,0.261,0.609,36,20,8,11
3528,21601069,Los Angeles Clippers,Dallas Mavericks,95,97,192,2,Dallas Mavericks,2,0.333,0.667,45,18,6,2,0.346,0.667,34,26,11,4
3529,21601070,Memphis Grizzlies,San Antonio Spurs,90,97,187,7,San Antonio Spurs,7,0.345,0.8,42,18,4,4,0.308,0.652,35,26,6,5
3530,21601071,New York Knicks,Portland Trail Blazers,95,110,205,15,Portland Trail Blazers,15,0.227,0.9,40,23,5,9,0.524,0.724,50,15,8,2
3531,21601072,Brooklyn Nets,Washington Wizards,108,129,237,21,Washington Wizards,21,0.2,0.731,38,24,5,4,0.385,0.955,46,29,9,5
3532,21601073,Cleveland Cavaliers,Charlotte Hornets,112,105,217,7,Cleveland Cavaliers,7,0.36,0.875,38,26,6,5,0.263,0.792,42,18,6,4
3533,21601074,Detroit Pistons,Orlando Magic,87,115,202,28,Orlando Magic,28,0.091,0.85,50,21,3,3,0.462,0.692,47,36,4,6
3534,21601075,Denver Nuggets,Indiana Pacers,125,117,242,8,Denver Nuggets,8,0.259,0.93,45,23,8,4,0.542,0.727,39,19,9,8
3535,21601076,Phoenix Suns,Boston Celtics,120,130,250,10,Boston Celtics,10,0.316,0.735,49,23,9,3,0.341,0.8,50,31,8,5
3536,21601077,Philadelphia 76ers,Chicago Bulls,117,107,224,10,Philadelphia 76ers,10,0.32,0.739,46,23,10,4,0.417,0.742,39,22,9,5
3537,21601078,Atlanta Hawks,Milwaukee Bucks,97,100,197,3,Milwaukee Bucks,3,0.364,0.875,49,20,5,3,0.296,0.875,35,27,10,6
3538,21601079,New Orleans Pelicans,Houston Rockets,107,117,224,10,Houston Rockets,10,0.368,0.786,36,28,9,7,0.359,0.75,59,29,5,3
3539,21601080,Minnesota Timberwolves,Los Angeles Lakers,119,130,249,11,Los Angeles Lakers,11,0.333,0.909,37,32,13,10,0.609,0.857,42,26,6,2
3540,21601081,Sacramento Kings,Golden State Warriors,100,114,214,14,Golden State Warriors,14,0.476,0.769,37,27,7,4,0.323,0.889,44,37,14,8
3541,21601082,Utah Jazz,Los Angeles Clippers,95,108,203,13,Los Angeles Clippers,13,0.308,0.722,43,22,5,3,0.259,0.893,47,14,9,5
3542,21601083,Washington Wizards,Cleveland Cavaliers,127,115,242,12,Washington Wizards,12,0.444,0.808,40,24,10,4,0.364,0.778,32,24,6,6
3543,21601084,Toronto Raptors,Dallas Mavericks,94,86,180,8,Toronto Raptors,8,0.429,0.778,44,22,9,3,0.25,0.85,40,20,10,4
3544,21601085,New York Knicks,San Antonio Spurs,98,106,204,8,San Antonio Spurs,8,0.3,0.867,45,24,6,5,0.4,0.75,50,28,11,6
3545,21601086,Minnesota Timberwolves,Portland Trail Blazers,100,112,212,12,Portland Trail Blazers,12,0.2,0.75,27,15,10,3,0.5,0.647,35,24,5,3
3546,21601087,Phoenix Suns,Charlotte Hornets,106,120,226,14,Charlotte Hornets,14,0.375,0.818,39,25,6,3,0.467,0.917,41,29,8,2
3547,21601088,Brooklyn Nets,Atlanta Hawks,107,92,199,15,Brooklyn Nets,15,0.273,0.833,50,21,13,7,0.185,0.594,58,16,10,3
3548,21601089,Sacramento Kings,Los Angeles Clippers,98,97,195,1,Sacramento Kings,1,0.464,0.692,46,23,5,4,0.345,0.821,45,20,7,2
3549,21601090,Chicago Bulls,Milwaukee Bucks,109,94,203,15,Chicago Bulls,15,0.476,0.7,49,33,4,2,0.304,0.765,34,20,8,0
3550,21601091,Oklahoma City Thunder,Houston Rockets,125,137,262,12,Houston Rockets,12,0.367,0.714,41,27,15,3,0.513,0.81,36,32,8,4
3551,21601092,Philadelphia 76ers,Indiana Pacers,94,107,201,13,Indiana Pacers,13,0.341,0.714,48,19,7,5,0.412,0.828,51,16,9,4
3552,21601093,Miami Heat,Boston Celtics,108,112,220,4,Boston Celtics,4,0.241,0.792,40,19,9,5,0.333,0.88,35,32,8,3
3553,21601094,Memphis Grizzlies,Golden State Warriors,94,106,200,12,Golden State Warriors,12,0.276,0.667,37,21,11,0,0.548,0.733,37,30,9,4
3554,21601095,New Orleans Pelicans,Denver Nuggets,115,90,205,25,New Orleans Pelicans,25,0.333,0.833,60,29,6,4,0.24,0.857,48,21,3,1
3555,21601096,Portland Trail Blazers,Los Angeles Lakers,97,81,178,16,Portland Trail Blazers,16,0.429,0.722,61,24,8,4,0.238,0.588,42,19,6,3
3556,21601097,Orlando Magic,Toronto Raptors,112,131,243,19,Toronto Raptors,19,0.2,0.786,33,19,11,3,0.667,0.657,43,24,7,8
3557,21601098,Detroit Pistons,New York Knicks,95,109,204,14,New York Knicks,14,0.391,0.667,42,18,4,3,0.333,0.923,37,26,13,5
3558,21601099,Cleveland Cavaliers,San Antonio Spurs,74,103,177,29,San Antonio Spurs,29,0.154,0.615,40,20,8,2,0.269,0.824,52,24,11,7
3559,21601100,Oklahoma City Thunder,Dallas Mavericks,92,91,183,1,Oklahoma City Thunder,1,0.261,0.857,48,17,10,7,0.345,0.789,39,23,12,4
3560,21601101,Memphis Grizzlies,Sacramento Kings,90,91,181,1,Sacramento Kings,1,0.192,0.793,45,15,4,2,0.24,0.767,36,16,4,6
3561,21601102,New Orleans Pelicans,Utah Jazz,100,108,208,8,Utah Jazz,8,0.4,0.667,37,17,7,7,0.556,0.611,49,27,6,7
3562,21601103,Milwaukee Bucks,Charlotte Hornets,118,108,226,10,Milwaukee Bucks,10,0.467,0.706,42,31,1,3,0.25,0.793,31,25,7,1
3563,21601104,Minnesota Timberwolves,Indiana Pacers,115,114,229,1,Minnesota Timberwolves,1,0.45,0.865,35,22,10,9,0.278,0.829,37,25,8,5
3564,21601105,Philadelphia 76ers,Brooklyn Nets,106,101,207,5,Philadelphia 76ers,5,0.303,0.857,53,21,7,9,0.281,0.667,50,22,11,5
3565,21601106,Phoenix Suns,Atlanta Hawks,91,95,186,4,Atlanta Hawks,4,0.226,0.583,48,25,12,6,0.222,0.724,51,24,5,6
3566,21601107,Miami Heat,Detroit Pistons,97,96,193,1,Miami Heat,1,0.238,0.714,44,18,5,4,0.296,0.762,51,20,7,5
3567,21601108,Golden State Warriors,Houston Rockets,113,106,219,7,Golden State Warriors,7,0.268,0.75,44,33,9,7,0.161,0.897,38,20,9,2
3568,21601109,Denver Nuggets,Portland Trail Blazers,113,122,235,9,Portland Trail Blazers,9,0.3,0.8,47,23,3,6,0.296,0.727,47,15,8,5
3569,21601110,Washington Wizards,Los Angeles Lakers,119,108,227,11,Washington Wizards,11,0.261,0.68,41,24,12,3,0.364,0.875,43,21,6,9
3570,21601111,Atlanta Hawks,Philadelphia 76ers,99,92,191,7,Atlanta Hawks,7,0.5,0.846,47,19,7,3,0.282,0.818,40,30,7,3
3571,21601112,Oklahoma City Thunder,Orlando Magic,114,106,220,8,Oklahoma City Thunder,8,0.303,0.643,57,18,11,7,0.3,0.704,53,24,9,8
3572,21601113,Milwaukee Bucks,Boston Celtics,103,100,203,3,Milwaukee Bucks,3,0.364,0.765,35,27,9,8,0.324,0.783,42,24,8,3
3573,21601114,Charlotte Hornets,Toronto Raptors,110,106,216,4,Charlotte Hornets,4,0.5,0.762,38,23,6,2,0.355,0.792,44,23,4,7
3574,21601115,Miami Heat,New York Knicks,105,88,193,17,Miami Heat,17,0.48,0.765,40,18,11,7,0.2,0.81,52,19,2,6
3575,21601116,Indiana Pacers,Memphis Grizzlies,97,110,207,13,Memphis Grizzlies,13,0.4,0.867,43,19,5,7,0.375,0.889,43,22,8,3
3576,21601117,Dallas Mavericks,New Orleans Pelicans,118,121,239,3,New Orleans Pelicans,3,0.519,0.941,38,25,3,4,0.4,0.758,44,26,5,5
3577,21601118,Golden State Warriors,San Antonio Spurs,110,98,208,12,Golden State Warriors,12,0.5,1,35,31,7,7,0.375,0.808,42,20,9,9
3578,21601119,Washington Wizards,Los Angeles Clippers,124,133,257,9,Los Angeles Clippers,9,0.382,0.655,43,22,7,0,0.4,0.73,41,27,6,4
3579,21601120,Utah Jazz,Sacramento Kings,112,82,194,30,Utah Jazz,30,0.419,0.789,43,22,10,3,0.133,0.667,32,14,7,1
3580,21601121,Brooklyn Nets,Detroit Pistons,89,90,179,1,Detroit Pistons,1,0.323,0.75,46,17,4,4,0.389,0.647,53,20,6,7
3581,21601122,Cleveland Cavaliers,Chicago Bulls,93,99,192,6,Chicago Bulls,6,0.37,0.563,44,23,6,5,0.48,0.611,51,26,11,3
3582,21601123,Los Angeles Lakers,Minnesota Timberwolves,104,119,223,15,Minnesota Timberwolves,15,0.333,0.938,42,20,4,5,0.476,0.767,40,30,9,5
3583,21601124,Los Angeles Clippers,Phoenix Suns,124,118,242,6,Los Angeles Clippers,6,0.545,0.706,39,20,4,4,0.304,0.542,43,24,6,2
3584,21601125,Houston Rockets,Portland Trail Blazers,107,117,224,10,Portland Trail Blazers,10,0.235,0.826,42,18,9,3,0.394,0.818,41,24,12,8
3585,21601126,Indiana Pacers,Toronto Raptors,100,111,211,11,Toronto Raptors,11,0.423,0.81,42,19,7,4,0.519,0.657,53,23,7,5
3586,21601127,Denver Nuggets,Charlotte Hornets,114,122,236,8,Charlotte Hornets,8,0.485,0.727,49,32,4,1,0.472,0.833,43,26,10,11
3587,21601128,Philadelphia 76ers,Cleveland Cavaliers,105,122,227,17,Cleveland Cavaliers,17,0.333,0.737,42,26,7,2,0.448,0.563,49,30,8,4
3588,21601129,Orlando Magic,Boston Celtics,116,117,233,1,Boston Celtics,1,0.4,0.96,48,28,9,4,0.364,0.853,45,27,6,5
3589,21601130,Detroit Pistons,Milwaukee Bucks,105,108,213,3,Milwaukee Bucks,3,0.233,0.625,54,25,8,4,0.389,0.706,48,25,6,3
3590,21601131,Dallas Mavericks,Memphis Grizzlies,90,99,189,9,Memphis Grizzlies,9,0.353,0.8,38,15,7,4,0.407,0.9,47,23,4,4
3591,21601132,Sacramento Kings,New Orleans Pelicans,89,117,206,28,New Orleans Pelicans,28,0.3,0.765,52,18,7,6,0.303,0.789,45,28,16,12
3592,21601133,New York Knicks,Miami Heat,98,94,192,4,New York Knicks,4,0.375,0.941,39,25,9,5,0.242,0.72,41,17,5,4
3593,21601134,Washington Wizards,Utah Jazz,88,95,183,7,Utah Jazz,7,0.294,0.813,45,12,8,1,0.4,0.613,42,20,9,7
3594,21601135,San Antonio Spurs,Oklahoma City Thunder,100,95,195,5,San Antonio Spurs,5,0.333,0.63,41,23,8,11,0.286,0.852,46,21,7,3
3595,21601136,Houston Rockets,Golden State Warriors,98,107,205,9,Golden State Warriors,9,0.324,0.783,48,20,6,3,0.344,0.714,43,27,10,14
3596,21601137,Los Angeles Lakers,Los Angeles Clippers,104,115,219,11,Los Angeles Clippers,11,0.261,0.667,41,26,12,2,0.44,0.824,39,24,8,5
3597,21601138,Atlanta Hawks,Chicago Bulls,104,106,210,2,Chicago Bulls,2,0.393,0.765,45,25,4,1,0.4,1,40,25,6,4
3598,21601139,Orlando Magic,Brooklyn Nets,111,121,232,10,Brooklyn Nets,10,0.4,0.733,42,26,9,2,0.258,0.813,44,26,8,5
3599,21601140,Sacramento Kings,Minnesota Timberwolves,123,117,240,6,Sacramento Kings,6,0.579,0.727,40,27,5,4,0.333,0.789,41,27,8,4
3600,21601141,Phoenix Suns,Portland Trail Blazers,117,130,247,13,Portland Trail Blazers,13,0.3,0.813,43,17,8,6,0.405,0.935,41,21,12,3
3601,21601142,Charlotte Hornets,Oklahoma City Thunder,113,101,214,12,Charlotte Hornets,12,0.367,0.875,37,20,18,5,0.387,0.917,42,19,10,5
3602,21601143,Memphis Grizzlies,Los Angeles Lakers,103,108,211,5,Los Angeles Lakers,5,0.433,0.714,33,29,8,5,0.368,0.778,51,14,11,2
3603,21601144,Dallas Mavericks,Milwaukee Bucks,109,105,214,4,Dallas Mavericks,4,0.389,0.95,30,25,7,1,0.353,0.833,33,25,9,3
3604,21601145,Boston Celtics,New York Knicks,110,94,204,16,Boston Celtics,16,0.324,0.692,41,22,8,3,0.28,0.84,32,20,12,2
3605,21601146,Chicago Bulls,New Orleans Pelicans,117,110,227,7,Chicago Bulls,7,0.5,0.778,49,26,7,6,0.333,0.971,40,24,7,4
3606,21601147,Philadelphia 76ers,Toronto Raptors,105,113,218,8,Toronto Raptors,8,0.306,0.88,37,25,8,5,0.316,0.789,37,25,12,9
3607,21601148,Atlanta Hawks,Brooklyn Nets,82,91,173,9,Brooklyn Nets,9,0.292,0.652,44,19,9,4,0.303,0.85,51,21,11,6
3608,21601149,Denver Nuggets,Miami Heat,116,113,229,3,Denver Nuggets,3,0.25,0.852,40,25,9,6,0.481,0.762,41,26,3,9
3609,21601150,Indiana Pacers,Cleveland Cavaliers,130,135,265,5,Cleveland Cavaliers,5,0.39,0.9,46,32,6,3,0.419,0.697,56,29,7,4
3610,21601151,Utah Jazz,San Antonio Spurs,103,109,212,6,San Antonio Spurs,6,0.375,0.615,36,24,6,8,0.526,0.864,42,26,7,6
3611,21601152,Washington Wizards,Golden State Warriors,115,139,254,24,Golden State Warriors,24,0.37,0.76,38,28,9,3,0.444,0.885,44,34,7,10
3612,21601153,Houston Rockets,Phoenix Suns,123,116,239,7,Houston Rockets,7,0.368,0.652,46,23,8,4,0.235,0.828,61,24,8,11
3613,21601154,Brooklyn Nets,Philadelphia 76ers,141,118,259,23,Brooklyn Nets,23,0.516,0.879,36,36,9,5,0.316,0.741,36,32,7,4
3614,21601155,Charlotte Hornets,Washington Wizards,111,118,229,7,Washington Wizards,7,0.353,0.864,37,21,5,3,0.5,0.833,36,31,10,3
3615,21601156,Orlando Magic,Cleveland Cavaliers,102,122,224,20,Cleveland Cavaliers,20,0.333,0.962,43,23,8,3,0.5,0.762,42,30,9,3
3616,21601157,Toronto Raptors,Indiana Pacers,90,108,198,18,Indiana Pacers,18,0.217,0.895,40,11,7,5,0.48,1,43,16,7,4
3617,21601158,Denver Nuggets,New Orleans Pelicans,134,131,265,3,Denver Nuggets,3,0.433,0.714,50,31,3,2,0.438,0.882,35,30,5,8
3618,21601159,Milwaukee Bucks,Oklahoma City Thunder,79,110,189,31,Oklahoma City Thunder,31,0.167,0.692,38,16,9,5,0.321,0.84,53,29,9,7
3619,21601160,Chicago Bulls,New York Knicks,91,100,191,9,New York Knicks,9,0.222,0.913,37,22,7,5,0.261,0.625,54,26,4,8
3620,21601161,Memphis Grizzlies,San Antonio Spurs,89,95,184,6,San Antonio Spurs,6,0.32,0.611,50,26,9,2,0.524,0.778,46,22,8,6
3621,21601162,Minnesota Timberwolves,Golden State Warriors,107,121,228,14,Golden State Warriors,14,0.211,0.808,50,22,9,3,0.438,0.792,40,33,9,7
3622,21601163,Dallas Mavericks,Sacramento Kings,87,98,185,11,Sacramento Kings,11,0.279,0.786,39,21,9,9,0.545,0.824,51,17,11,2
3623,21601164,Portland Trail Blazers,Utah Jazz,87,106,193,19,Utah Jazz,19,0.231,0.882,29,10,8,5,0.565,0.789,47,21,4,6
3624,21601165,Miami Heat,Charlotte Hornets,112,99,211,13,Miami Heat,13,0.525,0.917,40,23,5,7,0.32,0.875,36,19,2,7
3625,21601166,Toronto Raptors,Detroit Pistons,105,102,207,3,Toronto Raptors,3,0.333,0.867,36,29,7,2,0.333,0.611,45,22,5,4
3626,21601167,Oklahoma City Thunder,Memphis Grizzlies,103,100,203,3,Oklahoma City Thunder,3,0.452,0.625,44,19,8,3,0.346,0.81,38,21,7,5
3627,21601168,Denver Nuggets,Houston Rockets,104,110,214,6,Houston Rockets,6,0.184,0.833,51,26,10,5,0.294,0.684,56,19,7,3
3628,21601169,Cleveland Cavaliers,Boston Celtics,114,91,205,23,Cleveland Cavaliers,23,0.306,0.944,51,19,7,5,0.212,0.621,38,21,6,4
3629,21601170,Los Angeles Lakers,San Antonio Spurs,102,95,197,7,Los Angeles Lakers,7,0.5,0.786,47,23,8,5,0.371,0.667,37,28,8,8
3630,21601171,Golden State Warriors,Phoenix Suns,120,111,231,9,Golden State Warriors,9,0.433,0.708,39,25,13,9,0.259,0.692,55,26,13,2
3631,21601172,Dallas Mavericks,Los Angeles Clippers,101,112,213,11,Los Angeles Clippers,11,0.355,0.778,44,24,5,3,0.387,0.774,40,22,11,0
3632,21601173,Chicago Bulls,Philadelphia 76ers,102,90,192,12,Chicago Bulls,12,0.32,0.941,57,27,7,6,0.212,0.773,50,19,10,3
3633,21601174,Brooklyn Nets,Orlando Magic,107,115,222,8,Orlando Magic,8,0.367,0.727,39,21,7,6,0.36,0.846,48,24,9,6
3634,21601175,Milwaukee Bucks,Indiana Pacers,89,104,193,15,Indiana Pacers,15,0.458,0.857,32,21,8,4,0.32,0.769,44,20,15,3
3635,21601176,Washington Wizards,New York Knicks,106,103,209,3,Washington Wizards,3,0.412,0.714,39,17,5,8,0.35,0.762,49,20,9,2
3636,21601177,Boston Celtics,Atlanta Hawks,116,123,239,7,Atlanta Hawks,7,0.349,0.794,38,28,9,4,0.478,0.706,52,26,7,4
3637,21601178,Minnesota Timberwolves,Portland Trail Blazers,98,105,203,7,Portland Trail Blazers,7,0.222,0.9,47,16,7,4,0.424,0.808,41,19,8,4
3638,21601179,Atlanta Hawks,Cleveland Cavaliers,114,100,214,14,Atlanta Hawks,14,0.432,1,42,39,7,3,0.25,0.765,38,23,5,3
3639,21601180,Miami Heat,Toronto Raptors,94,96,190,2,Toronto Raptors,2,0.348,0.69,44,16,10,5,0.45,0.708,44,14,10,4
3640,21601181,New York Knicks,Memphis Grizzlies,88,101,189,13,Memphis Grizzlies,13,0.214,0.462,41,20,8,4,0.556,0.833,38,20,3,9
3641,21601182,Detroit Pistons,Houston Rockets,114,109,223,5,Detroit Pistons,5,0.346,0.813,55,27,5,1,0.314,0.75,49,25,3,6
3642,21601183,San Antonio Spurs,Dallas Mavericks,102,89,191,13,San Antonio Spurs,13,0.321,0.591,58,26,6,5,0.308,0.625,44,26,1,8
3643,21601184,New Orleans Pelicans,Denver Nuggets,106,122,228,16,Denver Nuggets,16,0.13,0.692,33,19,11,3,0.406,0.719,50,31,9,4
3644,21601185,Minnesota Timberwolves,Utah Jazz,113,120,233,7,Utah Jazz,7,0.438,1,34,22,11,1,0.56,0.727,33,29,8,7
3645,21601186,Oklahoma City Thunder,Phoenix Suns,99,120,219,21,Phoenix Suns,21,0.233,0.727,48,13,1,3,0.444,0.839,45,16,6,6
3646,21601187,Sacramento Kings,Los Angeles Lakers,94,98,192,4,Los Angeles Lakers,4,0.4,0.769,40,27,5,6,0.167,0.72,41,20,12,1
3647,21601188,Chicago Bulls,Brooklyn Nets,106,107,213,1,Brooklyn Nets,1,0.458,0.882,52,14,6,6,0.323,0.792,44,24,15,6
3648,21601189,Boston Celtics,Charlotte Hornets,121,114,235,7,Boston Celtics,7,0.436,0.824,43,35,2,5,0.321,0.906,42,22,5,5
3649,21601190,Indiana Pacers,Orlando Magic,127,112,239,15,Indiana Pacers,15,0.5,0.737,45,35,6,4,0.467,0.727,33,29,10,2
3650,21601191,Milwaukee Bucks,Philadelphia 76ers,90,82,172,8,Milwaukee Bucks,8,0.222,0.7,43,18,10,4,0.258,0.87,47,23,9,1
3651,21601192,Miami Heat,Washington Wizards,106,103,209,3,Miami Heat,3,0.389,0.694,36,23,13,7,0.364,0.773,44,21,7,6
3652,21601193,Los Angeles Clippers,San Antonio Spurs,98,87,185,11,Los Angeles Clippers,11,0.273,0.571,45,21,8,7,0.364,0.786,40,20,3,3
3653,21601194,Utah Jazz,Portland Trail Blazers,86,101,187,15,Portland Trail Blazers,15,0.316,0.75,47,19,2,9,0.433,0.875,47,15,5,6
3654,21601195,New Orleans Pelicans,Golden State Warriors,101,123,224,22,Golden State Warriors,22,0.238,0.632,34,24,3,1,0.303,0.938,53,37,2,4
3655,21601196,Toronto Raptors,New York Knicks,110,97,207,13,Toronto Raptors,13,0.323,0.87,41,20,8,1,0.321,0.933,36,27,6,1
3656,21601197,Cleveland Cavaliers,Atlanta Hawks,125,126,251,1,Atlanta Hawks,1,0.413,0.8,53,28,4,3,0.29,0.784,45,31,8,4
3657,21601198,Oklahoma City Thunder,Denver Nuggets,106,105,211,1,Oklahoma City Thunder,1,0.24,0.909,54,19,7,3,0.324,0.933,42,22,6,4
3658,21601199,Dallas Mavericks,Phoenix Suns,111,124,235,13,Phoenix Suns,13,0.356,0.684,44,23,5,2,0.421,0.875,43,26,6,4
3659,21601200,Houston Rockets,Sacramento Kings,135,128,263,7,Houston Rockets,7,0.419,0.871,41,26,3,2,0.29,0.833,38,26,8,2
3660,21601201,Detroit Pistons,Memphis Grizzlies,103,90,193,13,Detroit Pistons,13,0.5,0.688,46,21,8,2,0.429,0.692,30,23,12,3
3661,21601202,Minnesota Timberwolves,Los Angeles Lakers,109,110,219,1,Los Angeles Lakers,1,0.2,0.839,41,27,8,6,0.37,0.8,40,26,10,8
3662,21601203,Indiana Pacers,Philadelphia 76ers,120,111,231,9,Indiana Pacers,9,0.313,0.81,44,30,9,5,0.394,0.903,33,20,10,1
3663,21601204,Brooklyn Nets,Boston Celtics,105,114,219,9,Boston Celtics,9,0.258,0.897,49,18,8,6,0.368,0.857,51,31,7,4
3664,21601205,Cleveland Cavaliers,Miami Heat,121,124,245,3,Miami Heat,3,0.4,0.864,47,19,7,4,0.364,0.706,46,28,9,3
3665,21601206,Orlando Magic,Chicago Bulls,75,122,197,47,Chicago Bulls,47,0.185,0.75,37,18,5,5,0.462,0.875,54,33,12,4
3666,21601207,Charlotte Hornets,Milwaukee Bucks,79,89,168,10,Milwaukee Bucks,10,0.278,0.615,39,21,11,5,0.593,0.6,46,28,4,3
3667,21601208,Washington Wizards,Detroit Pistons,105,101,206,4,Washington Wizards,4,0.368,0.875,48,27,8,5,0.385,1,36,22,9,2
3668,21601209,San Antonio Spurs,Portland Trail Blazers,98,99,197,1,Portland Trail Blazers,1,0.381,0.7,47,17,4,9,0.444,0.867,42,18,6,3
3669,21601210,Houston Rockets,Los Angeles Clippers,96,125,221,29,Los Angeles Clippers,29,0.225,0.778,41,23,5,3,0.385,0.821,49,29,9,0
3670,21601211,Utah Jazz,Golden State Warriors,105,99,204,6,Utah Jazz,6,0.371,0.667,49,29,8,3,0.36,0.706,42,25,5,6
3671,21601212,Charlotte Hornets,Atlanta Hawks,76,103,179,27,Atlanta Hawks,27,0.13,0.789,40,16,11,1,0.259,0.778,50,30,6,4
3672,21601213,Oklahoma City Thunder,Minnesota Timberwolves,100,98,198,2,Oklahoma City Thunder,2,0.318,0.76,54,22,7,4,0.25,0.68,35,24,12,3
3673,21601214,Denver Nuggets,Dallas Mavericks,109,91,200,18,Denver Nuggets,18,0.429,0.643,53,31,7,1,0.3,0.818,42,24,8,4
3674,21601215,New Orleans Pelicans,Los Angeles Lakers,96,108,204,12,Los Angeles Lakers,12,0.318,0.75,39,29,5,5,0.364,0.696,47,24,15,3
3675,21601216,Phoenix Suns,Sacramento Kings,104,129,233,25,Sacramento Kings,25,0.267,0.583,48,19,8,3,0.474,0.791,55,28,7,2
3676,21601217,Detroit Pistons,Orlando Magic,109,113,222,4,Orlando Magic,4,0.306,0.571,53,20,6,3,0.52,0.941,51,27,7,6
3677,21601218,Toronto Raptors,Cleveland Cavaliers,98,83,181,15,Toronto Raptors,15,0.308,0.625,48,20,8,2,0.27,0.708,42,20,5,7
3678,21601219,Milwaukee Bucks,Boston Celtics,94,112,206,18,Boston Celtics,18,0.261,0.824,43,26,6,9,0.333,0.692,45,31,12,3
3679,21601220,Philadelphia 76ers,New York Knicks,113,114,227,1,New York Knicks,1,0.304,0.7,38,21,10,4,0.409,0.719,43,17,5,7
3680,21601221,Washington Wizards,Miami Heat,102,110,212,8,Miami Heat,8,0.269,0.786,34,18,9,0,0.333,0.833,51,19,2,4
3681,21601222,Brooklyn Nets,Chicago Bulls,73,112,185,39,Chicago Bulls,39,0.091,0.778,48,17,8,3,0.467,0.762,62,28,15,4
3682,21601223,Dallas Mavericks,Memphis Grizzlies,100,93,193,7,Dallas Mavericks,7,0.265,0.806,37,21,9,5,0.32,0.864,48,18,4,5
3683,21601224,Minnesota Timberwolves,Houston Rockets,118,123,241,5,Houston Rockets,5,0.478,0.733,49,37,7,3,0.339,0.636,47,37,11,7
3684,21601225,Denver Nuggets,Oklahoma City Thunder,111,105,216,6,Denver Nuggets,6,0.28,0.813,43,22,6,8,0.32,0.647,51,20,10,8
3685,21601226,Atlanta Hawks,Indiana Pacers,86,104,190,18,Indiana Pacers,18,0.379,0.789,37,19,5,4,0.417,0.842,41,21,5,7
3686,21601227,San Antonio Spurs,Utah Jazz,97,101,198,4,Utah Jazz,4,0.381,0.846,42,16,12,2,0.385,0.65,36,24,10,5
3687,21601228,Sacramento Kings,Los Angeles Clippers,95,115,210,20,Los Angeles Clippers,20,0.455,0.714,37,27,2,1,0.357,0.76,43,29,4,6
3688,21601229,Los Angeles Lakers,Golden State Warriors,94,109,203,15,Golden State Warriors,15,0.235,0.571,40,23,13,2,0.333,0.682,54,26,14,8
3689,21601230,New Orleans Pelicans,Portland Trail Blazers,103,100,203,3,New Orleans Pelicans,3,0.333,0.714,42,20,13,3,0.433,0.385,53,22,4,2
3690,21700001,Boston Celtics,Cleveland Cavaliers,99,102,201,3,Cleveland Cavaliers,3,0.25,0.76,46,24,11,4,0.227,0.84,50,19,3,4
3691,21700002,Houston Rockets,Golden State Warriors,122,121,243,1,Houston Rockets,1,0.366,0.684,43,28,9,5,0.533,0.905,41,34,5,9
3692,21700003,Charlotte Hornets,Detroit Pistons,90,102,192,12,Detroit Pistons,12,0.3,0.793,47,16,4,3,0.346,0.917,47,24,14,3
3693,21700004,Brooklyn Nets,Indiana Pacers,131,140,271,9,Indiana Pacers,9,0.4,0.906,43,22,7,2,0.265,0.781,47,29,12,9
3694,21700005,Miami Heat,Orlando Magic,109,116,225,7,Orlando Magic,7,0.267,0.765,44,27,6,4,0.381,0.759,50,22,8,9
3695,21700006,Philadelphia 76ers,Washington Wizards,115,120,235,5,Washington Wizards,5,0.429,0.737,48,25,6,6,0.273,0.789,52,21,8,10
3696,21700007,Milwaukee Bucks,Boston Celtics,108,100,208,8,Milwaukee Bucks,8,0.333,0.833,45,19,6,4,0.393,0.524,43,23,12,2
3697,21700008,New Orleans Pelicans,Memphis Grizzlies,91,103,194,12,Memphis Grizzlies,12,0.28,0.828,51,15,4,12,0.31,0.571,45,19,9,8
3698,21700009,Atlanta Hawks,Dallas Mavericks,117,111,228,6,Atlanta Hawks,6,0.5,0.8,50,20,11,6,0.378,0.857,41,27,5,4
3699,21700010,Denver Nuggets,Utah Jazz,96,106,202,10,Utah Jazz,10,0.481,0.917,38,21,4,3,0.375,0.938,36,28,9,5
3700,21700011,Minnesota Timberwolves,San Antonio Spurs,99,107,206,8,San Antonio Spurs,8,0.421,0.739,42,23,7,4,0.381,0.895,50,22,8,11
3701,21700012,Portland Trail Blazers,Phoenix Suns,124,76,200,48,Portland Trail Blazers,48,0.583,0.786,57,22,8,7,0.259,0.722,33,10,9,8
3702,21700013,Houston Rockets,Sacramento Kings,105,100,205,5,Houston Rockets,5,0.267,0.931,44,19,7,3,0.348,0.8,42,19,5,4
3703,21700014,Chicago Bulls,Toronto Raptors,100,117,217,17,Toronto Raptors,17,0.313,0.889,39,22,7,2,0.448,0.929,49,26,10,4
3704,21700015,New York Knicks,Oklahoma City Thunder,84,105,189,21,Oklahoma City Thunder,21,0.292,0.684,41,19,8,4,0.289,0.727,41,26,14,7
3705,21700016,Los Angeles Clippers,Los Angeles Lakers,108,92,200,16,Los Angeles Clippers,16,0.364,0.923,59,23,12,3,0.25,0.609,52,21,8,7
3706,21700017,Atlanta Hawks,Charlotte Hornets,91,109,200,18,Charlotte Hornets,18,0.233,0.857,38,19,11,4,0.306,0.8,57,17,5,4
3707,21700018,Portland Trail Blazers,Indiana Pacers,114,96,210,18,Portland Trail Blazers,18,0.474,0.765,51,19,5,6,0.222,0.667,39,15,1,4
3708,21700019,Boston Celtics,Philadelphia 76ers,102,92,194,10,Boston Celtics,10,0.345,0.688,55,16,4,5,0.313,0.75,47,20,7,4
3709,21700020,Detroit Pistons,Washington Wizards,111,115,226,4,Washington Wizards,4,0.435,0.75,33,19,12,1,0.353,0.829,37,25,12,7
3710,21700021,Cleveland Cavaliers,Milwaukee Bucks,116,97,213,19,Cleveland Cavaliers,19,0.423,1,44,25,8,3,0.314,0.833,30,23,9,2
3711,21700022,Orlando Magic,Brooklyn Nets,121,126,247,5,Brooklyn Nets,5,0.545,0.867,40,30,9,3,0.333,0.714,48,22,13,6
3712,21700023,Utah Jazz,Minnesota Timberwolves,97,100,197,3,Minnesota Timberwolves,3,0.409,0.824,38,23,10,8,0.318,0.808,44,17,11,2
3713,21700024,Sacramento Kings,Dallas Mavericks,93,88,181,5,Sacramento Kings,5,0.435,0.692,57,20,8,3,0.333,0.714,36,19,8,7
3714,21700025,Golden State Warriors,New Orleans Pelicans,128,120,248,8,Golden State Warriors,8,0.45,0.8,49,29,6,8,0.444,0.636,50,26,8,4
3715,21700026,Los Angeles Lakers,Phoenix Suns,132,130,262,2,Los Angeles Lakers,2,0.462,0.727,42,22,8,3,0.483,0.684,50,17,8,9
3716,21700027,Philadelphia 76ers,Toronto Raptors,94,128,222,34,Toronto Raptors,34,0.333,0.611,41,18,5,4,0.295,0.838,51,23,5,10
3717,21700028,Orlando Magic,Cleveland Cavaliers,114,93,207,21,Orlando Magic,21,0.486,0.85,50,28,7,6,0.28,0.741,44,15,4,7
3718,21700029,Indiana Pacers,Miami Heat,108,112,220,4,Miami Heat,4,0.368,0.714,45,18,9,4,0.412,0.571,45,24,6,11
3719,21700030,Detroit Pistons,New York Knicks,111,107,218,4,Detroit Pistons,4,0.3,0.933,43,21,5,2,0.267,0.806,39,20,6,2
3720,21700031,San Antonio Spurs,Chicago Bulls,87,77,164,10,San Antonio Spurs,10,0.083,0.625,52,25,8,3,0.286,0.778,48,18,3,5
3721,21700032,Dallas Mavericks,Houston Rockets,91,107,198,16,Houston Rockets,16,0.419,0.762,41,19,6,0,0.234,0.818,54,17,12,4
3722,21700033,Golden State Warriors,Memphis Grizzlies,101,111,212,10,Memphis Grizzlies,10,0.316,0.852,46,20,10,7,0.37,0.784,40,20,8,4
3723,21700034,Portland Trail Blazers,Milwaukee Bucks,110,113,223,3,Milwaukee Bucks,3,0.393,0.886,42,18,10,6,0.389,0.733,35,22,9,8
3724,21700035,Sacramento Kings,Denver Nuggets,79,96,175,17,Denver Nuggets,17,0.364,0.692,39,15,6,3,0.333,0.6,58,25,7,2
3725,21700036,Oklahoma City Thunder,Utah Jazz,87,96,183,9,Utah Jazz,9,0.333,0.632,38,15,14,4,0.31,0.786,41,22,11,4
3726,21700037,Phoenix Suns,Los Angeles Clippers,88,130,218,42,Los Angeles Clippers,42,0.25,0.737,36,19,8,3,0.462,0.733,52,26,12,2
3727,21700038,Atlanta Hawks,Brooklyn Nets,104,116,220,12,Brooklyn Nets,12,0.259,0.917,48,21,6,2,0.407,0.676,51,27,12,8
3728,21700039,Minnesota Timberwolves,Oklahoma City Thunder,115,113,228,2,Minnesota Timberwolves,2,0.4,0.826,45,25,5,1,0.355,0.625,36,26,9,6
3729,21700040,New Orleans Pelicans,Los Angeles Lakers,119,112,231,7,New Orleans Pelicans,7,0.313,0.714,42,26,14,5,0.333,0.75,38,27,7,6
3730,21700041,Philadelphia 76ers,Detroit Pistons,97,86,183,11,Philadelphia 76ers,11,0.375,0.75,49,25,11,0,0.2,0.737,39,14,5,2
3731,21700042,Atlanta Hawks,Miami Heat,93,104,197,11,Miami Heat,11,0.412,0.778,41,14,9,1,0.378,0.667,41,21,12,6
3732,21700043,Memphis Grizzlies,Houston Rockets,98,90,188,8,Memphis Grizzlies,8,0.316,0.919,38,16,5,2,0.237,0.739,39,25,5,2
3733,21700044,Charlotte Hornets,Milwaukee Bucks,94,103,197,9,Milwaukee Bucks,9,0.269,0.583,48,17,3,5,0.346,0.875,42,24,8,4
3734,21700045,Golden State Warriors,Dallas Mavericks,133,103,236,30,Golden State Warriors,30,0.385,0.846,50,33,6,8,0.31,0.6,42,21,11,0
3735,21700046,Toronto Raptors,San Antonio Spurs,97,101,198,4,San Antonio Spurs,4,0.27,0.792,34,17,11,4,0.25,0.696,55,19,4,12
3736,21700047,Washington Wizards,Denver Nuggets,109,104,213,5,Washington Wizards,5,0.3,0.929,38,24,13,3,0.348,0.783,44,27,5,2
3737,21700048,Sacramento Kings,Phoenix Suns,115,117,232,2,Phoenix Suns,2,0.409,0.69,37,19,13,2,0.333,0.852,45,20,6,5
3738,21700049,Chicago Bulls,Cleveland Cavaliers,112,119,231,7,Cleveland Cavaliers,7,0.515,0.846,39,28,3,3,0.421,0.773,39,28,5,3
3739,21700050,Brooklyn Nets,Orlando Magic,121,125,246,4,Orlando Magic,4,0.314,0.882,49,21,8,4,0.348,0.875,44,20,8,5
3740,21700051,New York Knicks,Boston Celtics,89,110,199,21,Boston Celtics,21,0.083,0.64,43,20,8,2,0.483,0.815,41,26,11,7
3741,21700052,Indiana Pacers,Minnesota Timberwolves,130,107,237,23,Indiana Pacers,23,0.455,0.727,42,31,8,2,0.375,0.636,27,27,9,4
3742,21700053,New Orleans Pelicans,Portland Trail Blazers,93,103,196,10,Portland Trail Blazers,10,0.3,0.75,42,17,5,7,0.345,0.818,63,17,7,7
3743,21700054,Utah Jazz,Los Angeles Clippers,84,102,186,18,Los Angeles Clippers,18,0.25,0.818,41,20,7,7,0.345,0.667,44,21,12,4
3744,21700055,Denver Nuggets,Charlotte Hornets,93,110,203,17,Charlotte Hornets,17,0.258,0.6,51,18,6,1,0.419,0.808,50,17,5,5
3745,21700056,Minnesota Timberwolves,Detroit Pistons,101,122,223,21,Detroit Pistons,21,0.36,0.857,37,19,5,4,0.441,0.647,47,32,7,3
3746,21700057,Houston Rockets,Philadelphia 76ers,105,104,209,1,Houston Rockets,1,0.308,0.875,40,22,11,13,0.333,0.6,43,29,14,7
3747,21700058,Cleveland Cavaliers,Brooklyn Nets,107,112,219,5,Brooklyn Nets,5,0.343,0.654,47,21,5,7,0.37,0.714,38,22,11,3
3748,21700059,San Antonio Spurs,Miami Heat,117,100,217,17,San Antonio Spurs,17,0.588,0.767,44,18,6,3,0.346,0.944,32,19,6,2
3749,21700060,Indiana Pacers,Oklahoma City Thunder,96,114,210,18,Oklahoma City Thunder,18,0.345,0.857,41,13,13,2,0.37,0.692,49,26,8,8
3750,21700061,Memphis Grizzlies,Dallas Mavericks,94,103,197,9,Dallas Mavericks,9,0.387,0.667,36,14,7,2,0.423,0.69,35,20,6,4
3751,21700062,Utah Jazz,Phoenix Suns,88,97,185,9,Phoenix Suns,9,0.24,0.72,44,20,8,10,0.316,0.778,55,18,8,5
3752,21700063,Toronto Raptors,Golden State Warriors,112,117,229,5,Golden State Warriors,5,0.235,0.947,42,30,10,6,0.462,0.864,37,32,10,7
3753,21700064,Washington Wizards,Los Angeles Lakers,99,102,201,3,Los Angeles Lakers,3,0.231,0.652,45,20,11,5,0.233,0.813,53,27,9,5
3754,21700065,Atlanta Hawks,Chicago Bulls,86,91,177,5,Chicago Bulls,5,0.393,0.846,40,22,10,5,0.219,0.759,62,20,5,4
3755,21700066,Dallas Mavericks,Memphis Grizzlies,91,96,187,5,Memphis Grizzlies,5,0.294,0.85,53,20,10,3,0.294,0.867,46,18,7,6
3756,21700067,Boston Celtics,Milwaukee Bucks,96,89,185,7,Boston Celtics,7,0.367,0.864,45,21,7,4,0.44,0.571,37,22,6,3
3757,21700068,Los Angeles Clippers,Portland Trail Blazers,104,103,207,1,Los Angeles Clippers,1,0.321,0.639,46,11,4,5,0.452,0.864,44,19,5,4
3758,21700069,New Orleans Pelicans,Sacramento Kings,114,106,220,8,New Orleans Pelicans,8,0.406,0.739,47,22,5,3,0.35,0.92,34,25,7,5
3759,21700070,Houston Rockets,Charlotte Hornets,109,93,202,16,Houston Rockets,16,0.386,0.846,51,21,5,6,0.379,0.571,44,16,6,5
3760,21700071,San Antonio Spurs,Orlando Magic,87,114,201,27,Orlando Magic,27,0.167,0.852,49,19,8,8,0.478,0.5,45,22,9,7
3761,21700072,Denver Nuggets,Atlanta Hawks,105,100,205,5,Denver Nuggets,5,0.2,0.739,46,25,8,4,0.424,1,43,23,7,4
3762,21700073,Brooklyn Nets,New York Knicks,86,107,193,21,New York Knicks,21,0.367,0.714,35,18,5,1,0.333,0.588,55,19,7,6
3763,21700074,Oklahoma City Thunder,Minnesota Timberwolves,116,119,235,3,Minnesota Timberwolves,3,0.286,0.88,35,19,8,9,0.364,0.771,44,23,5,7
3764,21700075,Washington Wizards,Golden State Warriors,117,120,237,3,Golden State Warriors,3,0.455,0.727,41,30,7,6,0.263,0.9,53,33,7,13
3765,21700076,Toronto Raptors,Los Angeles Lakers,101,92,193,9,Toronto Raptors,9,0.241,0.7,40,27,12,4,0.13,0.708,49,20,7,6
3766,21700077,Cleveland Cavaliers,New Orleans Pelicans,101,123,224,22,New Orleans Pelicans,22,0.375,0.739,37,19,8,2,0.394,0.75,47,33,10,4
3767,21700078,Boston Celtics,Miami Heat,96,90,186,6,Boston Celtics,6,0.261,0.846,41,15,11,5,0.226,0.938,40,17,6,9
3768,21700079,Oklahoma City Thunder,Chicago Bulls,101,69,170,32,Oklahoma City Thunder,32,0.382,0.714,52,28,16,8,0.27,0.75,47,16,9,5
3769,21700080,Houston Rockets,Memphis Grizzlies,89,103,192,14,Memphis Grizzlies,14,0.368,0.81,43,18,4,3,0.424,0.75,42,26,10,6
3770,21700081,Philadelphia 76ers,Dallas Mavericks,112,110,222,2,Philadelphia 76ers,2,0.457,0.714,42,25,10,1,0.475,0.789,33,22,7,2
3771,21700082,Los Angeles Lakers,Utah Jazz,81,96,177,15,Utah Jazz,15,0.227,0.7,39,17,12,4,0.419,0.692,49,18,9,5
3772,21700083,Phoenix Suns,Portland Trail Blazers,107,114,221,7,Portland Trail Blazers,7,0.346,0.8,46,21,12,7,0.423,0.821,53,27,8,7
3773,21700084,Detroit Pistons,Los Angeles Clippers,95,87,182,8,Detroit Pistons,8,0.321,0.667,50,16,11,6,0.395,0.727,51,19,6,6
3774,21700085,Milwaukee Bucks,Atlanta Hawks,117,106,223,11,Milwaukee Bucks,11,0.5,0.762,43,30,9,3,0.448,0.808,31,27,9,2
3775,21700086,San Antonio Spurs,Indiana Pacers,94,97,191,3,Indiana Pacers,3,0.321,0.722,44,19,12,8,0.455,0.75,44,21,9,3
3776,21700087,Denver Nuggets,Brooklyn Nets,124,111,235,13,Denver Nuggets,13,0.55,0.864,46,23,7,7,0.387,0.677,56,24,5,4
3777,21700088,Orlando Magic,Charlotte Hornets,113,120,233,7,Charlotte Hornets,7,0.333,0.769,39,28,11,4,0.333,0.471,59,31,6,7
3778,21700089,Washington Wizards,Sacramento Kings,110,83,193,27,Washington Wizards,27,0.5,0.65,49,28,9,3,0.273,0.813,43,13,8,2
3779,21700090,New York Knicks,Cleveland Cavaliers,114,95,209,19,New York Knicks,19,0.464,0.81,51,27,9,6,0.303,0.852,41,20,5,5
3780,21700091,Detroit Pistons,Golden State Warriors,115,107,222,8,Detroit Pistons,8,0.444,1,37,22,16,0,0.37,0.75,40,29,3,11
3781,21700092,San Antonio Spurs,Boston Celtics,94,108,202,14,Boston Celtics,14,0.462,0.5,40,24,8,4,0.355,0.813,54,24,10,6
3782,21700093,Minnesota Timberwolves,Miami Heat,125,122,247,3,Minnesota Timberwolves,3,0.478,0.914,40,20,16,4,0.259,0.68,50,17,8,5
3783,21700094,Denver Nuggets,New York Knicks,110,116,226,6,New York Knicks,6,0.439,0.71,36,20,13,5,0.406,0.913,49,27,8,10
3784,21700095,Philadelphia 76ers,Houston Rockets,115,107,222,8,Philadelphia 76ers,8,0.417,0.708,48,27,10,4,0.277,0.737,35,17,12,3
3785,21700096,Charlotte Hornets,Memphis Grizzlies,104,99,203,5,Charlotte Hornets,5,0.412,0.793,56,15,3,7,0.229,0.818,48,17,7,8
3786,21700097,Orlando Magic,New Orleans Pelicans,115,99,214,16,Orlando Magic,16,0.471,0.722,43,27,10,1,0.25,0.778,43,30,9,5
3787,21700098,Dallas Mavericks,Utah Jazz,89,104,193,15,Utah Jazz,15,0.5,0.818,42,17,4,3,0.457,0.8,35,25,16,8
3788,21700099,Toronto Raptors,Portland Trail Blazers,99,85,184,14,Toronto Raptors,14,0.333,0.765,47,17,10,9,0.308,0.789,38,13,5,7
3789,21700100,Golden State Warriors,Los Angeles Clippers,141,113,254,28,Golden State Warriors,28,0.483,0.767,46,37,8,8,0.4,0.833,35,21,4,3
3790,21700101,Sacramento Kings,Indiana Pacers,83,101,184,18,Indiana Pacers,18,0.143,0.5,44,15,8,5,0.414,0.773,53,25,8,7
3791,21700102,Phoenix Suns,Brooklyn Nets,122,114,236,8,Phoenix Suns,8,0.455,0.917,66,18,5,5,0.29,0.7,44,15,9,4
3792,21700103,Oklahoma City Thunder,Milwaukee Bucks,110,91,201,19,Oklahoma City Thunder,19,0.429,0.857,46,24,6,3,0.29,0.818,31,24,8,4
3793,21700104,Detroit Pistons,Los Angeles Lakers,93,113,206,20,Los Angeles Lakers,20,0.303,0.333,44,21,7,3,0.462,0.786,53,30,9,5
3794,21700105,Milwaukee Bucks,Charlotte Hornets,121,126,247,5,Charlotte Hornets,5,0.528,0.8,40,29,3,3,0.56,0.759,41,21,5,3
3795,21700106,Indiana Pacers,Cleveland Cavaliers,124,107,231,17,Indiana Pacers,17,0.615,0.769,43,35,9,1,0.226,0.7,41,25,6,3
3796,21700107,Atlanta Hawks,Philadelphia 76ers,109,119,228,10,Philadelphia 76ers,10,0.348,0.704,49,22,11,4,0.371,0.56,53,36,10,4
3797,21700108,Phoenix Suns,Washington Wizards,122,116,238,6,Phoenix Suns,6,0.375,0.816,45,23,5,5,0.333,0.8,45,20,5,4
3798,21700109,Sacramento Kings,Boston Celtics,86,113,199,27,Boston Celtics,27,0.3,0.833,26,24,10,5,0.415,0.842,52,30,10,3
3799,21700110,Chicago Bulls,Miami Heat,91,97,188,6,Miami Heat,6,0.25,0.632,54,20,7,6,0.387,0.895,48,21,8,0
3800,21700111,Houston Rockets,New York Knicks,119,97,216,22,Houston Rockets,22,0.365,0.762,46,21,6,4,0.308,0.846,42,23,8,1
3801,21700112,Orlando Magic,Memphis Grizzlies,101,99,200,2,Orlando Magic,2,0.448,0.857,38,25,6,8,0.333,0.688,31,21,12,3
3802,21700113,Minnesota Timberwolves,New Orleans Pelicans,104,98,202,6,Minnesota Timberwolves,6,0.273,0.667,47,20,13,3,0.258,0.857,38,27,13,4
3803,21700114,Toronto Raptors,Denver Nuggets,111,129,240,18,Denver Nuggets,18,0.355,0.64,38,20,7,4,0.5,0.655,43,35,9,4
3804,21700115,Portland Trail Blazers,Utah Jazz,103,112,215,9,Utah Jazz,9,0.265,0.741,53,17,8,8,0.448,0.861,55,16,9,8
3805,21700116,Dallas Mavericks,Los Angeles Clippers,98,119,217,21,Los Angeles Clippers,21,0.333,0.8,38,20,8,5,0.464,0.828,49,27,9,5
3806,21700117,Golden State Warriors,San Antonio Spurs,112,92,204,20,Golden State Warriors,20,0.5,0.75,41,30,11,12,0.292,0.739,46,19,6,8
3807,21700118,Los Angeles Lakers,Portland Trail Blazers,110,113,223,3,Portland Trail Blazers,3,0.222,0.741,32,16,8,8,0.409,0.889,41,22,7,4
3808,21700119,Milwaukee Bucks,Detroit Pistons,96,105,201,9,Detroit Pistons,9,0.4,0.889,36,27,6,6,0.308,0.821,39,21,10,4
3809,21700120,Chicago Bulls,Orlando Magic,105,83,188,22,Chicago Bulls,22,0.483,0.917,48,23,6,2,0.286,0.6,38,23,6,2
3810,21700121,Indiana Pacers,Philadelphia 76ers,110,121,231,11,Philadelphia 76ers,11,0.286,0.632,40,25,6,6,0.5,0.786,50,34,7,9
3811,21700122,Cleveland Cavaliers,Washington Wizards,130,122,252,8,Cleveland Cavaliers,8,0.444,0.929,34,20,11,4,0.393,0.677,37,25,5,2
3812,21700123,Houston Rockets,Atlanta Hawks,119,104,223,15,Houston Rockets,15,0.34,0.826,44,28,14,4,0.333,0.833,41,16,8,8
3813,21700124,Phoenix Suns,New York Knicks,107,120,227,13,New York Knicks,13,0.281,0.811,47,17,7,3,0.308,0.88,49,24,5,7
3814,21700125,New Orleans Pelicans,Dallas Mavericks,99,94,193,5,New Orleans Pelicans,5,0.241,0.769,53,23,9,4,0.265,0.773,47,19,4,7
3815,21700126,Charlotte Hornets,San Antonio Spurs,101,108,209,7,San Antonio Spurs,7,0.333,0.643,46,16,11,1,0.333,0.808,45,31,7,6
3816,21700127,Miami Heat,Denver Nuggets,94,95,189,1,Denver Nuggets,1,0.405,0.636,41,23,9,6,0.391,0.56,41,17,9,6
3817,21700128,Toronto Raptors,Utah Jazz,109,100,209,9,Toronto Raptors,9,0.367,0.786,39,20,9,4,0.348,0.917,33,11,9,5
3818,21700129,Boston Celtics,Oklahoma City Thunder,101,94,195,7,Boston Celtics,7,0.464,0.667,49,23,6,2,0.371,0.786,48,20,4,7
3819,21700130,Brooklyn Nets,Los Angeles Lakers,112,124,236,12,Los Angeles Lakers,12,0.237,0.763,43,23,8,5,0.429,0.704,57,26,10,7
3820,21700131,Memphis Grizzlies,Los Angeles Clippers,113,104,217,9,Memphis Grizzlies,9,0.419,0.833,39,21,8,7,0.154,0.774,43,18,7,7
3821,21700132,Sacramento Kings,Detroit Pistons,99,108,207,9,Detroit Pistons,9,0.476,0.692,32,24,6,1,0.542,0.682,35,28,10,3
3822,21700133,New Orleans Pelicans,Chicago Bulls,96,90,186,6,New Orleans Pelicans,6,0.29,0.773,52,23,9,4,0.262,0.75,58,23,10,5
3823,21700134,Dallas Mavericks,Minnesota Timberwolves,99,112,211,13,Minnesota Timberwolves,13,0.37,0.75,31,18,7,2,0.417,0.8,48,33,7,9
3824,21700135,Golden State Warriors,Denver Nuggets,127,108,235,19,Golden State Warriors,19,0.45,0.529,41,38,13,4,0.25,0.815,46,26,9,6
3825,21700136,Atlanta Hawks,Cleveland Cavaliers,117,115,232,2,Atlanta Hawks,2,0.44,0.706,44,24,4,6,0.278,0.913,47,27,6,6
3826,21700137,Miami Heat,Los Angeles Clippers,104,101,205,3,Miami Heat,3,0.389,0.842,37,23,12,6,0.29,0.8,50,16,11,4
3827,21700138,Boston Celtics,Orlando Magic,104,88,192,16,Boston Celtics,16,0.333,0.75,54,26,10,1,0.207,0.889,45,18,4,4
3828,21700139,Washington Wizards,Toronto Raptors,107,96,203,11,Washington Wizards,11,0.478,0.696,46,19,9,3,0.208,0.63,36,17,7,8
3829,21700140,Utah Jazz,Houston Rockets,110,137,247,27,Houston Rockets,27,0.382,0.875,33,22,7,3,0.59,0.857,42,26,9,7
3830,21700141,Phoenix Suns,San Antonio Spurs,95,112,207,17,San Antonio Spurs,17,0.348,0.591,45,23,5,4,0.5,0.722,43,21,9,4
3831,21700142,Indiana Pacers,New York Knicks,101,108,209,7,New York Knicks,7,0.48,0.882,34,24,6,2,0.261,0.737,46,24,8,7
3832,21700143,Charlotte Hornets,Minnesota Timberwolves,94,112,206,18,Minnesota Timberwolves,18,0.321,0.524,40,24,8,3,0.417,0.867,54,20,4,4
3833,21700144,Oklahoma City Thunder,Portland Trail Blazers,99,103,202,4,Portland Trail Blazers,4,0.333,0.533,32,17,11,2,0.35,0.786,44,20,6,7
3834,21700145,Memphis Grizzlies,Los Angeles Lakers,102,107,209,5,Los Angeles Lakers,5,0.297,0.786,39,23,6,7,0.333,0.783,46,25,5,4
3835,21700146,Boston Celtics,Atlanta Hawks,110,107,217,3,Boston Celtics,3,0.389,0.818,42,28,3,3,0.5,0.8,36,24,8,4
3836,21700147,Brooklyn Nets,Phoenix Suns,98,92,190,6,Brooklyn Nets,6,0.25,0.69,48,20,10,4,0.24,0.743,52,13,8,7
3837,21700148,Miami Heat,Golden State Warriors,80,97,177,17,Golden State Warriors,17,0.308,0.706,44,19,10,6,0.344,0.917,51,20,12,10
3838,21700149,Milwaukee Bucks,Cleveland Cavaliers,119,124,243,5,Cleveland Cavaliers,5,0.433,0.75,36,29,6,8,0.5,0.868,39,18,7,4
3839,21700150,New Orleans Pelicans,Indiana Pacers,117,112,229,5,New Orleans Pelicans,5,0.4,0.682,43,23,6,5,0.375,0.833,41,19,4,4
3840,21700151,Dallas Mavericks,Washington Wizards,113,99,212,14,Dallas Mavericks,14,0.367,0.8,53,26,6,8,0.4,0.781,39,21,5,5
3841,21700152,Charlotte Hornets,New York Knicks,113,118,231,5,New York Knicks,5,0.405,0.824,40,24,8,2,0.48,0.762,35,29,5,5
3842,21700153,Chicago Bulls,Toronto Raptors,114,119,233,5,Toronto Raptors,5,0.379,0.821,37,26,10,2,0.52,0.75,37,22,5,0
3843,21700154,Los Angeles Clippers,San Antonio Spurs,107,120,227,13,San Antonio Spurs,13,0.367,0.706,39,20,6,4,0.536,0.789,39,33,13,3
3844,21700155,Brooklyn Nets,Denver Nuggets,104,112,216,8,Denver Nuggets,8,0.314,0.773,47,22,12,6,0.265,0.75,47,26,16,9
3845,21700156,Philadelphia 76ers,Utah Jazz,104,97,201,7,Philadelphia 76ers,7,0.444,0.8,56,23,5,6,0.231,0.8,45,15,14,6
3846,21700157,Memphis Grizzlies,Portland Trail Blazers,98,97,195,1,Memphis Grizzlies,1,0.368,0.84,34,18,8,10,0.316,0.95,42,11,9,1
3847,21700158,Oklahoma City Thunder,Sacramento Kings,86,94,180,8,Sacramento Kings,8,0.27,0.783,44,15,16,2,0.375,0.917,47,21,6,5
3848,21700159,Indiana Pacers,Detroit Pistons,97,114,211,17,Detroit Pistons,17,0.292,0.778,38,22,8,3,0.444,0.64,50,25,3,5
3849,21700160,New York Knicks,Orlando Magic,99,112,211,13,Orlando Magic,13,0.417,0.769,42,26,7,2,0.464,0.591,29,31,16,7
3850,21700161,Los Angeles Lakers,Boston Celtics,96,107,203,11,Boston Celtics,11,0.208,0.739,48,16,8,8,0.241,0.774,48,20,8,6
3851,21700162,Miami Heat,Phoenix Suns,126,115,241,11,Miami Heat,11,0.4,0.8,53,21,5,4,0.414,0.767,34,20,4,2
3852,21700163,Minnesota Timberwolves,Golden State Warriors,101,125,226,24,Golden State Warriors,24,0.208,0.741,41,21,15,0,0.417,0.778,45,37,10,9
3853,21700164,Los Angeles Lakers,Washington Wizards,95,111,206,16,Washington Wizards,16,0.13,0.732,46,17,9,4,0.333,0.9,45,20,7,4
3854,21700165,New Orleans Pelicans,Toronto Raptors,118,122,240,4,Toronto Raptors,4,0.419,0.68,38,31,7,4,0.381,0.696,48,27,8,4
3855,21700166,Cleveland Cavaliers,Houston Rockets,113,117,230,4,Houston Rockets,4,0.444,0.786,26,24,9,1,0.348,0.806,45,21,11,5
3856,21700167,Philadelphia 76ers,Sacramento Kings,108,109,217,1,Sacramento Kings,1,0.405,0.704,56,23,6,5,0.444,0.607,45,29,6,5
3857,21700168,Oklahoma City Thunder,Denver Nuggets,94,102,196,8,Denver Nuggets,8,0.367,0.5,44,16,15,7,0.333,0.773,45,27,7,7
3858,21700169,Atlanta Hawks,Detroit Pistons,104,111,215,7,Detroit Pistons,7,0.333,0.727,45,28,11,7,0.4,0.778,51,23,7,5
3859,21700170,Charlotte Hornets,Boston Celtics,87,90,177,3,Boston Celtics,3,0.273,0.576,47,20,5,7,0.29,0.84,49,15,6,5
3860,21700171,Indiana Pacers,Chicago Bulls,105,87,192,18,Indiana Pacers,18,0.414,0.583,51,27,8,3,0.259,0.667,43,24,10,3
3861,21700172,Los Angeles Clippers,Oklahoma City Thunder,111,120,231,9,Oklahoma City Thunder,9,0.4,0.7,46,13,4,2,0.423,0.725,40,23,8,7
3862,21700173,Milwaukee Bucks,San Antonio Spurs,94,87,181,7,Milwaukee Bucks,7,0.278,0.5,47,27,10,7,0.31,0.909,43,23,8,6
3863,21700174,Orlando Magic,Phoenix Suns,128,112,240,16,Orlando Magic,16,0.464,0.674,44,29,8,5,0.208,0.76,40,13,8,5
3864,21700175,Miami Heat,Utah Jazz,84,74,158,10,Miami Heat,10,0.4,0.778,48,10,9,6,0.238,0.864,40,12,10,7
3865,21700176,Brooklyn Nets,Portland Trail Blazers,101,97,198,4,Brooklyn Nets,4,0.316,0.579,49,25,7,4,0.348,0.818,51,17,4,4
3866,21700177,Atlanta Hawks,Washington Wizards,94,113,207,19,Washington Wizards,19,0.424,0.706,32,19,11,1,0.292,0.786,42,22,14,10
3867,21700178,Los Angeles Clippers,New Orleans Pelicans,103,111,214,8,New Orleans Pelicans,8,0.385,0.852,37,16,12,1,0.375,0.792,51,26,7,4
3868,21700179,Sacramento Kings,New York Knicks,91,118,209,27,New York Knicks,27,0.318,0.8,42,19,6,4,0.444,0.8,40,29,6,6
3869,21700180,Memphis Grizzlies,Houston Rockets,96,111,207,15,Houston Rockets,15,0.3,0.778,41,23,9,5,0.356,0.75,46,18,14,4
3870,21700181,Cleveland Cavaliers,Dallas Mavericks,111,104,215,7,Cleveland Cavaliers,7,0.387,0.829,53,18,8,3,0.294,0.762,42,21,7,3
3871,21700182,Los Angeles Lakers,Milwaukee Bucks,90,98,188,8,Milwaukee Bucks,8,0.273,0.595,48,21,7,9,0.261,0.846,42,16,11,4
3872,21700183,Chicago Bulls,San Antonio Spurs,94,133,227,39,San Antonio Spurs,39,0.261,0.615,28,22,9,4,0.667,0.813,44,33,5,6
3873,21700184,Philadelphia 76ers,Golden State Warriors,114,135,249,21,Golden State Warriors,21,0.429,0.7,38,30,10,2,0.519,0.962,39,31,15,11
3874,21700185,Orlando Magic,Denver Nuggets,107,125,232,18,Denver Nuggets,18,0.355,0.7,36,24,7,5,0.414,0.778,50,29,9,4
3875,21700186,Minnesota Timberwolves,Phoenix Suns,110,118,228,8,Phoenix Suns,8,0.2,0.8,47,16,12,4,0.385,0.667,46,21,4,10
3876,21700187,Brooklyn Nets,Utah Jazz,106,114,220,8,Utah Jazz,8,0.304,0.744,41,13,7,4,0.379,0.84,44,19,12,3
3877,21700188,Toronto Raptors,Boston Celtics,94,95,189,1,Boston Celtics,1,0.417,0.87,36,18,8,8,0.385,0.789,46,24,9,2
3878,21700189,Miami Heat,Detroit Pistons,103,112,215,9,Detroit Pistons,9,0.351,0.75,39,25,8,5,0.5,0.7,54,24,2,5
3879,21700190,Houston Rockets,Indiana Pacers,118,95,213,23,Houston Rockets,23,0.362,0.833,47,24,10,5,0.364,0.619,41,18,5,7
3880,21700191,Dallas Mavericks,Oklahoma City Thunder,99,112,211,13,Oklahoma City Thunder,13,0.297,0.778,41,18,9,4,0.469,0.758,37,21,10,4
3881,21700192,Sacramento Kings,Washington Wizards,92,110,202,18,Washington Wizards,18,0.522,0.667,35,19,8,4,0.324,0.917,50,30,7,1
3882,21700193,Cleveland Cavaliers,New York Knicks,104,101,205,3,Cleveland Cavaliers,3,0.356,0.818,48,21,7,7,0.32,0.773,49,19,13,3
3883,21700194,Memphis Grizzlies,Milwaukee Bucks,103,110,213,7,Milwaukee Bucks,7,0.423,0.857,37,21,5,1,0.545,0.72,36,23,6,5
3884,21700195,Atlanta Hawks,New Orleans Pelicans,105,106,211,1,New Orleans Pelicans,1,0.472,0.889,36,25,14,1,0.394,0.647,38,31,10,5
3885,21700196,Los Angeles Lakers,Phoenix Suns,100,93,193,7,Los Angeles Lakers,7,0.424,0.615,53,17,6,6,0.269,0.6,54,15,6,4
3886,21700197,Minnesota Timberwolves,Utah Jazz,109,98,207,11,Minnesota Timberwolves,11,0.5,0.862,40,22,9,5,0.35,0.909,31,23,8,4
3887,21700198,Denver Nuggets,Portland Trail Blazers,82,99,181,17,Portland Trail Blazers,17,0.281,0.867,35,13,9,2,0.333,0.889,43,22,12,5
3888,21700199,Orlando Magic,Golden State Warriors,100,110,210,10,Golden State Warriors,10,0.313,0.889,35,26,10,3,0.348,0.875,50,35,4,5
3889,21700200,Philadelphia 76ers,Los Angeles Clippers,109,105,214,4,Philadelphia 76ers,4,0.219,0.743,51,27,9,2,0.375,0.656,34,16,8,4
3890,21700201,Boston Celtics,Brooklyn Nets,109,102,211,7,Boston Celtics,7,0.333,0.815,49,15,8,3,0.4,0.625,43,26,4,3
3891,21700202,Toronto Raptors,Houston Rockets,129,113,242,16,Toronto Raptors,16,0.467,0.786,36,28,11,4,0.308,0.854,48,21,4,4
3892,21700203,San Antonio Spurs,Dallas Mavericks,97,91,188,6,San Antonio Spurs,6,0.231,0.778,47,18,9,7,0.294,0.833,40,18,7,4
3893,21700204,Sacramento Kings,Atlanta Hawks,80,126,206,46,Atlanta Hawks,46,0.214,0.6,29,18,12,2,0.5,0.625,53,40,9,6
3894,21700205,Washington Wizards,Miami Heat,102,93,195,9,Washington Wizards,9,0.474,0.935,40,9,8,2,0.433,0.842,42,15,3,3
3895,21700206,Utah Jazz,New York Knicks,101,106,207,5,New York Knicks,5,0.486,0.941,37,19,5,10,0.429,0.84,45,18,4,5
3896,21700207,Cleveland Cavaliers,Charlotte Hornets,115,107,222,8,Cleveland Cavaliers,8,0.342,0.9,51,25,9,4,0.231,0.679,41,21,7,5
3897,21700208,Indiana Pacers,Memphis Grizzlies,116,113,229,3,Indiana Pacers,3,0.5,0.9,36,29,6,6,0.25,0.773,43,29,5,10
3898,21700209,Detroit Pistons,Milwaukee Bucks,95,99,194,4,Milwaukee Bucks,4,0.405,0.87,45,23,7,3,0.364,0.75,43,24,10,16
3899,21700210,San Antonio Spurs,Minnesota Timberwolves,86,98,184,12,Minnesota Timberwolves,12,0.292,0.867,45,20,4,4,0.5,0.688,41,27,9,4
3900,21700211,Toronto Raptors,New Orleans Pelicans,125,116,241,9,Toronto Raptors,9,0.471,0.95,37,27,8,6,0.37,1,32,31,13,3
3901,21700212,Chicago Bulls,Oklahoma City Thunder,79,92,171,13,Oklahoma City Thunder,13,0.379,0.8,38,16,7,2,0.267,0.865,48,15,7,2
3902,21700213,Orlando Magic,Portland Trail Blazers,94,99,193,5,Portland Trail Blazers,5,0.379,1,41,19,6,4,0.519,0.692,41,21,7,2
3903,21700214,Philadelphia 76ers,Los Angeles Lakers,115,109,224,6,Philadelphia 76ers,6,0.219,0.8,52,27,7,15,0.111,0.815,57,18,7,6
3904,21700215,Golden State Warriors,Boston Celtics,88,92,180,4,Boston Celtics,4,0.313,0.632,47,22,9,10,0.219,0.868,52,15,8,5
3905,21700216,Houston Rockets,Phoenix Suns,142,116,258,26,Houston Rockets,26,0.477,0.921,51,27,9,9,0.333,0.571,47,28,9,5
3906,21700217,Detroit Pistons,Indiana Pacers,100,107,207,7,Indiana Pacers,7,0.424,0.8,43,20,4,8,0.536,0.667,51,22,4,5
3907,21700218,Miami Heat,Washington Wizards,91,88,179,3,Miami Heat,3,0.286,0.722,52,21,6,7,0.286,0.875,46,18,4,4
3908,21700219,Utah Jazz,Brooklyn Nets,107,118,225,11,Brooklyn Nets,11,0.462,0.708,39,21,6,6,0.459,0.75,36,27,8,2
3909,21700220,Los Angeles Clippers,Cleveland Cavaliers,113,118,231,5,Cleveland Cavaliers,5,0.286,0.786,55,29,7,10,0.333,0.793,51,24,9,4
3910,21700221,New York Knicks,Toronto Raptors,84,107,191,23,Toronto Raptors,23,0.391,0.882,43,17,7,4,0.346,0.909,40,29,4,11
3911,21700222,Charlotte Hornets,Chicago Bulls,120,123,243,3,Chicago Bulls,3,0.476,0.765,42,19,3,2,0.5,0.923,35,26,9,2
3912,21700223,Oklahoma City Thunder,San Antonio Spurs,101,104,205,3,San Antonio Spurs,3,0.391,0.667,41,24,7,3,0.4,0.786,44,23,6,7
3913,21700224,Minnesota Timberwolves,Dallas Mavericks,111,87,198,24,Minnesota Timberwolves,24,0.433,0.87,48,27,7,0,0.211,0.882,41,18,3,3
3914,21700225,Portland Trail Blazers,Sacramento Kings,82,86,168,4,Sacramento Kings,4,0.28,0.938,44,13,8,1,0.286,0.667,43,20,11,5
3915,21700226,New Orleans Pelicans,Denver Nuggets,114,146,260,32,Denver Nuggets,32,0.364,0.6,29,32,2,0,0.514,0.762,48,37,5,4
3916,21700227,Phoenix Suns,Los Angeles Lakers,122,113,235,9,Phoenix Suns,9,0.406,0.684,44,28,10,5,0.28,0.667,49,26,7,10
3917,21700228,Los Angeles Clippers,Charlotte Hornets,87,102,189,15,Charlotte Hornets,15,0.276,0.684,44,18,5,6,0.423,0.793,49,20,7,9
3918,21700229,Utah Jazz,Orlando Magic,125,85,210,40,Utah Jazz,40,0.412,0.944,54,31,10,4,0.276,0.652,46,13,10,5
3919,21700230,Boston Celtics,Atlanta Hawks,110,99,209,11,Boston Celtics,11,0.471,0.8,41,21,9,6,0.375,0.8,35,24,7,1
3920,21700231,Golden State Warriors,Philadelphia 76ers,124,116,240,8,Golden State Warriors,8,0.304,0.85,48,25,5,6,0.345,0.75,40,28,8,5
3921,21700232,Houston Rockets,Memphis Grizzlies,105,83,188,22,Houston Rockets,22,0.419,0.81,45,21,8,9,0.259,0.737,48,18,6,7
3922,21700233,Milwaukee Bucks,Dallas Mavericks,79,111,190,32,Dallas Mavericks,32,0.24,0.548,38,13,8,5,0.5,0.842,49,27,7,2
3923,21700234,Sacramento Kings,Portland Trail Blazers,90,102,192,12,Portland Trail Blazers,12,0.471,0.778,36,14,9,4,0.476,0.762,44,19,6,8
3924,21700235,Indiana Pacers,Miami Heat,120,95,215,25,Indiana Pacers,25,0.478,0.875,42,33,9,7,0.351,0.857,35,21,8,2
3925,21700236,Golden State Warriors,Brooklyn Nets,118,111,229,7,Golden State Warriors,7,0.417,0.696,57,29,8,14,0.333,0.692,52,24,7,2
3926,21700237,Washington Wizards,Toronto Raptors,91,100,191,9,Toronto Raptors,9,0.579,0.571,43,20,5,3,0.256,0.714,48,20,8,7
3927,21700238,Detroit Pistons,Minnesota Timberwolves,100,97,197,3,Detroit Pistons,3,0.32,0.7,37,25,10,2,0.227,0.667,38,23,11,4
3928,21700239,Chicago Bulls,Phoenix Suns,105,113,218,8,Phoenix Suns,8,0.333,0.643,47,20,5,1,0.259,0.727,48,32,5,4
3929,21700240,Denver Nuggets,Los Angeles Lakers,109,127,236,18,Los Angeles Lakers,18,0.419,0.686,47,18,8,8,0.375,0.563,46,36,11,5
3930,21700241,Minnesota Timberwolves,Charlotte Hornets,102,118,220,16,Charlotte Hornets,16,0.222,0.846,38,13,8,6,0.423,0.793,52,22,5,7
3931,21700242,Cleveland Cavaliers,Detroit Pistons,116,88,204,28,Cleveland Cavaliers,28,0.485,0.941,42,28,4,2,0.433,0.538,34,23,7,2
3932,21700243,Indiana Pacers,Orlando Magic,105,97,202,8,Indiana Pacers,8,0.4,0.793,48,25,17,4,0.342,0.609,50,23,6,7
3933,21700244,Utah Jazz,Philadelphia 76ers,86,107,193,21,Philadelphia 76ers,21,0.321,0.895,34,18,16,4,0.267,0.682,55,20,11,7
3934,21700245,Los Angeles Clippers,New York Knicks,85,107,192,22,New York Knicks,22,0.313,0.714,36,20,12,3,0.382,0.96,51,24,11,5
3935,21700246,Portland Trail Blazers,Memphis Grizzlies,100,92,192,8,Portland Trail Blazers,8,0.4,0.875,60,11,1,9,0.267,0.783,35,23,6,9
3936,21700247,Washington Wizards,Milwaukee Bucks,99,88,187,11,Washington Wizards,11,0.375,0.706,46,23,4,1,0.182,0.737,33,17,10,7
3937,21700248,Oklahoma City Thunder,New Orleans Pelicans,107,114,221,7,New Orleans Pelicans,7,0.314,0.769,40,22,14,2,0.28,0.781,49,26,8,3
3938,21700249,Boston Celtics,Dallas Mavericks,110,102,212,8,Boston Celtics,8,0.361,0.808,53,24,8,4,0.212,0.85,45,18,7,3
3939,21700250,Atlanta Hawks,San Antonio Spurs,85,96,181,11,San Antonio Spurs,11,0.267,0.375,38,21,7,7,0.323,1,52,29,7,5
3940,21700251,Denver Nuggets,Sacramento Kings,114,98,212,16,Denver Nuggets,16,0.469,0.75,49,18,6,3,0.4,0.889,34,18,11,6
3941,21700252,Chicago Bulls,Los Angeles Lakers,94,103,197,9,Los Angeles Lakers,9,0.306,0.688,54,22,4,4,0.325,0.72,53,23,7,6
3942,21700253,Washington Wizards,Charlotte Hornets,124,129,253,5,Charlotte Hornets,5,0.333,0.773,43,25,4,6,0.357,0.825,48,23,5,5
3943,21700254,Brooklyn Nets,Cleveland Cavaliers,109,119,228,10,Cleveland Cavaliers,10,0.378,0.688,42,26,5,2,0.412,0.704,33,21,8,2
3944,21700255,Portland Trail Blazers,Philadelphia 76ers,81,101,182,20,Philadelphia 76ers,20,0.269,0.583,48,14,8,6,0.344,0.706,57,23,12,8
3945,21700256,Los Angeles Clippers,Atlanta Hawks,116,103,219,13,Los Angeles Clippers,13,0.5,0.684,33,30,7,4,0.345,0.867,36,26,10,2
3946,21700257,Boston Celtics,Miami Heat,98,104,202,6,Miami Heat,6,0.346,0.704,37,19,11,4,0.357,0.875,48,20,3,4
3947,21700258,Toronto Raptors,New York Knicks,100,108,208,8,New York Knicks,8,0.368,0.667,42,21,4,10,0.333,0.824,47,29,8,7
3948,21700259,Denver Nuggets,Houston Rockets,95,125,220,30,Houston Rockets,30,0.303,0.652,43,19,11,5,0.439,0.739,46,30,13,4
3949,21700260,Dallas Mavericks,Memphis Grizzlies,95,94,189,1,Dallas Mavericks,1,0.321,0.5,40,23,9,2,0.241,0.929,52,25,7,6
3950,21700261,Orlando Magic,Minnesota Timberwolves,118,124,242,6,Minnesota Timberwolves,6,0.324,0.636,44,28,4,4,0.348,0.8,42,22,9,3
3951,21700262,San Antonio Spurs,New Orleans Pelicans,90,107,197,17,New Orleans Pelicans,17,0.25,0.933,39,22,10,5,0.292,0.917,45,23,7,2
3952,21700263,Golden State Warriors,Oklahoma City Thunder,91,108,199,17,Oklahoma City Thunder,17,0.323,0.833,39,22,11,8,0.32,0.692,50,16,15,5
3953,21700264,Milwaukee Bucks,Phoenix Suns,113,107,220,6,Milwaukee Bucks,6,0.276,0.677,42,19,16,6,0.318,0.788,60,15,7,9
3954,21700265,Chicago Bulls,Utah Jazz,80,110,190,30,Utah Jazz,30,0.238,0.85,43,15,3,1,0.4,0.842,45,23,10,5
3955,21700266,Los Angeles Lakers,Sacramento Kings,102,113,215,11,Sacramento Kings,11,0.517,0.6,32,27,8,4,0.476,0.643,44,26,9,4
3956,21700267,Portland Trail Blazers,Brooklyn Nets,127,125,252,2,Portland Trail Blazers,2,0.4,0.714,45,24,5,13,0.4,0.714,47,25,4,6
3957,21700268,New York Knicks,Atlanta Hawks,104,116,220,12,Atlanta Hawks,12,0.4,0.857,38,30,1,9,0.419,0.75,40,30,7,2
3958,21700269,Orlando Magic,Boston Celtics,103,118,221,15,Boston Celtics,15,0.375,0.632,51,21,6,4,0.405,0.68,46,27,6,10
3959,21700270,Charlotte Hornets,Cleveland Cavaliers,99,100,199,1,Cleveland Cavaliers,1,0.379,0.593,55,25,4,3,0.333,0.733,45,25,4,7
3960,21700271,Toronto Raptors,Indiana Pacers,104,107,211,3,Indiana Pacers,3,0.3,0.75,42,17,14,4,0.423,0.741,41,19,10,3
3961,21700272,Miami Heat,Minnesota Timberwolves,109,97,206,12,Miami Heat,12,0.487,0.875,42,29,4,4,0.412,0.615,44,21,9,3
3962,21700273,Detroit Pistons,Oklahoma City Thunder,99,98,197,1,Detroit Pistons,1,0.378,0.778,43,22,6,5,0.25,0.75,45,22,13,6
3963,21700274,Memphis Grizzlies,Denver Nuggets,92,104,196,12,Denver Nuggets,12,0.375,0.688,23,28,10,3,0.281,0.577,50,24,9,4
3964,21700275,New Orleans Pelicans,Phoenix Suns,115,91,206,24,New Orleans Pelicans,24,0.333,0.727,49,29,10,4,0.1,0.833,48,12,9,6
3965,21700276,Chicago Bulls,Golden State Warriors,94,143,237,49,Golden State Warriors,49,0.361,0.733,40,18,7,2,0.444,1,49,36,11,11
3966,21700277,San Antonio Spurs,Charlotte Hornets,106,86,192,20,San Antonio Spurs,20,0.24,0.88,45,22,8,7,0.16,0.769,42,20,7,4
3967,21700278,Orlando Magic,Philadelphia 76ers,111,130,241,19,Philadelphia 76ers,19,0.387,0.677,41,22,8,5,0.471,0.9,53,35,7,2
3968,21700279,Portland Trail Blazers,Washington Wizards,108,105,213,3,Portland Trail Blazers,3,0.375,0.773,41,18,3,6,0.348,0.938,37,20,9,4
3969,21700280,Toronto Raptors,Atlanta Hawks,112,78,190,34,Toronto Raptors,34,0.406,0.778,46,31,10,3,0.222,0.87,32,18,9,1
3970,21700281,Boston Celtics,Indiana Pacers,108,98,206,10,Boston Celtics,10,0.4,0.889,30,22,8,4,0.304,1,36,20,9,2
3971,21700282,New York Knicks,Houston Rockets,102,117,219,15,Houston Rockets,15,0.235,0.737,40,29,4,3,0.383,0.773,42,30,12,6
3972,21700283,Oklahoma City Thunder,Dallas Mavericks,81,97,178,16,Dallas Mavericks,16,0.371,0.769,39,24,12,1,0.429,0.727,43,25,11,5
3973,21700284,New Orleans Pelicans,Golden State Warriors,95,110,205,15,Golden State Warriors,15,0.355,0.696,45,24,2,9,0.303,0.815,44,30,11,6
3974,21700285,Milwaukee Bucks,Utah Jazz,108,121,229,13,Utah Jazz,13,0.381,0.783,40,19,5,6,0.563,0.579,30,31,8,2
3975,21700286,Los Angeles Clippers,Sacramento Kings,97,95,192,2,Los Angeles Clippers,2,0.321,0.923,37,23,11,5,0.524,0.889,37,19,9,8
3976,21700287,Miami Heat,Chicago Bulls,100,93,193,7,Miami Heat,7,0.406,0.826,45,19,9,5,0.424,0.813,47,25,10,2
3977,21700288,Phoenix Suns,Minnesota Timberwolves,108,119,227,11,Minnesota Timberwolves,11,0.5,0.75,37,25,6,1,0.429,0.706,48,24,12,5
3978,21700289,Brooklyn Nets,Memphis Grizzlies,98,88,186,10,Brooklyn Nets,10,0.448,0.826,43,19,7,7,0.32,0.889,35,15,8,3
3979,21700290,Orlando Magic,Indiana Pacers,109,121,230,12,Indiana Pacers,12,0.39,0.813,35,22,4,9,0.577,0.846,43,25,7,8
3980,21700291,Cleveland Cavaliers,Philadelphia 76ers,113,91,204,22,Cleveland Cavaliers,22,0.405,0.8,46,25,7,3,0.107,0.8,53,15,6,2
3981,21700292,Detroit Pistons,Boston Celtics,118,108,226,10,Detroit Pistons,10,0.44,0.826,40,26,8,2,0.485,0.571,36,27,2,4
3982,21700293,Portland Trail Blazers,New York Knicks,103,91,194,12,Portland Trail Blazers,12,0.333,0.846,45,18,10,3,0.333,0.727,51,13,3,3
3983,21700294,Brooklyn Nets,Houston Rockets,103,117,220,14,Houston Rockets,14,0.256,0.765,43,24,5,4,0.4,0.65,42,31,8,4
3984,21700295,Dallas Mavericks,San Antonio Spurs,108,115,223,7,San Antonio Spurs,7,0.438,0.706,40,25,7,0,0.417,0.905,43,27,7,5
3985,21700296,Sacramento Kings,Golden State Warriors,110,106,216,4,Sacramento Kings,4,0.529,0.81,36,27,7,6,0.432,0.714,36,31,9,6
3986,21700297,Los Angeles Lakers,Los Angeles Clippers,115,120,235,5,Los Angeles Clippers,5,0.367,0.667,43,23,10,5,0.357,0.933,44,19,7,3
3987,21700298,Miami Heat,Cleveland Cavaliers,97,108,205,11,Cleveland Cavaliers,11,0.323,0.65,42,24,7,5,0.333,0.739,45,21,12,2
3988,21700299,Phoenix Suns,Chicago Bulls,104,99,203,5,Phoenix Suns,5,0.367,0.739,57,25,4,4,0.4,0.7,41,27,11,7
3989,21700300,Washington Wizards,Minnesota Timberwolves,92,89,181,3,Washington Wizards,3,0.357,0.588,44,23,5,4,0.333,0.643,49,27,3,1
3990,21700301,Denver Nuggets,Utah Jazz,77,106,183,29,Utah Jazz,29,0.206,0.875,42,13,6,4,0.438,0.889,43,24,7,6
3991,21700302,Milwaukee Bucks,Sacramento Kings,112,87,199,25,Milwaukee Bucks,25,0.409,0.613,38,27,13,5,0.294,0.69,40,15,5,2
3992,21700303,Phoenix Suns,Detroit Pistons,107,131,238,24,Detroit Pistons,24,0.318,0.786,37,21,11,4,0.464,0.762,44,31,11,6
3993,21700304,Oklahoma City Thunder,Orlando Magic,108,121,229,13,Orlando Magic,13,0.375,0.667,48,17,8,5,0.433,0.692,37,28,9,7
3994,21700305,Washington Wizards,Philadelphia 76ers,113,118,231,5,Philadelphia 76ers,5,0.409,0.865,35,22,8,4,0.167,0.641,64,23,6,8
3995,21700306,Miami Heat,New York Knicks,86,115,201,29,New York Knicks,29,0.263,0.6,31,21,13,4,0.385,0.846,52,26,10,5
3996,21700307,Charlotte Hornets,Toronto Raptors,113,126,239,13,Toronto Raptors,13,0.474,0.857,36,26,6,2,0.438,0.727,39,24,6,2
3997,21700308,Indiana Pacers,Houston Rockets,97,118,215,21,Houston Rockets,21,0.25,1,36,18,9,7,0.45,0.762,49,26,9,0
3998,21700309,Minnesota Timberwolves,New Orleans Pelicans,120,102,222,18,Minnesota Timberwolves,18,0.391,0.895,44,30,10,1,0.4,0.909,28,27,8,2
3999,21700310,Brooklyn Nets,Dallas Mavericks,109,104,213,5,Brooklyn Nets,5,0.379,0.56,52,25,5,1,0.333,0.81,44,26,5,3
4000,21700311,Memphis Grizzlies,San Antonio Spurs,95,104,199,9,San Antonio Spurs,9,0.5,0.875,37,21,4,1,0.4,0.833,32,22,9,5
4001,21700312,Golden State Warriors,Los Angeles Lakers,127,123,250,4,Golden State Warriors,4,0.4,0.75,49,30,10,4,0.375,0.8,34,30,12,5
4002,21700313,Cleveland Cavaliers,Atlanta Hawks,121,114,235,7,Cleveland Cavaliers,7,0.462,0.778,40,30,9,5,0.387,0.833,29,24,9,4
4003,21700314,Philadelphia 76ers,Boston Celtics,97,108,205,11,Boston Celtics,11,0.5,0.611,45,24,11,1,0.414,0.8,40,25,7,7
4004,21700315,Chicago Bulls,Denver Nuggets,110,111,221,1,Denver Nuggets,1,0.375,0.619,40,25,4,4,0.387,0.742,44,22,7,4
4005,21700316,Milwaukee Bucks,Portland Trail Blazers,103,91,194,12,Milwaukee Bucks,12,0.3,0.867,35,19,11,5,0.261,0.882,50,17,5,3
4006,21700317,Utah Jazz,Los Angeles Clippers,126,107,233,19,Utah Jazz,19,0.486,0.786,33,38,13,2,0.345,0.7,36,23,8,6
4007,21700318,Golden State Warriors,Orlando Magic,133,112,245,21,Golden State Warriors,21,0.5,1,42,46,9,11,0.393,0.722,35,23,9,4
4008,21700319,Indiana Pacers,Toronto Raptors,115,120,235,5,Toronto Raptors,5,0.308,0.773,46,21,7,5,0.313,0.667,47,29,6,8
4009,21700320,Detroit Pistons,Washington Wizards,91,109,200,18,Washington Wizards,18,0.3,0.632,32,20,7,5,0.333,0.842,49,28,12,6
4010,21700321,Charlotte Hornets,Miami Heat,100,105,205,5,Miami Heat,5,0.25,0.905,40,21,9,5,0.4,0.619,39,25,8,4
4011,21700322,Sacramento Kings,Chicago Bulls,107,106,213,1,Sacramento Kings,1,0.333,0.786,43,29,5,10,0.361,0.692,38,30,8,2
4012,21700323,San Antonio Spurs,Memphis Grizzlies,95,79,174,16,San Antonio Spurs,16,0.407,0.688,43,20,8,5,0.333,0.778,38,19,8,6
4013,21700324,Minnesota Timberwolves,Oklahoma City Thunder,107,111,218,4,Oklahoma City Thunder,4,0.5,0.81,26,26,7,5,0.308,0.955,42,28,7,7
4014,21700325,New Orleans Pelicans,Utah Jazz,108,114,222,6,Utah Jazz,6,0.5,0.6,42,28,4,7,0.4,0.72,46,25,7,3
4015,21700326,Phoenix Suns,Boston Celtics,111,116,227,5,Boston Celtics,5,0.292,0.727,47,24,8,1,0.452,0.783,31,32,8,6
4016,21700327,Los Angeles Clippers,Dallas Mavericks,82,108,190,26,Dallas Mavericks,26,0.273,0.696,38,16,8,6,0.457,0.769,54,24,4,7
4017,21700328,Atlanta Hawks,Brooklyn Nets,114,102,216,12,Atlanta Hawks,12,0.37,0.714,47,18,12,5,0.405,0.81,46,26,1,8
4018,21700329,Memphis Grizzlies,Cleveland Cavaliers,111,116,227,5,Cleveland Cavaliers,5,0.565,0.857,36,31,6,4,0.458,0.913,31,24,8,7
4019,21700330,Detroit Pistons,Philadelphia 76ers,103,108,211,5,Philadelphia 76ers,5,0.29,0.813,36,20,8,2,0.357,0.875,47,27,7,4
4020,21700331,Sacramento Kings,Milwaukee Bucks,104,109,213,5,Milwaukee Bucks,5,0.458,0.905,33,20,7,1,0.316,0.833,36,20,9,6
4021,21700332,Los Angeles Lakers,Denver Nuggets,100,115,215,15,Denver Nuggets,15,0.3,0.714,52,21,5,2,0.387,0.821,39,26,8,6
4022,21700333,New Orleans Pelicans,Portland Trail Blazers,123,116,239,7,New Orleans Pelicans,7,0.484,0.72,48,22,2,3,0.314,1,44,20,6,3
4023,21700334,Orlando Magic,New York Knicks,105,100,205,5,Orlando Magic,5,0.214,0.862,42,19,8,3,0.333,0.9,45,18,4,4
4024,21700335,Golden State Warriors,Miami Heat,123,95,218,28,Golden State Warriors,28,0.367,0.75,41,32,4,4,0.378,0.882,28,17,5,4
4025,21700336,Los Angeles Clippers,Minnesota Timberwolves,106,112,218,6,Minnesota Timberwolves,6,0.441,0.773,37,21,3,7,0.308,0.903,42,22,9,1
4026,21700337,San Antonio Spurs,Oklahoma City Thunder,87,90,177,3,Oklahoma City Thunder,3,0.286,0.739,39,14,11,9,0.273,0.476,47,21,8,2
4027,21700338,Houston Rockets,Los Angeles Lakers,118,95,213,23,Houston Rockets,23,0.378,0.824,43,17,10,4,0.321,0.733,45,16,9,6
4028,21700339,Orlando Magic,Charlotte Hornets,94,104,198,10,Charlotte Hornets,10,0.313,0.857,40,24,5,5,0.176,0.825,52,17,13,5
4029,21700340,New York Knicks,Indiana Pacers,97,115,212,18,Indiana Pacers,18,0.261,0.688,43,26,4,2,0.423,0.8,44,28,10,5
4030,21700341,Phoenix Suns,Philadelphia 76ers,115,101,216,14,Phoenix Suns,14,0.455,0.773,46,25,10,9,0.233,1,47,23,9,6
4031,21700342,Brooklyn Nets,Atlanta Hawks,110,90,200,20,Brooklyn Nets,20,0.417,0.867,52,29,7,6,0.3,0.778,38,18,9,2
4032,21700343,Milwaukee Bucks,Boston Celtics,100,111,211,11,Boston Celtics,11,0.429,0.875,28,17,6,2,0.455,0.789,45,25,5,3
4033,21700344,Cleveland Cavaliers,Chicago Bulls,113,91,204,22,Cleveland Cavaliers,22,0.361,0.941,46,22,6,2,0.265,0.778,43,21,4,5
4034,21700345,Minnesota Timberwolves,Memphis Grizzlies,92,95,187,3,Memphis Grizzlies,3,0.235,0.947,34,17,9,2,0.286,0.875,41,22,6,8
4035,21700346,Golden State Warriors,New Orleans Pelicans,125,115,240,10,Golden State Warriors,10,0.485,0.704,40,36,14,5,0.41,0.6,47,33,11,4
4036,21700347,Denver Nuggets,Dallas Mavericks,105,122,227,17,Dallas Mavericks,17,0.389,0.652,49,25,5,5,0.462,0.706,42,26,4,6
4037,21700348,Detroit Pistons,San Antonio Spurs,93,96,189,3,San Antonio Spurs,3,0.296,0.625,42,15,8,2,0.452,1,51,30,2,7
4038,21700349,Washington Wizards,Utah Jazz,69,116,185,47,Utah Jazz,47,0.2,0.826,31,9,8,2,0.471,0.778,52,29,9,3
4039,21700350,Phoenix Suns,Toronto Raptors,113,126,239,13,Toronto Raptors,13,0.375,0.789,35,23,7,4,0.417,0.885,42,30,13,4
4040,21700351,Utah Jazz,Oklahoma City Thunder,94,100,194,6,Oklahoma City Thunder,6,0.333,0.714,35,18,16,5,0.222,0.692,46,18,11,6
4041,21700352,Washington Wizards,Portland Trail Blazers,106,92,198,14,Washington Wizards,14,0.44,0.786,44,20,16,6,0.444,0.762,41,18,2,5
4042,21700353,Sacramento Kings,Cleveland Cavaliers,95,101,196,6,Cleveland Cavaliers,6,0.313,0.538,45,25,15,5,0.359,0.619,43,28,5,3
4043,21700354,Chicago Bulls,Indiana Pacers,96,98,194,2,Indiana Pacers,2,0.385,0.5,46,18,3,5,0.353,0.8,39,21,7,5
4044,21700355,Atlanta Hawks,Orlando Magic,106,110,216,4,Orlando Magic,4,0.407,0.75,49,25,7,3,0.214,0.667,52,17,9,7
4045,21700356,Dallas Mavericks,Boston Celtics,90,97,187,7,Boston Celtics,7,0.321,0.765,45,19,7,5,0.353,0.765,53,25,8,8
4046,21700357,Memphis Grizzlies,New York Knicks,88,99,187,11,New York Knicks,11,0.429,0.818,27,14,8,5,0.643,0.741,42,22,8,3
4047,21700358,Golden State Warriors,Charlotte Hornets,101,87,188,14,Golden State Warriors,14,0.367,0.769,47,26,8,12,0.316,0.765,49,17,5,3
4048,21700359,Detroit Pistons,Milwaukee Bucks,100,104,204,4,Milwaukee Bucks,4,0.333,0.667,46,20,5,0,0.364,0.692,41,22,7,5
4049,21700360,Denver Nuggets,New Orleans Pelicans,114,123,237,9,New Orleans Pelicans,9,0.457,0.727,40,22,7,4,0.387,0.655,49,28,4,5
4050,21700361,Miami Heat,San Antonio Spurs,105,117,222,12,San Antonio Spurs,12,0.529,0.75,29,28,7,4,0.52,0.857,34,30,6,7
4051,21700362,Minnesota Timberwolves,Los Angeles Clippers,113,107,220,6,Minnesota Timberwolves,6,0.368,0.762,46,29,4,7,0.313,0.6,43,23,6,3
4052,21700363,Los Angeles Lakers,Philadelphia 76ers,107,104,211,3,Los Angeles Lakers,3,0.393,0.5,44,22,13,7,0.385,0.762,44,29,3,13
4053,21700364,Washington Wizards,Phoenix Suns,109,99,208,10,Washington Wizards,10,0.381,0.76,38,25,6,4,0.304,0.714,42,22,5,5
4054,21700365,Oklahoma City Thunder,Brooklyn Nets,95,100,195,5,Brooklyn Nets,5,0.292,0.522,54,18,6,3,0.297,0.633,49,24,3,7
4055,21700366,Houston Rockets,Utah Jazz,112,101,213,11,Houston Rockets,11,0.429,0.75,46,22,10,5,0.367,0.815,32,17,10,5
4056,21700367,Chicago Bulls,Charlotte Hornets,119,111,230,8,Chicago Bulls,8,0.333,0.773,56,23,5,7,0.345,0.724,50,22,7,11
4057,21700368,Golden State Warriors,Detroit Pistons,102,98,200,4,Golden State Warriors,4,0.269,0.773,45,29,5,15,0.444,0.526,49,20,8,2
4058,21700369,Cleveland Cavaliers,Indiana Pacers,102,106,208,4,Indiana Pacers,4,0.306,0.773,44,23,4,4,0.385,0.625,49,21,7,3
4059,21700370,Denver Nuggets,Orlando Magic,103,89,192,14,Denver Nuggets,14,0.286,0.813,44,21,7,7,0.238,0.783,42,18,5,7
4060,21700371,Toronto Raptors,Memphis Grizzlies,116,107,223,9,Toronto Raptors,9,0.419,0.879,36,21,8,3,0.333,0.727,35,24,8,3
4061,21700372,Dallas Mavericks,Milwaukee Bucks,102,109,211,7,Milwaukee Bucks,7,0.417,0.846,36,18,6,2,0.333,0.853,40,20,10,6
4062,21700373,Sacramento Kings,New Orleans Pelicans,116,109,225,7,Sacramento Kings,7,0.433,0.643,46,21,12,4,0.357,0.895,35,19,7,3
4063,21700374,Boston Celtics,San Antonio Spurs,102,105,207,3,San Antonio Spurs,3,0.289,0.882,39,14,10,0,0.296,0.875,46,16,6,3
4064,21700375,Washington Wizards,Los Angeles Clippers,112,113,225,1,Los Angeles Clippers,1,0.406,0.652,44,33,5,2,0.438,0.875,33,22,8,4
4065,21700376,Miami Heat,Brooklyn Nets,101,89,190,12,Miami Heat,12,0.296,0.643,44,15,6,8,0.259,0.842,43,16,3,3
4066,21700377,Los Angeles Lakers,Charlotte Hornets,110,99,209,11,Los Angeles Lakers,11,0.333,0.714,46,24,7,5,0.32,0.643,43,21,7,3
4067,21700378,Orlando Magic,Atlanta Hawks,110,117,227,7,Atlanta Hawks,7,0.382,0.875,39,39,7,2,0.515,0.72,40,33,7,6
4068,21700379,Philadelphia 76ers,Cleveland Cavaliers,98,105,203,7,Cleveland Cavaliers,7,0.333,1,39,31,10,2,0.483,0.76,33,26,12,2
4069,21700380,New York Knicks,Chicago Bulls,102,104,206,2,Chicago Bulls,2,0.292,1,40,25,6,3,0.28,0.565,40,28,10,7
4070,21700381,Utah Jazz,Milwaukee Bucks,100,117,217,17,Milwaukee Bucks,17,0.348,0.703,35,20,7,3,0.412,0.846,41,22,8,6
4071,21700382,Oklahoma City Thunder,Memphis Grizzlies,102,101,203,1,Oklahoma City Thunder,1,0.353,0.581,47,18,7,5,0.394,0.588,47,23,5,5
4072,21700383,San Antonio Spurs,Phoenix Suns,104,101,205,3,San Antonio Spurs,3,0.316,0.72,52,18,5,6,0.28,0.8,40,11,4,1
4073,21700384,Houston Rockets,Portland Trail Blazers,124,117,241,7,Houston Rockets,7,0.4,0.81,35,14,13,2,0.439,0.75,33,19,4,5
4074,21700385,Toronto Raptors,Sacramento Kings,102,87,189,15,Toronto Raptors,15,0.297,0.684,44,22,8,2,0.435,0.5,42,15,7,6
4075,21700386,Boston Celtics,Detroit Pistons,91,81,172,10,Boston Celtics,10,0.367,0.778,50,16,4,4,0.303,0.789,46,14,7,4
4076,21700387,Denver Nuggets,Indiana Pacers,116,126,242,10,Indiana Pacers,10,0.405,0.813,47,24,7,5,0.4,0.818,40,24,6,2
4077,21700388,Dallas Mavericks,Minnesota Timberwolves,92,97,189,5,Minnesota Timberwolves,5,0.355,0.778,33,23,6,5,0.368,0.783,45,19,7,2
4078,21700389,Philadelphia 76ers,New Orleans Pelicans,124,131,255,7,New Orleans Pelicans,7,0.31,0.9,47,26,5,4,0.625,0.75,33,31,11,9
4079,21700390,Atlanta Hawks,New York Knicks,107,111,218,4,New York Knicks,4,0.29,0.8,35,22,5,4,0.294,0.824,33,16,9,4
4080,21700391,Boston Celtics,Chicago Bulls,85,108,193,23,Chicago Bulls,23,0.25,0.643,46,22,2,2,0.414,0.72,46,23,9,3
4081,21700392,New Orleans Pelicans,Houston Rockets,123,130,253,7,Houston Rockets,7,0.545,0.538,41,32,6,2,0.378,0.68,36,30,12,7
4082,21700393,Miami Heat,Memphis Grizzlies,107,82,189,25,Miami Heat,25,0.519,0.792,35,24,8,8,0.296,0.667,31,17,6,1
4083,21700394,Charlotte Hornets,Oklahoma City Thunder,116,103,219,13,Charlotte Hornets,13,0.52,0.708,41,22,7,4,0.346,0.96,39,16,4,2
4084,21700395,Portland Trail Blazers,Golden State Warriors,104,111,215,7,Golden State Warriors,7,0.25,0.92,39,14,11,2,0.5,0.765,42,26,5,9
4085,21700396,Toronto Raptors,Los Angeles Clippers,91,96,187,5,Los Angeles Clippers,5,0.241,0.769,43,18,8,6,0.222,0.833,57,18,6,7
4086,21700397,Atlanta Hawks,Cleveland Cavaliers,114,123,237,9,Cleveland Cavaliers,9,0.444,0.923,37,26,8,4,0.526,0.7,37,35,5,2
4087,21700398,Denver Nuggets,Detroit Pistons,103,84,187,19,Denver Nuggets,19,0.333,0.929,44,27,8,3,0.36,0.864,40,17,7,2
4088,21700399,Los Angeles Lakers,New York Knicks,109,113,222,4,New York Knicks,4,0.371,0.8,52,24,6,6,0.409,0.727,49,25,7,7
4089,21700400,Washington Wizards,Brooklyn Nets,98,103,201,5,Brooklyn Nets,5,0.182,0.818,49,18,8,3,0.233,0.758,53,26,4,6
4090,21700401,Philadelphia 76ers,Minnesota Timberwolves,118,112,230,6,Philadelphia 76ers,6,0.423,0.844,52,32,6,3,0.172,0.704,50,19,14,7
4091,21700402,San Antonio Spurs,Dallas Mavericks,89,95,184,6,Dallas Mavericks,6,0.25,0.632,49,20,4,5,0.375,0.833,49,17,8,2
4092,21700403,Phoenix Suns,Sacramento Kings,92,99,191,7,Sacramento Kings,7,0.219,0.786,45,22,5,4,0.318,0.727,45,21,9,3
4093,21700404,Oklahoma City Thunder,Indiana Pacers,100,95,195,5,Oklahoma City Thunder,5,0.448,0.625,52,26,10,6,0.355,0.667,42,18,11,7
4094,21700405,Los Angeles Clippers,Orlando Magic,106,95,201,11,Los Angeles Clippers,11,0.462,0.8,51,25,10,6,0.333,0.571,45,24,6,6
4095,21700406,Memphis Grizzlies,Washington Wizards,87,93,180,6,Washington Wizards,6,0.357,0.938,47,18,6,2,0.409,0.5,44,21,7,8
4096,21700407,Denver Nuggets,Boston Celtics,118,124,242,6,Boston Celtics,6,0.321,0.731,48,22,8,4,0.44,0.792,30,29,10,7
4097,21700408,Portland Trail Blazers,Miami Heat,102,95,197,7,Portland Trail Blazers,7,0.357,0.87,33,14,7,2,0.433,0.609,36,19,6,1
4098,21700409,Utah Jazz,Chicago Bulls,100,103,203,3,Chicago Bulls,3,0.3,1,48,24,3,8,0.412,0.667,46,21,9,3
4099,21700410,Milwaukee Bucks,New Orleans Pelicans,108,115,223,7,New Orleans Pelicans,7,0.296,0.632,38,23,14,5,0.52,0.8,41,35,5,8
4100,21700411,Toronto Raptors,Phoenix Suns,115,109,224,6,Toronto Raptors,6,0.346,0.839,45,16,7,3,0.333,0.794,41,20,3,9
4101,21700412,Charlotte Hornets,Houston Rockets,96,108,204,12,Houston Rockets,12,0.19,0.741,56,14,4,5,0.378,0.684,45,24,7,5
4102,21700413,Detroit Pistons,Atlanta Hawks,105,91,196,14,Detroit Pistons,14,0.433,0.833,46,26,10,3,0.355,0.615,34,28,6,6
4103,21700414,New York Knicks,Brooklyn Nets,111,104,215,7,New York Knicks,7,0.5,0.864,40,23,11,4,0.286,0.783,43,21,10,4
4104,21700415,Los Angeles Lakers,Cleveland Cavaliers,112,121,233,9,Cleveland Cavaliers,9,0.29,0.643,49,33,7,3,0.417,0.8,39,32,10,5
4105,21700416,Sacramento Kings,Minnesota Timberwolves,96,119,215,23,Minnesota Timberwolves,23,0.424,0.833,42,24,4,2,0.476,0.85,39,29,12,9
4106,21700417,Dallas Mavericks,Golden State Warriors,97,112,209,15,Golden State Warriors,15,0.345,0.765,31,25,7,1,0.5,0.778,41,35,7,4
4107,21700418,Miami Heat,Charlotte Hornets,104,98,202,6,Miami Heat,6,0.355,0.882,40,25,10,8,0.37,0.741,42,21,7,1
4108,21700419,Detroit Pistons,Indiana Pacers,104,98,202,6,Detroit Pistons,6,0.406,0.765,44,22,7,10,0.3,0.76,51,21,6,4
4109,21700420,Portland Trail Blazers,Orlando Magic,95,88,183,7,Portland Trail Blazers,7,0.444,0.867,45,18,7,9,0.345,0.737,45,15,7,3
4110,21700421,Oklahoma City Thunder,Philadelphia 76ers,119,117,236,2,Oklahoma City Thunder,2,0.429,0.526,60,28,10,5,0.283,0.8,50,35,13,4
4111,21700422,Los Angeles Clippers,Washington Wizards,91,100,191,9,Washington Wizards,9,0.292,0.621,47,17,12,6,0.226,0.652,50,21,12,7
4112,21700423,Utah Jazz,Boston Celtics,107,95,202,12,Utah Jazz,12,0.52,0.778,55,19,6,2,0.29,0.842,31,20,10,5
4113,21700424,Brooklyn Nets,Toronto Raptors,87,120,207,33,Toronto Raptors,33,0.304,0.842,37,15,4,1,0.25,0.556,45,26,11,5
4114,21700425,Atlanta Hawks,Memphis Grizzlies,94,96,190,2,Memphis Grizzlies,2,0.387,0.875,35,27,12,5,0.48,0.706,43,21,12,6
4115,21700426,Chicago Bulls,Milwaukee Bucks,115,109,224,6,Chicago Bulls,6,0.364,0.657,50,24,8,0,0.273,0.69,43,24,6,5
4116,21700427,New Orleans Pelicans,Denver Nuggets,111,117,228,6,Denver Nuggets,6,0.441,0.714,42,27,8,8,0.444,0.643,48,30,12,4
4117,21700428,San Antonio Spurs,Houston Rockets,109,124,233,15,Houston Rockets,15,0.385,0.538,39,22,10,5,0.36,0.8,45,20,15,3
4118,21700429,Portland Trail Blazers,Charlotte Hornets,93,91,184,2,Portland Trail Blazers,2,0.417,0.5,47,19,2,3,0.226,0.643,51,18,9,3
4119,21700430,Utah Jazz,Cleveland Cavaliers,100,109,209,9,Cleveland Cavaliers,9,0.5,0.643,38,24,9,7,0.455,0.882,41,30,9,1
4120,21700431,Oklahoma City Thunder,New York Knicks,96,111,207,15,New York Knicks,15,0.444,0.6,42,18,9,7,0.609,0.808,35,21,9,3
4121,21700432,Los Angeles Clippers,Miami Heat,85,90,175,5,Miami Heat,5,0.286,0.5,46,18,3,5,0.343,0.762,37,22,10,8
4122,21700433,Milwaukee Bucks,Houston Rockets,111,115,226,4,Houston Rockets,4,0.296,0.818,40,17,12,7,0.314,0.81,38,16,7,4
4123,21700434,Phoenix Suns,Minnesota Timberwolves,108,106,214,2,Phoenix Suns,2,0.458,0.886,52,22,4,3,0.333,0.708,31,21,14,8
4124,21700435,Dallas Mavericks,San Antonio Spurs,96,98,194,2,San Antonio Spurs,2,0.357,0.889,38,23,4,4,0.2,0.833,41,14,5,2
4125,21700436,Boston Celtics,Memphis Grizzlies,102,93,195,9,Boston Celtics,9,0.467,0.714,42,21,6,6,0.412,0.882,38,18,8,3
4126,21700437,Sacramento Kings,Toronto Raptors,93,108,201,15,Toronto Raptors,15,0.423,0.75,32,25,9,9,0.433,0.821,46,20,8,9
4127,21700438,Orlando Magic,Detroit Pistons,110,114,224,4,Detroit Pistons,4,0.515,0.647,40,27,6,4,0.5,0.813,39,27,11,3
4128,21700439,Indiana Pacers,Brooklyn Nets,109,97,206,12,Indiana Pacers,12,0.444,0.789,43,21,6,7,0.364,0.81,29,26,7,2
4129,21700440,Cleveland Cavaliers,Washington Wizards,106,99,205,7,Cleveland Cavaliers,7,0.412,0.833,42,24,6,4,0.364,0.563,51,20,4,5
4130,21700441,New York Knicks,Charlotte Hornets,91,109,200,18,Charlotte Hornets,18,0.167,0.8,37,21,10,5,0.45,0.875,47,30,10,6
4131,21700442,Boston Celtics,Indiana Pacers,112,111,223,1,Boston Celtics,1,0.615,0.571,38,26,6,4,0.333,0.789,38,14,12,3
4132,21700443,Miami Heat,Atlanta Hawks,104,110,214,6,Atlanta Hawks,6,0.28,0.833,42,19,9,6,0.364,0.839,39,25,8,6
4133,21700444,Philadelphia 76ers,Chicago Bulls,115,117,232,2,Chicago Bulls,2,0.424,0.722,47,30,9,8,0.464,0.842,39,27,9,7
4134,21700445,Utah Jazz,Houston Rockets,99,120,219,21,Houston Rockets,21,0.296,0.875,32,17,12,1,0.395,0.852,52,25,5,7
4135,21700446,Portland Trail Blazers,Minnesota Timberwolves,107,108,215,1,Minnesota Timberwolves,1,0.417,1,40,26,6,8,0.368,0.81,32,19,6,2
4136,21700447,Denver Nuggets,Oklahoma City Thunder,94,95,189,1,Oklahoma City Thunder,1,0.324,0.667,45,21,8,3,0.292,0.667,40,13,9,5
4137,21700448,Phoenix Suns,Dallas Mavericks,97,91,188,6,Phoenix Suns,6,0.4,0.773,49,17,9,6,0.297,0.941,42,21,10,5
4138,21700449,Los Angeles Clippers,San Antonio Spurs,91,109,200,18,San Antonio Spurs,18,0.31,0.5,42,21,12,4,0.375,0.8,45,22,7,4
4139,21700450,Golden State Warriors,Los Angeles Lakers,116,114,230,2,Golden State Warriors,2,0.324,0.905,61,25,6,10,0.4,0.629,45,23,9,9
4140,21700451,Sacramento Kings,Philadelphia 76ers,101,95,196,6,Sacramento Kings,6,0.259,0.522,39,21,11,6,0.286,0.708,53,21,7,6
4141,21700452,New Orleans Pelicans,Washington Wizards,106,116,222,10,Washington Wizards,10,0.25,0.825,42,20,7,1,0.4,0.714,44,29,8,3
4142,21700453,Cleveland Cavaliers,Milwaukee Bucks,116,119,235,3,Milwaukee Bucks,3,0.39,0.833,37,26,9,3,0.379,0.815,40,27,12,3
4143,21700454,Toronto Raptors,Charlotte Hornets,129,111,240,18,Toronto Raptors,18,0.485,0.833,43,35,6,7,0.304,0.743,39,21,10,6
4144,21700455,Indiana Pacers,Atlanta Hawks,105,95,200,10,Indiana Pacers,10,0.333,0.947,37,19,5,5,0.276,0.85,43,27,5,6
4145,21700456,Miami Heat,Boston Celtics,90,89,179,1,Miami Heat,1,0.357,0.56,46,23,6,3,0.406,0.762,44,18,5,5
4146,21700457,Sacramento Kings,Brooklyn Nets,104,99,203,5,Sacramento Kings,5,0.368,0.85,48,14,4,4,0.357,0.87,38,15,5,7
4147,21700458,Orlando Magic,Chicago Bulls,94,112,206,18,Chicago Bulls,18,0.185,0.826,35,23,5,1,0.344,0.929,51,31,6,8
4148,21700459,Los Angeles Lakers,Houston Rockets,122,116,238,6,Los Angeles Lakers,6,0.429,0.628,47,27,8,5,0.405,0.781,47,19,7,5
4149,21700460,Utah Jazz,Oklahoma City Thunder,79,107,186,28,Oklahoma City Thunder,28,0.226,0.741,39,13,6,3,0.348,0.864,42,23,15,5
4150,21700461,Detroit Pistons,Dallas Mavericks,93,110,203,17,Dallas Mavericks,17,0.292,0.909,38,19,4,2,0.467,0.8,37,22,6,7
4151,21700462,Minnesota Timberwolves,Denver Nuggets,112,104,216,8,Minnesota Timberwolves,8,0.333,0.947,37,28,12,2,0.464,0.792,42,27,6,5
4152,21700463,San Antonio Spurs,Portland Trail Blazers,93,91,184,2,San Antonio Spurs,2,0.353,0.833,53,17,7,9,0.24,0.643,37,18,13,2
4153,21700464,Memphis Grizzlies,Golden State Warriors,84,97,181,13,Golden State Warriors,13,0.387,0.842,41,20,10,6,0.333,0.88,44,26,9,8
4154,21700465,Phoenix Suns,Los Angeles Clippers,95,108,203,13,Los Angeles Clippers,13,0.229,0.895,50,22,3,3,0.333,0.667,50,22,1,4
4155,21700466,Chicago Bulls,Cleveland Cavaliers,112,115,227,3,Cleveland Cavaliers,3,0.387,0.75,35,34,8,1,0.414,0.864,35,25,10,3
4156,21700467,Toronto Raptors,Philadelphia 76ers,114,109,223,5,Toronto Raptors,5,0.343,0.914,45,18,14,6,0.31,0.714,40,27,14,6
4157,21700468,Boston Celtics,New York Knicks,93,102,195,9,New York Knicks,9,0.342,0.737,35,17,11,1,0.571,0.846,49,13,8,3
4158,21700469,Memphis Grizzlies,Phoenix Suns,95,97,192,2,Phoenix Suns,2,0.192,0.75,50,15,5,7,0.385,0.778,44,21,4,1
4159,21700470,San Antonio Spurs,Utah Jazz,89,100,189,11,Utah Jazz,11,0.476,0.688,38,14,7,3,0.462,0.833,41,18,7,4
4160,21700471,New York Knicks,Detroit Pistons,101,104,205,3,Detroit Pistons,3,0.333,0.833,51,25,6,9,0.4,0.72,44,19,8,5
4161,21700472,New Orleans Pelicans,Orlando Magic,111,97,208,14,New Orleans Pelicans,14,0.333,0.625,48,23,10,2,0.2,0.724,40,16,7,2
4162,21700473,Washington Wizards,Brooklyn Nets,84,119,203,35,Brooklyn Nets,35,0.25,0.733,35,22,7,1,0.341,0.81,60,29,4,4
4163,21700474,Dallas Mavericks,Miami Heat,101,113,214,12,Miami Heat,12,0.486,0.727,22,28,5,2,0.64,0.833,35,25,3,3
4164,21700475,Los Angeles Clippers,Houston Rockets,128,118,246,10,Los Angeles Clippers,10,0.429,0.774,38,24,8,5,0.425,0.829,43,16,4,4
4165,21700476,Charlotte Hornets,Milwaukee Bucks,104,109,213,5,Milwaukee Bucks,5,0.462,0.824,43,21,4,7,0.276,0.826,43,27,7,5
4166,21700477,Atlanta Hawks,Oklahoma City Thunder,117,120,237,3,Oklahoma City Thunder,3,0.469,0.824,27,28,12,3,0.52,0.613,40,24,11,5
4167,21700478,Denver Nuggets,Portland Trail Blazers,102,85,187,17,Denver Nuggets,17,0.28,0.733,49,19,4,10,0.273,0.563,34,15,6,4
4168,21700479,Los Angeles Lakers,Golden State Warriors,106,113,219,7,Golden State Warriors,7,0.379,0.682,46,22,11,5,0.292,0.815,42,24,9,13
4169,21700480,Philadelphia 76ers,Toronto Raptors,86,102,188,16,Toronto Raptors,16,0.259,0.65,41,19,10,7,0.333,0.885,43,18,15,6
4170,21700481,Milwaukee Bucks,Charlotte Hornets,106,111,217,5,Charlotte Hornets,5,0.308,0.824,35,25,4,2,0.429,0.75,43,22,2,7
4171,21700482,Brooklyn Nets,Indiana Pacers,119,123,242,4,Indiana Pacers,4,0.444,0.76,51,24,2,2,0.435,0.792,41,31,8,9
4172,21700483,Orlando Magic,Washington Wizards,103,130,233,27,Washington Wizards,27,0.308,0.647,28,17,7,3,0.533,0.87,49,29,5,2
4173,21700484,Dallas Mavericks,Atlanta Hawks,107,112,219,5,Atlanta Hawks,5,0.273,0.8,30,31,8,3,0.417,0.818,38,29,5,2
4174,21700485,Chicago Bulls,Boston Celtics,92,117,209,25,Boston Celtics,25,0.368,0.68,51,24,4,2,0.375,0.81,46,29,9,5
4175,21700486,New Orleans Pelicans,Miami Heat,109,94,203,15,New Orleans Pelicans,15,0.6,0.842,37,27,5,10,0.313,0.8,38,18,4,3
4176,21700487,Los Angeles Clippers,Memphis Grizzlies,112,115,227,3,Memphis Grizzlies,3,0.382,0.75,36,14,4,7,0.419,0.88,47,28,5,5
4177,21700488,Oklahoma City Thunder,Utah Jazz,103,89,192,14,Oklahoma City Thunder,14,0.414,0.813,45,18,9,5,0.231,0.85,37,16,3,2
4178,21700489,Denver Nuggets,Golden State Warriors,96,81,177,15,Denver Nuggets,15,0.25,0.867,45,25,10,4,0.111,0.824,38,25,14,8
4179,21700490,Minnesota Timberwolves,Phoenix Suns,115,106,221,9,Minnesota Timberwolves,9,0.375,0.862,47,18,6,6,0.344,0.625,36,24,5,4
4180,21700491,Portland Trail Blazers,Los Angeles Lakers,95,92,187,3,Portland Trail Blazers,3,0.4,0.5,47,19,7,8,0.32,0.6,55,23,8,3
4181,21700492,San Antonio Spurs,Sacramento Kings,108,99,207,9,San Antonio Spurs,9,0.478,0.818,44,29,3,1,0.545,0.636,42,21,2,2
4182,21700493,Philadelphia 76ers,New York Knicks,105,98,203,7,Philadelphia 76ers,7,0.357,0.833,48,21,7,7,0.267,0.643,45,18,7,5
4183,21700494,Cleveland Cavaliers,Golden State Warriors,92,99,191,7,Golden State Warriors,7,0.417,0.84,50,12,8,0,0.27,0.765,47,28,7,7
4184,21700495,Washington Wizards,Boston Celtics,111,103,214,8,Washington Wizards,8,0.231,0.679,47,26,6,4,0.483,0.647,45,20,2,4
4185,21700496,Houston Rockets,Oklahoma City Thunder,107,112,219,5,Oklahoma City Thunder,5,0.324,0.806,38,23,11,4,0.444,0.783,40,21,9,10
4186,21700497,Minnesota Timberwolves,Los Angeles Lakers,121,104,225,17,Minnesota Timberwolves,17,0.344,0.857,42,30,9,4,0.333,0.7,37,21,10,1
4187,21700498,Indiana Pacers,Detroit Pistons,83,107,190,24,Detroit Pistons,24,0.286,0.692,26,18,6,3,0.353,0.813,46,26,5,1
4188,21700499,Toronto Raptors,Dallas Mavericks,93,98,191,5,Dallas Mavericks,5,0.29,0.75,53,16,10,7,0.25,0.75,56,20,5,11
4189,21700500,Orlando Magic,Miami Heat,89,107,196,18,Miami Heat,18,0.25,0.818,42,14,8,5,0.333,0.824,53,22,11,5
4190,21700501,Chicago Bulls,Milwaukee Bucks,115,106,221,9,Chicago Bulls,9,0.357,0.6,47,26,11,3,0.323,0.75,41,23,2,8
4191,21700502,Brooklyn Nets,San Antonio Spurs,97,109,206,12,San Antonio Spurs,12,0.375,0.778,45,23,5,0,0.438,0.833,43,18,7,5
4192,21700503,Utah Jazz,Denver Nuggets,83,107,190,24,Denver Nuggets,24,0.286,0.826,42,19,7,0,0.367,0.818,53,23,3,1
4193,21700504,Memphis Grizzlies,Phoenix Suns,97,99,196,2,Phoenix Suns,2,0.15,0.828,38,12,10,11,0.364,0.771,41,24,5,5
4194,21700505,Sacramento Kings,Los Angeles Clippers,95,122,217,27,Los Angeles Clippers,27,0.318,0.667,37,25,11,7,0.419,0.778,49,31,7,8
4195,21700506,Boston Celtics,Charlotte Hornets,102,91,193,11,Boston Celtics,11,0.441,1,43,20,4,7,0.304,0.69,52,15,7,3
4196,21700507,Dallas Mavericks,Indiana Pacers,98,94,192,4,Dallas Mavericks,4,0.276,0.667,35,26,7,3,0.4,0.8,39,27,8,4
4197,21700508,Washington Wizards,Atlanta Hawks,99,113,212,14,Atlanta Hawks,14,0.375,0.769,40,24,6,5,0.297,0.69,53,28,7,7
4198,21700509,New York Knicks,Chicago Bulls,87,92,179,5,Chicago Bulls,5,0.174,0.692,51,21,6,5,0.357,0.75,50,23,9,3
4199,21700510,Denver Nuggets,Minnesota Timberwolves,125,128,253,3,Minnesota Timberwolves,3,0.385,0.839,48,26,3,2,0.414,0.733,42,27,4,7
4200,21700511,Brooklyn Nets,New Orleans Pelicans,113,128,241,15,New Orleans Pelicans,15,0.5,0.857,43,26,8,3,0.515,0.789,43,40,8,9
4201,21700512,Toronto Raptors,Oklahoma City Thunder,107,124,231,17,Oklahoma City Thunder,17,0.289,0.923,34,24,9,4,0.36,0.697,52,25,9,7
4202,21700513,Cleveland Cavaliers,Sacramento Kings,95,109,204,14,Sacramento Kings,14,0.387,0.76,37,19,9,4,0.4,0.833,40,25,8,6
4203,21700514,Utah Jazz,Golden State Warriors,101,126,227,25,Golden State Warriors,25,0.261,0.778,43,21,10,2,0.478,0.765,50,37,8,7
4204,21700515,Memphis Grizzlies,Los Angeles Lakers,109,99,208,10,Memphis Grizzlies,10,0.238,0.872,37,20,3,9,0.286,0.636,49,14,5,4
4205,21700516,Detroit Pistons,Orlando Magic,89,102,191,13,Orlando Magic,13,0.391,0.714,41,20,5,4,0.423,1,48,22,10,3
4206,21700517,Houston Rockets,Boston Celtics,98,99,197,1,Boston Celtics,1,0.326,0.774,43,16,9,3,0.276,0.708,44,18,9,8
4207,21700518,Minnesota Timberwolves,Milwaukee Bucks,96,102,198,6,Milwaukee Bucks,6,0.321,0.731,33,20,9,3,0.333,0.938,36,23,10,0
4208,21700519,New York Knicks,San Antonio Spurs,107,119,226,12,San Antonio Spurs,12,0.357,0.909,44,31,6,8,0.45,0.718,43,28,2,4
4209,21700520,Philadelphia 76ers,Portland Trail Blazers,110,114,224,4,Portland Trail Blazers,4,0.5,0.714,37,28,8,2,0.333,0.766,47,15,7,3
4210,21700521,Houston Rockets,Washington Wizards,103,121,224,18,Washington Wizards,18,0.292,0.813,35,15,11,2,0.5,0.75,45,23,12,5
4211,21700522,Atlanta Hawks,Toronto Raptors,98,111,209,13,Toronto Raptors,13,0.375,0.65,48,21,6,7,0.351,0.75,51,22,9,15
4212,21700523,Brooklyn Nets,Miami Heat,111,87,198,24,Brooklyn Nets,24,0.423,0.88,54,25,8,4,0.115,0.774,43,12,9,3
4213,21700524,Indiana Pacers,Chicago Bulls,107,119,226,12,Chicago Bulls,12,0.318,0.7,43,22,10,6,0.462,1,40,31,6,4
4214,21700525,Dallas Mavericks,New Orleans Pelicans,128,120,248,8,Dallas Mavericks,8,0.564,0.778,43,27,5,4,0.258,0.875,31,28,8,6
4215,21700526,Milwaukee Bucks,Oklahoma City Thunder,97,95,192,2,Milwaukee Bucks,2,0.31,0.471,43,26,9,7,0.28,0.6,45,16,5,5
4216,21700527,Phoenix Suns,Sacramento Kings,111,101,212,10,Phoenix Suns,10,0.433,0.667,47,26,5,5,0.348,0.826,37,23,6,2
4217,21700528,Charlotte Hornets,Golden State Warriors,111,100,211,11,Charlotte Hornets,11,0.3,0.676,47,27,12,6,0.364,0.923,43,32,6,5
4218,21700529,Los Angeles Clippers,Los Angeles Lakers,121,106,227,15,Los Angeles Clippers,15,0.281,0.824,49,23,7,6,0.158,0.688,35,25,7,3
4219,21700530,San Antonio Spurs,Detroit Pistons,79,93,172,14,Detroit Pistons,14,0.192,0.923,46,18,8,5,0.333,0.813,45,22,10,1
4220,21700531,Miami Heat,Orlando Magic,117,111,228,6,Miami Heat,6,0.5,0.833,40,24,6,2,0.444,0.733,37,31,2,9
4221,21700532,New York Knicks,New Orleans Pelicans,105,103,208,2,New York Knicks,2,0.263,0.857,51,24,6,7,0.231,0.778,48,24,3,5
4222,21700533,Portland Trail Blazers,Atlanta Hawks,89,104,193,15,Atlanta Hawks,15,0.28,0.769,46,19,9,8,0.467,0.667,45,29,12,3
4223,21700534,Cleveland Cavaliers,Utah Jazz,101,104,205,3,Utah Jazz,3,0.3,0.808,46,20,6,5,0.323,0.857,43,24,12,4
4224,21700535,Memphis Grizzlies,Golden State Warriors,128,141,269,13,Golden State Warriors,13,0.714,0.682,38,29,6,0,0.545,0.92,38,37,3,6
4225,21700536,Philadelphia 76ers,Denver Nuggets,107,102,209,5,Philadelphia 76ers,5,0.333,0.9,41,34,6,3,0.219,0.735,48,18,10,9
4226,21700537,Chicago Bulls,Washington Wizards,110,114,224,4,Washington Wizards,4,0.229,0.818,46,24,6,1,0.444,0.706,47,27,6,8
4227,21700538,Minnesota Timberwolves,Indiana Pacers,107,90,197,17,Minnesota Timberwolves,17,0.211,0.84,44,20,11,8,0.4,0.778,43,20,3,5
4228,21700539,Brooklyn Nets,Boston Celtics,105,108,213,3,Boston Celtics,3,0.306,0.842,45,25,5,4,0.424,0.64,50,21,7,8
4229,21700540,Los Angeles Lakers,Houston Rockets,142,148,290,6,Houston Rockets,6,0.4,0.703,54,31,6,4,0.346,0.821,43,29,7,9
4230,21700541,Dallas Mavericks,Oklahoma City Thunder,116,113,229,3,Dallas Mavericks,3,0.441,0.643,36,26,5,5,0.313,0.739,45,18,4,4
4231,21700542,Charlotte Hornets,Los Angeles Clippers,98,106,204,8,Los Angeles Clippers,8,0.333,0.789,47,23,10,3,0.357,0.889,42,24,9,5
4232,21700543,Memphis Grizzlies,Sacramento Kings,114,96,210,18,Memphis Grizzlies,18,0.467,0.75,44,22,11,8,0.375,0.52,42,20,6,2
4233,21700544,Philadelphia 76ers,Phoenix Suns,123,110,233,13,Philadelphia 76ers,13,0.417,0.794,44,24,11,7,0.37,0.765,35,18,9,4
4234,21700545,Orlando Magic,Brooklyn Nets,95,98,193,3,Brooklyn Nets,3,0.194,0.76,52,16,5,5,0.36,0.739,52,17,7,10
4235,21700546,Milwaukee Bucks,Toronto Raptors,127,131,258,4,Toronto Raptors,4,0.481,0.929,43,27,9,3,0.424,0.818,40,25,8,8
4236,21700547,Portland Trail Blazers,Chicago Bulls,124,120,244,4,Portland Trail Blazers,4,0.424,0.889,50,25,7,5,0.407,0.826,58,28,5,7
4237,21700548,Los Angeles Lakers,Minnesota Timberwolves,96,114,210,18,Minnesota Timberwolves,18,0.308,0.69,37,18,12,4,0.35,0.9,41,26,14,5
4238,21700549,Portland Trail Blazers,Cleveland Cavaliers,110,127,237,17,Cleveland Cavaliers,17,0.406,0.684,43,25,5,5,0.406,0.757,40,28,11,4
4239,21700550,San Antonio Spurs,New York Knicks,100,91,191,9,San Antonio Spurs,9,0.37,0.824,50,18,11,5,0.318,0.778,50,21,5,7
4240,21700551,Atlanta Hawks,Phoenix Suns,103,104,207,1,Phoenix Suns,1,0.323,0.84,40,18,11,3,0.318,0.731,47,24,7,4
4241,21700552,Charlotte Hornets,Sacramento Kings,131,111,242,20,Charlotte Hornets,20,0.469,0.778,30,25,7,3,0.412,0.778,47,22,1,2
4242,21700553,Memphis Grizzlies,Los Angeles Clippers,105,113,218,8,Los Angeles Clippers,8,0.308,0.636,38,18,10,2,0.391,0.839,34,23,5,3
4243,21700554,Houston Rockets,Orlando Magic,116,98,214,18,Houston Rockets,18,0.441,0.81,51,25,6,3,0.194,0.88,48,16,7,3
4244,21700555,San Antonio Spurs,Philadelphia 76ers,106,112,218,6,Philadelphia 76ers,6,0.32,0.87,43,15,4,4,0.318,0.767,45,23,10,5
4245,21700556,New York Knicks,Washington Wizards,103,121,224,18,Washington Wizards,18,0.368,0.778,36,19,7,5,0.391,0.615,42,27,9,5
4246,21700557,Minnesota Timberwolves,Brooklyn Nets,97,98,195,1,Brooklyn Nets,1,0.091,0.8,32,10,9,4,0.467,0.909,38,22,3,3
4247,21700558,Detroit Pistons,Miami Heat,104,111,215,7,Miami Heat,7,0.375,0.813,35,21,4,2,0.5,0.727,41,29,6,3
4248,21700559,Cleveland Cavaliers,Boston Celtics,88,102,190,14,Boston Celtics,14,0.25,1,48,16,6,7,0.333,0.727,52,27,9,2
4249,21700560,Toronto Raptors,Chicago Bulls,124,115,239,9,Toronto Raptors,9,0.395,1,49,23,9,5,0.394,0.842,43,29,5,2
4250,21700561,Indiana Pacers,Milwaukee Bucks,101,122,223,21,Milwaukee Bucks,21,0.2,0.842,30,24,7,2,0.529,0.893,34,33,8,5
4251,21700562,Golden State Warriors,Dallas Mavericks,125,122,247,3,Golden State Warriors,3,0.406,0.842,46,36,8,7,0.442,0.773,40,29,6,2
4252,21700563,Phoenix Suns,Denver Nuggets,111,134,245,23,Denver Nuggets,23,0.371,0.714,35,26,12,1,0.444,0.909,48,35,8,9
4253,21700564,New Orleans Pelicans,Utah Jazz,108,98,206,10,New Orleans Pelicans,10,0.467,1,42,23,8,2,0.219,0.882,36,23,12,1
4254,21700565,Oklahoma City Thunder,Los Angeles Lakers,133,96,229,37,Oklahoma City Thunder,37,0.467,0.778,44,36,12,5,0.333,0.6,45,24,5,4
4255,21700566,Golden State Warriors,Houston Rockets,124,114,238,10,Golden State Warriors,10,0.433,0.75,45,35,6,6,0.34,0.591,38,20,7,3
4256,21700567,Oklahoma City Thunder,Los Angeles Clippers,127,117,244,10,Oklahoma City Thunder,10,0.441,0.714,46,23,4,6,0.3,0.783,45,29,5,2
4257,21700568,New York Knicks,Miami Heat,103,107,210,4,Miami Heat,4,0.385,0.87,39,14,11,7,0.286,0.95,44,24,10,5
4258,21700569,Detroit Pistons,Philadelphia 76ers,78,114,192,36,Philadelphia 76ers,36,0.318,0.579,34,20,9,4,0.467,0.923,55,29,5,4
4259,21700570,Minnesota Timberwolves,Boston Celtics,84,91,175,7,Boston Celtics,7,0.304,0.75,43,15,6,5,0.167,0.692,56,24,6,4
4260,21700571,Toronto Raptors,Milwaukee Bucks,129,110,239,19,Toronto Raptors,19,0.303,0.821,43,25,9,5,0.412,0.724,28,26,4,4
4261,21700572,Chicago Bulls,Dallas Mavericks,127,124,251,3,Chicago Bulls,3,0.5,0.806,42,25,9,3,0.438,0.706,34,33,11,2
4262,21700573,Phoenix Suns,San Antonio Spurs,89,103,192,14,San Antonio Spurs,14,0.233,0.667,46,22,11,2,0.367,0.556,44,21,15,6
4263,21700574,Utah Jazz,Denver Nuggets,91,99,190,8,Denver Nuggets,8,0.364,0.5,53,26,7,5,0.4,0.6,37,24,9,1
4264,21700575,Washington Wizards,Memphis Grizzlies,102,100,202,2,Washington Wizards,2,0.37,0.765,48,21,7,7,0.333,0.769,46,20,6,9
4265,21700576,Atlanta Hawks,Portland Trail Blazers,89,110,199,21,Portland Trail Blazers,21,0.308,0.84,39,14,7,5,0.433,0.786,44,30,11,5
4266,21700577,Charlotte Hornets,Los Angeles Lakers,108,94,202,14,Charlotte Hornets,14,0.364,0.75,56,26,10,3,0.25,0.75,46,24,7,3
4267,21700578,Golden State Warriors,Los Angeles Clippers,121,105,226,16,Golden State Warriors,16,0.333,0.811,54,31,13,10,0.273,0.8,45,19,10,7
4268,21700579,Boston Celtics,Brooklyn Nets,87,85,172,2,Boston Celtics,2,0.278,0.533,44,12,8,13,0.194,0.864,55,11,2,11
4269,21700580,Houston Rockets,Detroit Pistons,101,108,209,7,Detroit Pistons,7,0.319,0.909,42,29,5,4,0.48,0.741,35,21,8,4
4270,21700581,Chicago Bulls,Indiana Pacers,86,125,211,39,Indiana Pacers,39,0.313,0.8,33,15,4,6,0.484,0.778,49,24,9,4
4271,21700582,Cleveland Cavaliers,Orlando Magic,131,127,258,4,Cleveland Cavaliers,4,0.441,0.71,45,25,11,2,0.378,0.682,46,29,5,2
4272,21700583,Milwaukee Bucks,Washington Wizards,110,103,213,7,Milwaukee Bucks,7,0.318,0.833,45,20,11,6,0.381,0.724,34,25,6,6
4273,21700584,New Orleans Pelicans,Minnesota Timberwolves,98,116,214,18,Minnesota Timberwolves,18,0.207,0.929,38,20,5,6,0.5,0.905,47,26,10,5
4274,21700585,Denver Nuggets,Sacramento Kings,98,106,204,8,Sacramento Kings,8,0.382,0.714,46,20,2,6,0.36,0.765,39,21,16,4
4275,21700586,Utah Jazz,Miami Heat,102,103,205,1,Miami Heat,1,0.313,0.9,44,15,6,5,0.31,0.7,37,21,6,6
4276,21700587,New York Knicks,Dallas Mavericks,100,96,196,4,New York Knicks,4,0.375,0.9,59,22,4,6,0.25,0.833,40,22,7,3
4277,21700588,Oklahoma City Thunder,Phoenix Suns,100,114,214,14,Phoenix Suns,14,0.296,0.571,42,23,7,7,0.436,0.826,43,24,6,6
4278,21700589,San Antonio Spurs,Portland Trail Blazers,110,111,221,1,Portland Trail Blazers,1,0.478,0.731,42,26,4,5,0.348,0.7,38,19,7,5
4279,21700590,Atlanta Hawks,Los Angeles Lakers,113,132,245,19,Los Angeles Lakers,19,0.353,0.826,37,22,5,4,0.444,0.8,49,32,13,6
4280,21700591,Milwaukee Bucks,Indiana Pacers,96,109,205,13,Indiana Pacers,13,0.259,0.778,34,18,11,4,0.318,0.7,40,30,9,5
4281,21700592,Toronto Raptors,Brooklyn Nets,114,113,227,1,Toronto Raptors,1,0.294,0.783,51,19,7,12,0.364,0.821,55,22,8,2
4282,21700593,Houston Rockets,Chicago Bulls,116,107,223,9,Houston Rockets,9,0.37,0.75,51,28,6,6,0.429,0.833,37,26,6,5
4283,21700594,Cleveland Cavaliers,Minnesota Timberwolves,99,127,226,28,Minnesota Timberwolves,28,0.342,0.75,37,26,0,4,0.323,0.765,56,30,6,2
4284,21700595,Detroit Pistons,New Orleans Pelicans,109,112,221,3,New Orleans Pelicans,3,0.296,0.864,39,22,5,4,0.273,0.667,41,31,7,9
4285,21700596,San Antonio Spurs,Sacramento Kings,107,100,207,7,San Antonio Spurs,7,0.423,0.615,37,23,11,4,0.348,0.75,45,19,6,1
4286,21700597,Denver Nuggets,Golden State Warriors,114,124,238,10,Golden State Warriors,10,0.421,0.75,39,30,8,3,0.433,0.714,43,33,7,10
4287,21700598,Atlanta Hawks,Los Angeles Clippers,107,108,215,1,Los Angeles Clippers,1,0.27,0.724,56,20,9,8,0.5,0.676,47,16,10,9
4288,21700599,Miami Heat,Toronto Raptors,90,89,179,1,Miami Heat,1,0.182,0.8,64,18,2,14,0.333,0.8,37,15,7,12
4289,21700600,Portland Trail Blazers,Oklahoma City Thunder,117,106,223,11,Portland Trail Blazers,11,0.435,0.808,42,19,10,2,0.419,0.731,38,20,6,4
4290,21700601,Orlando Magic,Dallas Mavericks,99,114,213,15,Dallas Mavericks,15,0.379,0.727,41,27,2,4,0.346,0.864,38,27,6,2
4291,21700602,Sacramento Kings,Los Angeles Lakers,86,99,185,13,Los Angeles Lakers,13,0.381,0.667,43,15,15,4,0.343,0.619,55,30,12,4
4292,21700603,Dallas Mavericks,Charlotte Hornets,115,111,226,4,Dallas Mavericks,4,0.417,0.786,39,23,7,7,0.385,0.5,43,16,6,5
4293,21700604,Miami Heat,Indiana Pacers,114,106,220,8,Miami Heat,8,0.433,0.714,37,25,6,6,0.056,0.655,45,13,7,3
4294,21700605,Utah Jazz,Washington Wizards,107,104,211,3,Utah Jazz,3,0.333,0.769,39,23,15,3,0.4,0.706,45,25,8,1
4295,21700606,Detroit Pistons,Brooklyn Nets,114,80,194,34,Detroit Pistons,34,0.476,0.667,54,24,10,4,0.324,0.933,35,19,11,2
4296,21700607,Chicago Bulls,New York Knicks,122,119,241,3,Chicago Bulls,3,0.455,0.85,48,21,10,5,0.455,0.619,51,24,5,9
4297,21700608,Portland Trail Blazers,Houston Rockets,112,121,233,9,Houston Rockets,9,0.346,0.719,40,21,5,6,0.316,0.76,49,25,7,5
4298,21700609,New Orleans Pelicans,Memphis Grizzlies,102,105,207,3,Memphis Grizzlies,3,0.314,0.676,40,20,5,7,0.263,0.813,50,21,7,5
4299,21700610,Orlando Magic,Milwaukee Bucks,103,110,213,7,Milwaukee Bucks,7,0.276,0.944,34,26,6,4,0.211,0.64,47,20,4,9
4300,21700611,Oklahoma City Thunder,Minnesota Timberwolves,88,104,192,16,Minnesota Timberwolves,16,0.24,0.75,41,13,9,2,0.35,0.704,45,22,11,5
4301,21700612,Atlanta Hawks,Denver Nuggets,110,97,207,13,Atlanta Hawks,13,0.444,1,44,25,6,4,0.243,0.6,40,27,13,6
4302,21700613,Los Angeles Clippers,Golden State Warriors,125,106,231,19,Los Angeles Clippers,19,0.458,0.786,46,24,9,3,0.348,0.846,33,26,9,6
4303,21700614,Boston Celtics,Philadelphia 76ers,114,103,217,11,Boston Celtics,11,0.371,0.789,46,24,11,2,0.393,0.889,37,20,12,4
4304,21700615,Cleveland Cavaliers,Toronto Raptors,99,133,232,34,Toronto Raptors,34,0.231,0.833,35,18,3,4,0.429,0.692,63,31,3,7
4305,21700616,Los Angeles Clippers,Sacramento Kings,121,115,236,6,Los Angeles Clippers,6,0.419,0.733,39,28,9,5,0.308,0.821,44,23,9,3
4306,21700617,San Antonio Spurs,Los Angeles Lakers,81,93,174,12,Los Angeles Lakers,12,0.4,0.733,45,21,6,5,0.342,0.571,47,22,15,4
4307,21700618,Utah Jazz,Charlotte Hornets,88,99,187,11,Charlotte Hornets,11,0.343,0.87,45,19,5,8,0.333,0.765,46,17,8,2
4308,21700619,Cleveland Cavaliers,Indiana Pacers,95,97,192,2,Indiana Pacers,2,0.206,0.737,46,19,12,5,0.476,0.75,44,16,5,4
4309,21700620,Orlando Magic,Washington Wizards,119,125,244,6,Washington Wizards,6,0.414,0.806,40,32,7,3,0.25,0.684,41,26,9,6
4310,21700621,Brooklyn Nets,Atlanta Hawks,110,105,215,5,Brooklyn Nets,5,0.382,0.654,43,29,8,1,0.393,0.769,46,21,6,3
4311,21700622,Golden State Warriors,Milwaukee Bucks,108,94,202,14,Golden State Warriors,14,0.333,0.833,43,28,7,3,0.393,0.917,33,21,9,6
4312,21700623,New York Knicks,Minnesota Timberwolves,108,118,226,10,Minnesota Timberwolves,10,0.5,0.667,36,25,6,6,0.37,0.625,43,33,12,4
4313,21700624,Portland Trail Blazers,New Orleans Pelicans,113,119,232,6,New Orleans Pelicans,6,0.286,0.786,39,24,13,6,0.368,0.957,43,26,7,6
4314,21700625,Memphis Grizzlies,Denver Nuggets,78,87,165,9,Denver Nuggets,9,0.292,0.786,36,17,8,5,0.318,0.813,47,15,8,3
4315,21700626,Houston Rockets,Phoenix Suns,112,95,207,17,Houston Rockets,17,0.319,0.864,53,18,11,4,0.424,0.778,38,27,5,3
4316,21700627,Los Angeles Lakers,Dallas Mavericks,107,101,208,6,Los Angeles Lakers,6,0.308,0.722,59,24,4,0,0.256,0.786,39,20,5,1
4317,21700628,Sacramento Kings,Los Angeles Clippers,105,126,231,21,Los Angeles Clippers,21,0.353,0.591,37,26,12,4,0.387,0.846,39,29,11,5
4318,21700629,Oklahoma City Thunder,Charlotte Hornets,101,91,192,10,Oklahoma City Thunder,10,0.308,0.75,57,17,8,9,0.321,0.696,50,16,3,7
4319,21700630,Brooklyn Nets,Washington Wizards,113,119,232,6,Washington Wizards,6,0.279,0.85,47,28,6,3,0.435,0.739,47,31,10,3
4320,21700631,Golden State Warriors,Toronto Raptors,127,125,252,2,Golden State Warriors,2,0.375,0.857,30,28,4,3,0.32,0.844,44,22,3,2
4321,21700632,Detroit Pistons,Chicago Bulls,105,107,212,2,Chicago Bulls,2,0.414,0.786,45,28,8,7,0.472,0.667,40,27,10,8
4322,21700633,Denver Nuggets,San Antonio Spurs,80,112,192,32,San Antonio Spurs,32,0.25,0.882,41,18,9,4,0.519,0.889,43,23,9,3
4323,21700634,Milwaukee Bucks,Miami Heat,79,97,176,18,Miami Heat,18,0.143,0.926,40,9,8,1,0.379,0.8,49,23,8,8
4324,21700635,New Orleans Pelicans,New York Knicks,123,118,241,5,New Orleans Pelicans,5,0.281,0.706,46,19,17,7,0.353,0.778,44,28,12,7
4325,21700636,Indiana Pacers,Phoenix Suns,120,97,217,23,Indiana Pacers,23,0.478,0.929,42,20,9,1,0.243,0.75,45,20,2,1
4326,21700637,Portland Trail Blazers,Minnesota Timberwolves,103,120,223,17,Minnesota Timberwolves,17,0.44,0.824,38,19,6,3,0.368,0.818,38,21,12,3
4327,21700638,Charlotte Hornets,Detroit Pistons,118,107,225,11,Charlotte Hornets,11,0.476,0.667,49,21,9,4,0.517,0.727,38,27,10,5
4328,21700639,Toronto Raptors,Philadelphia 76ers,111,117,228,6,Philadelphia 76ers,6,0.281,0.867,44,20,8,1,0.24,0.816,48,22,8,9
4329,21700640,Milwaukee Bucks,Washington Wizards,104,95,199,9,Milwaukee Bucks,9,0.5,0.69,44,21,14,6,0.286,0.806,39,19,10,8
4330,21700641,San Antonio Spurs,Atlanta Hawks,99,102,201,3,Atlanta Hawks,3,0.364,0.85,37,24,12,5,0.36,0.929,50,23,8,2
4331,21700642,New York Knicks,Brooklyn Nets,119,104,223,15,New York Knicks,15,0.563,0.703,51,27,5,10,0.344,0.806,45,16,5,3
4332,21700643,Sacramento Kings,Oklahoma City Thunder,88,95,183,7,Oklahoma City Thunder,7,0.233,0.6,37,22,13,0,0.3,0.483,59,20,10,6
4333,21700644,Miami Heat,Chicago Bulls,111,119,230,8,Chicago Bulls,8,0.333,0.792,40,35,5,4,0.41,0.864,45,27,6,2
4334,21700645,Los Angeles Lakers,Memphis Grizzlies,114,123,237,9,Memphis Grizzlies,9,0.343,0.839,44,25,11,8,0.455,0.853,48,24,8,8
4335,21700646,Golden State Warriors,Cleveland Cavaliers,118,108,226,10,Golden State Warriors,10,0.375,0.8,48,33,8,6,0.25,0.682,43,26,9,5
4336,21700647,Indiana Pacers,Utah Jazz,109,94,203,15,Indiana Pacers,15,0.538,0.867,43,26,7,2,0.273,0.765,38,11,11,7
4337,21700648,Houston Rockets,Los Angeles Clippers,102,113,215,11,Los Angeles Clippers,11,0.295,0.813,37,21,9,4,0.4,0.75,41,30,6,10
4338,21700649,Minnesota Timberwolves,Orlando Magic,102,108,210,6,Orlando Magic,6,0.438,0.9,37,19,10,9,0.355,0.895,51,24,4,10
4339,21700650,New Orleans Pelicans,Boston Celtics,116,113,229,3,New Orleans Pelicans,3,0.259,0.76,55,28,11,6,0.38,0.875,53,27,7,3
4340,21700651,Dallas Mavericks,Denver Nuggets,102,105,207,3,Denver Nuggets,3,0.296,0.818,35,17,10,3,0.308,0.654,47,23,10,3
4341,21700652,Phoenix Suns,Portland Trail Blazers,111,118,229,7,Portland Trail Blazers,7,0.39,0.955,43,21,6,3,0.486,0.9,43,21,7,6
4342,21700653,Washington Wizards,Charlotte Hornets,109,133,242,24,Charlotte Hornets,24,0.565,0.696,40,31,3,7,0.484,0.846,49,27,10,5
4343,21700654,New Orleans Pelicans,Atlanta Hawks,93,94,187,1,Atlanta Hawks,1,0.37,0.684,43,27,5,6,0.25,0.769,43,32,5,3
4344,21700655,San Antonio Spurs,Brooklyn Nets,100,95,195,5,San Antonio Spurs,5,0.474,0.742,42,24,8,4,0.361,0.667,47,23,3,1
4345,21700656,Detroit Pistons,Toronto Raptors,91,96,187,5,Toronto Raptors,5,0.357,0.467,42,22,14,7,0.355,0.739,49,24,6,8
4346,21700657,Golden State Warriors,Chicago Bulls,119,112,231,7,Golden State Warriors,7,0.394,0.88,49,24,5,3,0.256,0.923,49,24,10,2
4347,21700658,New York Knicks,Memphis Grizzlies,99,105,204,6,Memphis Grizzlies,6,0.259,0.957,45,22,5,12,0.357,0.765,44,23,9,3
4348,21700659,Miami Heat,Milwaukee Bucks,106,101,207,5,Miami Heat,5,0.417,0.741,46,28,4,7,0.393,0.75,38,23,6,4
4349,21700660,Los Angeles Lakers,Oklahoma City Thunder,90,114,204,24,Oklahoma City Thunder,24,0.385,1,30,25,9,1,0.343,0.833,54,22,10,6
4350,21700661,Utah Jazz,Sacramento Kings,120,105,225,15,Utah Jazz,15,0.414,0.8,29,26,15,4,0.619,0.8,36,19,9,4
4351,21700662,Denver Nuggets,Los Angeles Clippers,104,109,213,5,Los Angeles Clippers,5,0.2,0.833,54,23,13,7,0.333,0.613,48,22,10,5
4352,21700663,Philadelphia 76ers,Boston Celtics,89,80,169,9,Philadelphia 76ers,9,0.353,0.882,41,18,10,5,0.241,0.765,31,13,7,5
4353,21700664,Orlando Magic,Cleveland Cavaliers,103,104,207,1,Cleveland Cavaliers,1,0.227,0.762,42,25,12,6,0.294,0.667,46,22,8,4
4354,21700665,Minnesota Timberwolves,Houston Rockets,98,116,214,18,Houston Rockets,18,0.333,0.667,40,24,8,8,0.436,0.882,45,24,11,5
4355,21700666,Indiana Pacers,Portland Trail Blazers,86,100,186,14,Portland Trail Blazers,14,0.269,0.538,46,17,4,4,0.313,1,57,17,6,7
4356,21700667,San Antonio Spurs,Toronto Raptors,83,86,169,3,Toronto Raptors,3,0.25,0.8,56,18,9,7,0.346,0.643,50,16,8,1
4357,21700668,Miami Heat,Brooklyn Nets,95,101,196,6,Brooklyn Nets,6,0.318,0.72,43,22,7,7,0.281,0.769,44,20,5,8
4358,21700669,Washington Wizards,Detroit Pistons,122,112,234,10,Washington Wizards,10,0.457,0.889,34,28,10,4,0.333,0.846,35,25,8,3
4359,21700670,Sacramento Kings,Memphis Grizzlies,88,106,194,18,Memphis Grizzlies,18,0.407,0.722,44,18,10,3,0.294,0.783,49,24,12,5
4360,21700671,Phoenix Suns,Denver Nuggets,108,100,208,8,Phoenix Suns,8,0.424,0.7,37,28,9,6,0.389,0.762,42,23,7,5
4361,21700672,New York Knicks,Utah Jazz,117,115,232,2,New York Knicks,2,0.55,0.783,36,23,6,6,0.355,0.667,52,19,4,6
4362,21700673,Indiana Pacers,Los Angeles Lakers,86,99,185,13,Los Angeles Lakers,13,0.08,0.769,44,15,9,4,0.321,0.143,47,26,7,6
4363,21700674,Oklahoma City Thunder,Cleveland Cavaliers,148,124,272,24,Oklahoma City Thunder,24,0.467,0.643,52,37,9,2,0.27,0.815,28,32,7,4
4364,21700675,Chicago Bulls,Atlanta Hawks,113,97,210,16,Chicago Bulls,16,0.438,0.905,48,31,8,1,0.229,0.696,45,27,5,4
4365,21700676,Miami Heat,Charlotte Hornets,106,105,211,1,Miami Heat,1,0.464,0.583,47,28,5,6,0.259,0.762,43,22,9,8
4366,21700677,Memphis Grizzlies,New Orleans Pelicans,104,111,215,7,New Orleans Pelicans,7,0.429,0.938,44,22,2,1,0.259,0.813,41,23,6,5
4367,21700678,Milwaukee Bucks,Philadelphia 76ers,94,116,210,22,Philadelphia 76ers,22,0.313,0.818,35,20,10,3,0.4,0.842,45,32,9,4
4368,21700679,Golden State Warriors,Houston Rockets,108,116,224,8,Houston Rockets,8,0.472,0.733,33,31,8,10,0.378,0.69,46,19,14,3
4369,21700680,Toronto Raptors,Minnesota Timberwolves,109,115,224,6,Minnesota Timberwolves,6,0.364,0.905,35,23,7,7,0.438,0.762,44,21,4,3
4370,21700681,Los Angeles Clippers,Utah Jazz,113,125,238,12,Utah Jazz,12,0.306,0.789,34,18,17,2,0.393,0.75,56,21,9,3
4371,21700682,Dallas Mavericks,Portland Trail Blazers,108,117,225,9,Portland Trail Blazers,9,0.4,0.786,37,19,9,5,0.5,0.9,40,19,3,3
4372,21700683,Orlando Magic,Boston Celtics,103,95,198,8,Orlando Magic,8,0.286,0.688,44,20,7,9,0.296,0.929,44,22,6,9
4373,21700684,New York Knicks,Los Angeles Lakers,107,127,234,20,Los Angeles Lakers,20,0.48,0.7,33,32,3,5,0.385,0.714,39,31,10,3
4374,21700685,Brooklyn Nets,Detroit Pistons,101,100,201,1,Brooklyn Nets,1,0.419,0.7,46,23,1,3,0.31,0.882,43,21,3,4
4375,21700686,Indiana Pacers,San Antonio Spurs,94,86,180,8,Indiana Pacers,8,0.211,0.941,41,14,14,1,0.265,0.583,46,24,8,10
4376,21700687,Sacramento Kings,Charlotte Hornets,107,112,219,5,Charlotte Hornets,5,0.455,0.733,42,27,8,3,0.4,0.8,48,22,4,10
4377,21700688,Utah Jazz,Atlanta Hawks,90,104,194,14,Atlanta Hawks,14,0.267,0.714,39,20,8,6,0.462,1,44,24,8,5
4378,21700689,Miami Heat,Houston Rockets,90,99,189,9,Houston Rockets,9,0.233,0.556,42,18,7,4,0.405,0.667,38,20,10,3
4379,21700690,Philadelphia 76ers,Memphis Grizzlies,101,105,206,4,Memphis Grizzlies,4,0.452,0.742,48,21,2,4,0.385,0.829,32,14,14,2
4380,21700691,Phoenix Suns,Milwaukee Bucks,105,109,214,4,Milwaukee Bucks,4,0.346,0.9,34,31,12,2,0.294,0.757,32,20,14,5
4381,21700692,Chicago Bulls,New Orleans Pelicans,128,132,260,4,New Orleans Pelicans,4,0.258,0.882,54,31,8,6,0.364,0.846,55,32,14,3
4382,21700693,Washington Wizards,Dallas Mavericks,75,98,173,23,Dallas Mavericks,23,0.219,0.593,47,15,7,5,0.323,0.706,52,20,9,9
4383,21700694,Portland Trail Blazers,Denver Nuggets,101,104,205,3,Denver Nuggets,3,0.32,0.808,44,19,11,6,0.333,0.788,49,23,7,8
4384,21700695,Minnesota Timberwolves,Los Angeles Clippers,126,118,244,8,Minnesota Timberwolves,8,0.318,0.846,47,20,5,4,0.333,0.682,40,31,4,1
4385,21700696,Sacramento Kings,Orlando Magic,105,99,204,6,Sacramento Kings,6,0.308,0.846,44,24,9,11,0.355,0.842,40,23,9,4
4386,21700697,Brooklyn Nets,Oklahoma City Thunder,108,109,217,1,Oklahoma City Thunder,1,0.421,0.72,45,27,1,5,0.28,0.688,50,12,7,4
4387,21700698,Cleveland Cavaliers,San Antonio Spurs,102,114,216,12,San Antonio Spurs,12,0.286,0.839,41,19,6,3,0.286,0.75,45,23,11,4
4388,21700699,New York Knicks,Golden State Warriors,112,123,235,11,Golden State Warriors,11,0.409,0.895,38,28,4,0,0.433,0.9,36,40,6,3
4389,21700700,Boston Celtics,Los Angeles Lakers,107,108,215,1,Los Angeles Lakers,1,0.341,0.8,42,22,3,5,0.269,0.583,51,18,6,2
4390,21700701,New Orleans Pelicans,Charlotte Hornets,101,96,197,5,New Orleans Pelicans,5,0.346,0.778,42,26,6,10,0.286,0.581,49,16,5,6
4391,21700702,Utah Jazz,Detroit Pistons,98,95,193,3,Utah Jazz,3,0.323,0.75,44,24,11,9,0.226,0.667,57,23,10,7
4392,21700703,Phoenix Suns,Indiana Pacers,101,116,217,15,Indiana Pacers,15,0.257,0.759,42,22,3,2,0.375,0.68,39,32,11,3
4393,21700704,Chicago Bulls,Philadelphia 76ers,101,115,216,14,Philadelphia 76ers,14,0.297,0.818,43,20,8,2,0.5,0.75,48,31,6,7
4394,21700705,Toronto Raptors,Atlanta Hawks,108,93,201,15,Toronto Raptors,15,0.389,0.64,52,25,10,12,0.333,0.706,47,19,8,9
4395,21700706,Houston Rockets,Dallas Mavericks,104,97,201,7,Houston Rockets,7,0.412,0.478,43,20,8,3,0.429,0.667,49,24,5,2
4396,21700707,San Antonio Spurs,Memphis Grizzlies,108,85,193,23,San Antonio Spurs,23,0.417,0.88,45,29,9,6,0.111,0.786,41,19,7,4
4397,21700708,Minnesota Timberwolves,Portland Trail Blazers,114,123,237,9,Portland Trail Blazers,9,0.375,0.818,33,20,7,2,0.548,0.762,37,24,4,1
4398,21700709,Boston Celtics,Los Angeles Clippers,113,102,215,11,Boston Celtics,11,0.35,0.955,47,25,10,3,0.238,0.692,40,26,6,5
4399,21700710,Sacramento Kings,Miami Heat,89,88,177,1,Sacramento Kings,1,0.417,0.571,38,17,3,6,0.353,0.778,46,19,8,4
4400,21700711,Washington Wizards,Oklahoma City Thunder,112,121,233,9,Oklahoma City Thunder,9,0.457,0.75,39,25,10,2,0.333,0.759,40,18,16,6
4401,21700712,New York Knicks,Denver Nuggets,118,130,248,12,Denver Nuggets,12,0.381,0.833,33,32,9,5,0.5,0.833,32,36,3,2
4402,21700713,Minnesota Timberwolves,Golden State Warriors,113,126,239,13,Golden State Warriors,13,0.3,0.833,43,25,9,3,0.568,0.6,47,37,9,8
4403,21700714,Atlanta Hawks,Charlotte Hornets,110,121,231,11,Charlotte Hornets,11,0.5,0.84,39,23,6,5,0.382,0.875,43,25,13,8
4404,21700715,Indiana Pacers,Cleveland Cavaliers,108,115,223,7,Cleveland Cavaliers,7,0.419,0.818,37,27,13,1,0.351,0.769,44,27,13,4
4405,21700716,Utah Jazz,Toronto Raptors,97,93,190,4,Utah Jazz,4,0.476,0.714,47,20,7,5,0.259,0.706,52,23,10,13
4406,21700717,Los Angeles Lakers,Chicago Bulls,108,103,211,5,Los Angeles Lakers,5,0.208,0.75,48,23,6,3,0.472,0.667,53,21,3,7
4407,21700718,Los Angeles Clippers,Memphis Grizzlies,109,100,209,9,Los Angeles Clippers,9,0.37,0.724,36,23,15,6,0.296,0.778,43,31,1,9
4408,21700719,Brooklyn Nets,Milwaukee Bucks,91,116,207,25,Milwaukee Bucks,25,0.235,0.85,45,18,5,2,0.522,0.9,44,28,9,6
4409,21700720,Houston Rockets,New Orleans Pelicans,113,115,228,2,New Orleans Pelicans,2,0.333,0.829,35,22,10,2,0.407,0.762,42,36,8,5
4410,21700721,Portland Trail Blazers,Dallas Mavericks,107,93,200,14,Portland Trail Blazers,14,0.333,0.826,54,20,4,6,0.333,0.765,37,17,9,3
4411,21700722,Philadelphia 76ers,San Antonio Spurs,97,78,175,19,Philadelphia 76ers,19,0.429,0.667,50,23,5,4,0.125,0.833,36,20,6,5
4412,21700723,New York Knicks,Phoenix Suns,107,85,192,22,New York Knicks,22,0.36,0.727,49,25,7,10,0.333,0.615,42,15,6,3
4413,21700724,Oklahoma City Thunder,Detroit Pistons,121,108,229,13,Oklahoma City Thunder,13,0.424,0.739,43,23,9,2,0.364,0.75,43,24,4,3
4414,21700725,Orlando Magic,Indiana Pacers,112,114,226,2,Indiana Pacers,2,0.32,0.625,40,21,6,7,0.278,0.789,38,25,9,1
4415,21700726,Washington Wizards,Atlanta Hawks,129,104,233,25,Washington Wizards,25,0.563,0.929,38,40,7,6,0.279,0.762,32,24,2,4
4416,21700727,Charlotte Hornets,Miami Heat,91,95,186,4,Miami Heat,4,0.208,0.8,46,12,6,6,0.308,0.611,51,25,4,5
4417,21700728,Boston Celtics,Golden State Warriors,105,109,214,4,Golden State Warriors,4,0.5,0.708,45,17,6,2,0.37,0.885,43,19,9,9
4418,21700729,Brooklyn Nets,Minnesota Timberwolves,97,111,208,14,Minnesota Timberwolves,14,0.3,0.8,43,22,3,7,0.19,0.885,49,20,9,7
4419,21700730,Dallas Mavericks,Denver Nuggets,89,91,180,2,Denver Nuggets,2,0.355,0.526,43,17,8,5,0.364,0.733,53,23,6,8
4420,21700731,Milwaukee Bucks,Chicago Bulls,110,96,206,14,Milwaukee Bucks,14,0.464,0.6,43,28,11,4,0.353,0.8,41,25,8,2
4421,21700732,Phoenix Suns,Houston Rockets,102,113,215,11,Houston Rockets,11,0.242,0.846,43,17,7,2,0.297,0.776,43,17,8,2
4422,21700733,Los Angeles Clippers,New Orleans Pelicans,112,103,215,9,Los Angeles Clippers,9,0.321,0.722,50,29,7,4,0.257,0.72,47,23,9,6
4423,21700734,Detroit Pistons,Cleveland Cavaliers,104,121,225,17,Cleveland Cavaliers,17,0.389,0.769,43,31,5,6,0.429,0.846,45,27,2,3
4424,21700735,Los Angeles Lakers,Toronto Raptors,111,123,234,12,Toronto Raptors,12,0.32,0.697,44,22,9,4,0.387,0.76,53,23,4,4
4425,21700736,Philadelphia 76ers,Oklahoma City Thunder,112,122,234,10,Oklahoma City Thunder,10,0.379,0.806,40,19,7,5,0.303,0.733,41,21,7,3
4426,21700737,Sacramento Kings,San Antonio Spurs,98,113,211,15,San Antonio Spurs,15,0.529,0.909,34,21,5,3,0.44,0.706,52,33,4,2
4427,21700738,Charlotte Hornets,Indiana Pacers,96,105,201,9,Indiana Pacers,9,0.29,0.65,40,18,5,2,0.286,0.818,38,28,7,3
4428,21700739,Minnesota Timberwolves,Atlanta Hawks,100,105,205,5,Atlanta Hawks,5,0.368,0.833,35,24,15,5,0.382,0.875,44,27,8,8
4429,21700740,Phoenix Suns,Memphis Grizzlies,109,120,229,11,Memphis Grizzlies,11,0.304,0.722,37,20,11,2,0.5,0.833,38,29,7,9
4430,21700741,Philadelphia 76ers,Milwaukee Bucks,95,107,202,12,Milwaukee Bucks,12,0.077,0.913,43,22,5,4,0.393,0.909,42,26,6,8
4431,21700742,Miami Heat,Dallas Mavericks,95,88,183,7,Miami Heat,7,0.387,0.789,41,23,9,11,0.276,0.875,40,20,10,3
4432,21700743,Boston Celtics,Denver Nuggets,111,110,221,1,Boston Celtics,1,0.472,0.8,40,28,4,6,0.303,0.762,47,31,4,3
4433,21700744,Oklahoma City Thunder,Washington Wizards,96,102,198,6,Washington Wizards,6,0.281,0.794,52,19,7,8,0.28,0.931,43,27,8,7
4434,21700745,Brooklyn Nets,New York Knicks,95,111,206,16,New York Knicks,16,0.243,0.875,49,15,6,3,0.5,0.8,47,22,6,6
4435,21700746,Minnesota Timberwolves,Toronto Raptors,104,109,213,5,Toronto Raptors,5,0.417,0.625,40,21,4,2,0.31,0.846,39,28,3,4
4436,21700747,Cleveland Cavaliers,Detroit Pistons,114,125,239,11,Detroit Pistons,11,0.371,0.781,41,24,2,5,0.391,0.643,47,30,12,5
4437,21700748,Orlando Magic,Houston Rockets,107,114,221,7,Houston Rockets,7,0.484,0.8,33,26,6,4,0.371,0.821,40,17,5,5
4438,21700749,Sacramento Kings,New Orleans Pelicans,114,103,217,11,Sacramento Kings,11,0.385,0.857,49,22,7,1,0.36,0.727,36,26,7,8
4439,21700750,Denver Nuggets,San Antonio Spurs,104,106,210,2,San Antonio Spurs,2,0.435,1,38,22,11,6,0.375,1,43,33,4,9
4440,21700751,Golden State Warriors,Utah Jazz,99,129,228,30,Utah Jazz,30,0.2,0.762,37,27,10,7,0.5,0.643,42,25,16,3
4441,21700752,Portland Trail Blazers,Los Angeles Clippers,104,96,200,8,Portland Trail Blazers,8,0.433,0.864,59,21,12,6,0.273,0.769,50,22,5,7
4442,21700753,Memphis Grizzlies,Indiana Pacers,101,105,206,4,Indiana Pacers,4,0.462,0.733,41,20,10,1,0.385,0.677,33,20,16,4
4443,21700754,Los Angeles Lakers,Orlando Magic,105,127,232,22,Orlando Magic,22,0.2,0.767,43,18,7,1,0.563,0.724,35,28,13,4
4444,21700755,Charlotte Hornets,Atlanta Hawks,123,110,233,13,Charlotte Hornets,13,0.531,0.778,42,29,6,1,0.375,0.909,29,26,5,4
4445,21700756,Philadelphia 76ers,Brooklyn Nets,108,116,224,8,Brooklyn Nets,8,0.389,0.853,33,17,7,5,0.406,0.893,39,19,3,9
4446,21700757,Miami Heat,Cleveland Cavaliers,89,91,180,2,Cleveland Cavaliers,2,0.107,0.56,52,17,8,5,0.231,0.763,45,18,9,5
4447,21700758,New York Knicks,Boston Celtics,73,103,176,30,Boston Celtics,30,0.176,0.667,44,16,4,4,0.423,0.6,49,27,8,3
4448,21700759,Chicago Bulls,Portland Trail Blazers,108,124,232,16,Portland Trail Blazers,16,0.382,0.591,36,19,10,4,0.469,0.85,48,21,3,6
4449,21700760,Dallas Mavericks,Phoenix Suns,88,102,190,14,Phoenix Suns,14,0.278,0.538,49,18,11,4,0.367,0.733,47,23,9,3
4450,21700761,Memphis Grizzlies,Detroit Pistons,102,104,206,2,Detroit Pistons,2,0.258,1,49,22,3,3,0.28,0.73,41,20,8,4
4451,21700762,Toronto Raptors,Washington Wizards,119,122,241,3,Washington Wizards,3,0.414,0.792,32,20,7,3,0.333,0.923,44,30,10,2
4452,21700763,Milwaukee Bucks,Minnesota Timberwolves,89,108,197,19,Minnesota Timberwolves,19,0.207,0.76,43,19,6,1,0.368,0.85,39,27,8,7
4453,21700764,Houston Rockets,San Antonio Spurs,102,91,193,11,Houston Rockets,11,0.333,0.824,38,20,10,7,0.25,0.882,46,21,7,5
4454,21700765,Oklahoma City Thunder,Denver Nuggets,124,127,251,3,Denver Nuggets,3,0.321,0.765,40,34,5,6,0.395,0.706,43,32,3,10
4455,21700766,Indiana Pacers,Charlotte Hornets,126,133,259,7,Charlotte Hornets,7,0.414,0.929,31,21,10,6,0.455,0.882,43,27,5,2
4456,21700767,Atlanta Hawks,Boston Celtics,110,119,229,9,Boston Celtics,9,0.355,0.912,36,21,6,4,0.458,0.9,42,26,8,3
4457,21700768,Los Angeles Lakers,Brooklyn Nets,102,99,201,3,Los Angeles Lakers,3,0.385,0.7,56,21,5,6,0.31,0.696,38,20,7,8
4458,21700769,Portland Trail Blazers,Toronto Raptors,105,130,235,25,Toronto Raptors,25,0.333,0.727,36,20,4,2,0.475,0.905,42,21,5,4
4459,21700770,Miami Heat,Philadelphia 76ers,97,103,200,6,Philadelphia 76ers,6,0.324,0.654,49,20,3,5,0.333,0.733,39,28,9,4
4460,21700771,New York Knicks,Milwaukee Bucks,90,92,182,2,Milwaukee Bucks,2,0.2,0.765,57,24,7,4,0.292,0.731,36,18,10,8
4461,21700772,New Orleans Pelicans,Oklahoma City Thunder,114,100,214,14,New Orleans Pelicans,14,0.542,0.692,41,30,10,2,0.25,0.85,52,24,6,5
4462,21700773,Utah Jazz,Phoenix Suns,129,97,226,32,Utah Jazz,32,0.517,0.706,51,30,7,6,0.273,0.842,32,19,7,5
4463,21700774,Golden State Warriors,Sacramento Kings,119,104,223,15,Golden State Warriors,15,0.515,0.875,51,25,8,4,0.4,0.667,33,22,16,3
4464,21700775,Chicago Bulls,Los Angeles Clippers,103,113,216,10,Los Angeles Clippers,10,0.324,1,48,22,6,4,0.36,0.857,54,23,4,5
4465,21700776,Miami Heat,Detroit Pistons,107,111,218,4,Detroit Pistons,4,0.389,0.714,33,30,13,4,0.346,0.824,49,23,7,5
4466,21700777,Philadelphia 76ers,Indiana Pacers,92,100,192,8,Indiana Pacers,8,0.313,0.667,49,21,8,2,0.333,0.84,42,25,15,8
4467,21700778,Washington Wizards,Orlando Magic,115,98,213,17,Washington Wizards,17,0.269,0.889,38,35,14,6,0.313,0.909,35,17,12,4
4468,21700779,Houston Rockets,Cleveland Cavaliers,120,88,208,32,Houston Rockets,32,0.373,0.813,53,28,6,5,0.267,0.75,47,22,4,3
4469,21700780,New Orleans Pelicans,Minnesota Timberwolves,107,118,225,11,Minnesota Timberwolves,11,0.242,0.882,51,23,9,8,0.476,0.75,50,21,9,3
4470,21700781,Utah Jazz,San Antonio Spurs,120,111,231,9,Utah Jazz,9,0.522,0.833,37,26,6,5,0.385,0.722,36,25,9,5
4471,21700782,Golden State Warriors,Denver Nuggets,108,115,223,7,Denver Nuggets,7,0.258,0.609,42,28,9,10,0.414,0.862,48,28,7,0
4472,21700783,Dallas Mavericks,Sacramento Kings,106,99,205,7,Dallas Mavericks,7,0.317,0.786,36,28,8,0,0.296,0.833,32,23,11,3
4473,21700784,Portland Trail Blazers,Boston Celtics,96,97,193,1,Boston Celtics,1,0.419,0.786,46,21,4,9,0.417,0.706,51,24,3,6
4474,21700785,Milwaukee Bucks,Brooklyn Nets,109,94,203,15,Milwaukee Bucks,15,0.421,0.81,54,19,3,7,0.31,0.786,36,25,5,1
4475,21700786,Atlanta Hawks,New York Knicks,99,96,195,3,Atlanta Hawks,3,0.455,0.737,44,25,6,3,0.217,0.6,48,16,10,8
4476,21700787,Memphis Grizzlies,Toronto Raptors,86,101,187,15,Toronto Raptors,15,0.32,0.87,45,17,7,6,0.171,0.867,44,21,13,7
4477,21700788,Los Angeles Lakers,Oklahoma City Thunder,108,104,212,4,Los Angeles Lakers,4,0.433,0.611,40,24,6,7,0.28,0.68,46,17,13,6
4478,21700789,Charlotte Hornets,Phoenix Suns,115,110,225,5,Charlotte Hornets,5,0.263,0.862,43,24,12,6,0.517,1,39,24,4,4
4479,21700790,Portland Trail Blazers,Detroit Pistons,91,111,202,20,Detroit Pistons,20,0.303,0.875,45,18,9,5,0.5,0.667,51,36,7,4
4480,21700791,Washington Wizards,Indiana Pacers,111,102,213,9,Washington Wizards,9,0.28,0.824,43,29,8,1,0.414,0.64,35,19,6,2
4481,21700792,Orlando Magic,Miami Heat,111,109,220,2,Orlando Magic,2,0.433,0.842,39,25,8,5,0.13,0.743,53,21,5,4
4482,21700793,Utah Jazz,New Orleans Pelicans,133,109,242,24,Utah Jazz,24,0.667,0.882,45,29,6,5,0.364,0.538,30,24,10,6
4483,21700794,Charlotte Hornets,Denver Nuggets,104,121,225,17,Denver Nuggets,17,0.423,0.625,36,21,7,1,0.529,0.846,41,30,10,2
4484,21700795,Chicago Bulls,Sacramento Kings,98,104,202,6,Sacramento Kings,6,0.389,0.833,46,20,6,1,0.344,0.76,45,22,5,5
4485,21700796,Dallas Mavericks,Los Angeles Clippers,101,104,205,3,Los Angeles Clippers,3,0.405,0.9,38,22,5,5,0.37,0.833,39,28,10,3
4486,21700797,Cleveland Cavaliers,Orlando Magic,98,116,214,18,Orlando Magic,18,0.324,0.7,36,19,4,4,0.273,0.667,50,27,7,8
4487,21700798,Boston Celtics,Toronto Raptors,91,111,202,20,Toronto Raptors,20,0.435,0.75,38,21,3,3,0.472,0.824,40,29,10,4
4488,21700799,Memphis Grizzlies,Atlanta Hawks,82,108,190,26,Atlanta Hawks,26,0.182,0.769,37,23,7,5,0.32,0.762,36,29,13,5
4489,21700800,Houston Rockets,Brooklyn Nets,123,113,236,10,Houston Rockets,10,0.485,0.81,40,16,7,7,0.457,0.882,37,24,8,2
4490,21700801,Milwaukee Bucks,New York Knicks,103,89,192,14,Milwaukee Bucks,14,0.308,0.778,43,23,11,6,0.217,0.667,47,20,5,6
4491,21700802,Washington Wizards,Philadelphia 76ers,102,115,217,13,Philadelphia 76ers,13,0.259,0.722,39,23,14,2,0.5,0.786,45,27,9,4
4492,21700803,Oklahoma City Thunder,Golden State Warriors,125,105,230,20,Oklahoma City Thunder,20,0.387,0.758,40,17,14,3,0.286,0.742,45,27,7,8
4493,21700804,Phoenix Suns,Los Angeles Lakers,93,112,205,19,Los Angeles Lakers,19,0.276,0.565,48,24,4,4,0.423,0.885,56,19,7,7
4494,21700805,Brooklyn Nets,Detroit Pistons,106,115,221,9,Detroit Pistons,9,0.333,0.917,50,33,4,6,0.375,0.72,46,20,10,3
4495,21700806,Houston Rockets,Miami Heat,109,101,210,8,Houston Rockets,8,0.387,0.808,35,16,8,6,0.406,0.833,41,23,3,3
4496,21700807,Minnesota Timberwolves,Cleveland Cavaliers,138,140,278,2,Cleveland Cavaliers,2,0.576,0.917,35,33,7,4,0.512,0.652,41,33,5,1
4497,21700808,Utah Jazz,Memphis Grizzlies,92,88,180,4,Utah Jazz,4,0.273,0.848,43,14,6,4,0.348,0.75,36,18,12,5
4498,21700809,Indiana Pacers,New Orleans Pelicans,92,96,188,4,New Orleans Pelicans,4,0.318,0.944,48,15,13,5,0.348,0.833,50,15,4,11
4499,21700810,San Antonio Spurs,Phoenix Suns,129,81,210,48,San Antonio Spurs,48,0.5,0.778,62,26,6,6,0.094,0.667,44,15,8,4
4500,21700811,Atlanta Hawks,Orlando Magic,98,100,198,2,Orlando Magic,2,0.4,0.667,46,25,4,7,0.31,0.864,36,20,10,6
4501,21700812,New York Knicks,Toronto Raptors,88,113,201,25,Toronto Raptors,25,0.259,0.833,43,19,4,8,0.372,0.786,52,31,11,5
4502,21700813,Boston Celtics,Washington Wizards,110,104,214,6,Boston Celtics,6,0.346,0.676,45,16,9,6,0.462,0.8,52,28,11,4
4503,21700814,Charlotte Hornets,Portland Trail Blazers,103,109,212,6,Portland Trail Blazers,6,0.394,0.824,44,17,10,3,0.29,0.818,57,18,7,7
4504,21700815,Dallas Mavericks,Golden State Warriors,103,121,224,18,Golden State Warriors,18,0.243,0.824,34,19,15,7,0.483,0.85,51,37,6,7
4505,21700816,Oklahoma City Thunder,Los Angeles Lakers,81,106,187,25,Los Angeles Lakers,25,0.235,0.474,50,16,6,4,0.323,0.923,51,28,5,7
4506,21700817,Los Angeles Clippers,Detroit Pistons,108,95,203,13,Los Angeles Clippers,13,0.333,0.933,57,23,6,3,0.323,0.765,40,22,5,5
4507,21700818,New Orleans Pelicans,Philadelphia 76ers,82,100,182,18,Philadelphia 76ers,18,0.258,0.5,46,17,8,6,0.412,0.889,58,26,10,4
4508,21700819,Cleveland Cavaliers,Atlanta Hawks,123,107,230,16,Cleveland Cavaliers,16,0.429,0.667,43,31,8,4,0.364,0.895,42,20,4,4
4509,21700820,Indiana Pacers,Boston Celtics,97,91,188,6,Indiana Pacers,6,0.25,0.818,53,18,6,5,0.259,0.8,38,16,5,8
4510,21700821,Milwaukee Bucks,Miami Heat,85,91,176,6,Miami Heat,6,0.3,0.882,37,18,9,9,0.385,0.944,51,16,7,7
4511,21700822,Minnesota Timberwolves,Chicago Bulls,113,114,227,1,Chicago Bulls,1,0.364,0.821,46,19,8,4,0.346,0.767,39,22,5,4
4512,21700823,Denver Nuggets,Houston Rockets,104,130,234,26,Houston Rockets,26,0.107,0.81,39,25,7,2,0.463,0.735,48,26,5,7
4513,21700824,Charlotte Hornets,Utah Jazz,94,106,200,12,Utah Jazz,12,0.375,0.789,33,17,8,2,0.345,0.824,49,29,5,7
4514,21700825,Portland Trail Blazers,Sacramento Kings,118,100,218,18,Portland Trail Blazers,18,0.429,0.944,45,18,10,4,0.391,0.714,43,25,5,3
4515,21700826,New Orleans Pelicans,Brooklyn Nets,138,128,266,10,New Orleans Pelicans,10,0.375,0.641,59,23,10,10,0.356,0.955,60,30,10,3
4516,21700827,Milwaukee Bucks,Orlando Magic,111,104,215,7,Milwaukee Bucks,7,0.36,0.8,41,28,7,4,0.267,0.846,41,23,7,3
4517,21700828,Los Angeles Clippers,Philadelphia 76ers,98,112,210,14,Philadelphia 76ers,14,0.25,0.609,53,20,7,5,0.394,0.765,45,32,12,8
4518,21700829,Washington Wizards,Chicago Bulls,101,90,191,11,Washington Wizards,11,0.342,0.857,41,31,8,3,0.281,0.813,45,23,11,2
4519,21700830,Los Angeles Lakers,Dallas Mavericks,123,130,253,7,Dallas Mavericks,7,0.471,0.682,37,29,7,0,0.444,0.815,40,32,8,3
4520,21700831,San Antonio Spurs,Golden State Warriors,105,122,227,17,Golden State Warriors,17,0.185,0.737,34,30,8,5,0.444,0.933,44,35,5,6
4521,21700832,Denver Nuggets,Phoenix Suns,123,113,236,10,Denver Nuggets,10,0.448,0.909,37,20,10,5,0.368,0.56,36,24,7,9
4522,21700833,Toronto Raptors,Charlotte Hornets,123,103,226,20,Toronto Raptors,20,0.486,0.7,40,35,7,8,0.435,0.739,42,26,5,5
4523,21700834,Detroit Pistons,Atlanta Hawks,115,118,233,3,Atlanta Hawks,3,0.394,0.788,40,30,6,4,0.345,0.865,35,27,10,3
4524,21700835,Cleveland Cavaliers,Boston Celtics,121,99,220,22,Cleveland Cavaliers,22,0.533,0.75,41,22,7,6,0.263,0.773,43,22,3,4
4525,21700836,New York Knicks,Indiana Pacers,113,121,234,8,Indiana Pacers,8,0.257,0.88,45,27,8,3,0.429,0.682,54,27,7,5
4526,21700837,Dallas Mavericks,Houston Rockets,97,104,201,7,Houston Rockets,7,0.323,0.688,52,26,6,4,0.289,0.697,42,15,9,7
4527,21700838,Sacramento Kings,Minnesota Timberwolves,106,111,217,5,Minnesota Timberwolves,5,0.4,0.706,43,17,12,2,0.375,0.875,37,29,10,5
4528,21700839,Memphis Grizzlies,Oklahoma City Thunder,92,110,202,18,Oklahoma City Thunder,18,0.214,0.917,47,21,4,5,0.432,0.65,38,21,6,3
4529,21700840,Utah Jazz,Portland Trail Blazers,115,96,211,19,Utah Jazz,19,0.5,0.909,58,23,8,4,0.36,0.84,37,16,7,4
4530,21700841,New Orleans Pelicans,Detroit Pistons,118,103,221,15,New Orleans Pelicans,15,0.412,1,53,31,6,7,0.257,0.75,54,18,5,3
4531,21700842,New York Knicks,Philadelphia 76ers,92,108,200,16,Philadelphia 76ers,16,0.25,0.857,33,16,5,4,0.526,0.667,37,27,13,6
4532,21700843,Los Angeles Clippers,Brooklyn Nets,114,101,215,13,Los Angeles Clippers,13,0.375,0.857,43,19,8,6,0.3,0.7,37,27,10,6
4533,21700844,Orlando Magic,Chicago Bulls,101,105,206,4,Chicago Bulls,4,0.323,0.895,39,24,8,7,0.281,0.762,46,25,6,3
4534,21700845,San Antonio Spurs,Utah Jazz,99,101,200,2,Utah Jazz,2,0.24,0.68,44,23,5,8,0.458,0.667,43,15,7,5
4535,21700846,Phoenix Suns,Golden State Warriors,83,129,212,46,Golden State Warriors,46,0.13,0.636,47,13,2,3,0.423,0.667,49,36,8,16
4536,21700847,Miami Heat,Toronto Raptors,112,115,227,3,Toronto Raptors,3,0.414,0.842,51,24,5,3,0.371,0.783,40,24,7,3
4537,21700848,Atlanta Hawks,Milwaukee Bucks,92,97,189,5,Milwaukee Bucks,5,0.343,0.7,50,21,7,6,0.32,0.765,48,23,6,10
4538,21700849,Houston Rockets,Minnesota Timberwolves,126,108,234,18,Houston Rockets,18,0.468,0.759,37,25,1,4,0.261,0.957,40,22,3,4
4539,21700850,Cleveland Cavaliers,Oklahoma City Thunder,120,112,232,8,Cleveland Cavaliers,8,0.444,0.636,41,24,6,3,0.314,0.7,51,23,6,3
4540,21700851,Sacramento Kings,Dallas Mavericks,114,109,223,5,Sacramento Kings,5,0.414,0.667,38,30,6,4,0.375,0.783,37,29,4,4
4541,21700852,San Antonio Spurs,Denver Nuggets,109,117,226,8,Denver Nuggets,8,0.273,0.682,42,24,6,7,0.313,0.833,35,29,10,3
4542,21700853,Atlanta Hawks,Detroit Pistons,98,104,202,6,Detroit Pistons,6,0.182,0.842,43,25,9,4,0.394,0.84,47,26,3,5
4543,21700854,Charlotte Hornets,Orlando Magic,104,102,206,2,Charlotte Hornets,2,0.433,0.789,45,26,14,4,0.405,0.882,48,21,7,0
4544,21700855,Miami Heat,Philadelphia 76ers,102,104,206,2,Philadelphia 76ers,2,0.407,0.724,29,23,9,5,0.257,0.68,60,25,6,2
4545,21700856,Indiana Pacers,Brooklyn Nets,108,103,211,5,Indiana Pacers,5,0.4,0.857,52,20,10,7,0.371,0.741,44,24,4,2
4546,21700857,Washington Wizards,New York Knicks,118,113,231,5,Washington Wizards,5,0.318,0.789,45,31,7,9,0.474,0.778,42,21,7,1
4547,21700858,Los Angeles Clippers,Boston Celtics,129,119,248,10,Los Angeles Clippers,10,0.379,0.909,43,26,5,5,0.484,0.952,46,24,4,7
4548,21700859,Toronto Raptors,Chicago Bulls,122,98,220,24,Toronto Raptors,24,0.368,0.8,50,38,5,8,0.167,0.8,42,17,5,6
4549,21700860,Sacramento Kings,Houston Rockets,91,100,191,9,Houston Rockets,9,0.313,0.625,48,26,8,5,0.286,0.909,48,19,10,5
4550,21700861,Oklahoma City Thunder,Memphis Grizzlies,121,114,235,7,Oklahoma City Thunder,7,0.459,0.686,38,26,7,6,0.519,0.8,41,29,6,2
4551,21700862,Los Angeles Lakers,New Orleans Pelicans,117,139,256,22,New Orleans Pelicans,22,0.455,0.833,37,26,5,3,0.438,0.905,48,35,13,7
4552,21700863,Phoenix Suns,Utah Jazz,97,107,204,10,Utah Jazz,10,0.414,0.708,41,19,5,6,0.294,0.864,54,22,6,3
4553,21700864,Golden State Warriors,Portland Trail Blazers,117,123,240,6,Portland Trail Blazers,6,0.351,0.947,41,24,8,7,0.364,0.875,49,20,9,0
4554,21700865,Denver Nuggets,Milwaukee Bucks,134,123,257,11,Denver Nuggets,11,0.6,0.8,34,37,9,6,0.346,0.727,40,27,9,5
4555,21700866,Los Angeles Lakers,Minnesota Timberwolves,111,119,230,8,Minnesota Timberwolves,8,0.226,0.692,46,19,6,4,0.25,0.935,46,23,5,10
4556,21700867,Brooklyn Nets,Charlotte Hornets,96,111,207,15,Charlotte Hornets,15,0.326,0.714,41,27,6,8,0.524,0.8,54,29,3,6
4557,21700868,New York Knicks,Orlando Magic,120,113,233,7,New York Knicks,7,0.28,0.81,47,28,7,12,0.458,0.696,39,28,7,5
4558,21700869,Washington Wizards,Cleveland Cavaliers,110,103,213,7,Washington Wizards,7,0.4,1,43,29,9,3,0.229,0.579,36,20,5,2
4559,21700870,Philadelphia 76ers,Chicago Bulls,116,115,231,1,Philadelphia 76ers,1,0.379,0.6,41,25,7,5,0.529,0.6,48,27,5,4
4560,21700871,Oklahoma City Thunder,Sacramento Kings,110,107,217,3,Oklahoma City Thunder,3,0.4,0.833,49,26,6,7,0.444,0.733,44,23,6,4
4561,21700872,Los Angeles Clippers,Golden State Warriors,127,134,261,7,Golden State Warriors,7,0.344,0.824,36,32,9,2,0.56,0.765,32,31,8,8
4562,21700873,Boston Celtics,Detroit Pistons,110,98,208,12,Boston Celtics,12,0.436,0.611,42,30,8,5,0.303,0.667,45,16,4,4
4563,21700874,Atlanta Hawks,Indiana Pacers,93,116,209,23,Indiana Pacers,23,0.226,0.632,40,14,9,7,0.321,0.846,57,30,17,3
4564,21700875,Charlotte Hornets,Washington Wizards,122,105,227,17,Charlotte Hornets,17,0.436,0.85,41,26,7,5,0.36,0.941,36,25,3,0
4565,21700876,Milwaukee Bucks,Toronto Raptors,122,119,241,3,Milwaukee Bucks,3,0.5,0.852,51,21,6,3,0.265,0.923,37,23,7,8
4566,21700877,Minnesota Timberwolves,Houston Rockets,102,120,222,18,Houston Rockets,18,0.385,0.75,43,19,6,3,0.368,0.867,50,24,6,2
4567,21700878,Cleveland Cavaliers,Memphis Grizzlies,112,89,201,23,Cleveland Cavaliers,23,0.379,0.955,46,26,13,9,0.375,0.778,37,22,10,4
4568,21700879,Miami Heat,New Orleans Pelicans,123,124,247,1,New Orleans Pelicans,1,0.333,0.654,58,26,12,5,0.258,0.833,56,27,9,13
4569,21700880,San Antonio Spurs,Denver Nuggets,119,122,241,3,Denver Nuggets,3,0.313,0.718,38,28,4,4,0.375,0.737,52,33,5,3
4570,21700881,Los Angeles Clippers,Phoenix Suns,128,117,245,11,Los Angeles Clippers,11,0.438,0.75,51,23,5,8,0.29,0.581,48,22,12,5
4571,21700882,Portland Trail Blazers,Utah Jazz,100,81,181,19,Portland Trail Blazers,19,0.375,0.929,41,14,11,5,0.24,0.818,43,15,7,6
4572,21700883,Dallas Mavericks,Los Angeles Lakers,102,124,226,22,Los Angeles Lakers,22,0.452,0.818,29,25,9,8,0.394,0.75,62,32,8,6
4573,21700884,Orlando Magic,Philadelphia 76ers,105,116,221,11,Philadelphia 76ers,11,0.419,0.842,33,27,7,5,0.333,0.852,45,31,5,4
4574,21700885,Memphis Grizzlies,Miami Heat,89,115,204,26,Miami Heat,26,0.455,0.824,40,16,7,3,0.364,0.778,50,27,15,6
4575,21700886,Boston Celtics,New York Knicks,121,112,233,9,Boston Celtics,9,0.394,0.857,45,21,11,5,0.222,0.8,49,20,10,4
4576,21700887,Oklahoma City Thunder,Golden State Warriors,80,112,192,32,Golden State Warriors,32,0.265,0.619,43,19,8,3,0.447,0.846,54,36,8,6
4577,21700888,Chicago Bulls,Minnesota Timberwolves,104,122,226,18,Minnesota Timberwolves,18,0.261,0.7,42,21,5,9,0.314,0.731,51,25,6,4
4578,21700889,Portland Trail Blazers,Phoenix Suns,106,104,210,2,Portland Trail Blazers,2,0.2,0.733,48,15,6,7,0.423,0.714,51,23,5,10
4579,21700890,Dallas Mavericks,Utah Jazz,90,97,187,7,Utah Jazz,7,0.286,0.857,44,19,6,4,0.281,0.769,44,26,6,3
4580,21700891,Los Angeles Lakers,Sacramento Kings,113,108,221,5,Los Angeles Lakers,5,0.447,0.7,44,26,5,6,0.52,0.647,48,28,5,5
4581,21700892,Detroit Pistons,Charlotte Hornets,98,114,212,16,Charlotte Hornets,16,0.222,0.714,41,23,4,2,0.457,0.609,47,28,9,4
4582,21700893,New Orleans Pelicans,Milwaukee Bucks,123,121,244,2,New Orleans Pelicans,2,0.333,0.786,50,22,8,7,0.28,0.897,44,21,10,3
4583,21700894,San Antonio Spurs,Cleveland Cavaliers,110,94,204,16,San Antonio Spurs,16,0.474,0.781,44,22,11,9,0.235,0.714,47,18,8,3
4584,21700895,Philadelphia 76ers,Washington Wizards,94,109,203,15,Washington Wizards,15,0.273,0.742,43,24,13,3,0.48,0.917,48,35,9,6
4585,21700896,Houston Rockets,Denver Nuggets,119,114,233,5,Houston Rockets,5,0.429,0.813,42,18,7,3,0.345,0.667,36,33,13,6
4586,21700897,Los Angeles Lakers,Atlanta Hawks,123,104,227,19,Los Angeles Lakers,19,0.455,0.737,59,28,8,6,0.222,0.706,41,21,14,3
4587,21700898,Memphis Grizzlies,Boston Celtics,98,109,207,11,Boston Celtics,11,0.217,0.781,40,27,4,2,0.324,0.704,44,25,5,5
4588,21700899,Chicago Bulls,Brooklyn Nets,87,104,191,17,Brooklyn Nets,17,0.261,0.652,56,17,8,7,0.381,1,48,31,4,9
4589,21700900,Golden State Warriors,New York Knicks,125,111,236,14,Golden State Warriors,14,0.484,0.846,43,31,8,5,0.4,0.778,39,28,7,3
4590,21700901,Detroit Pistons,Toronto Raptors,94,123,217,29,Toronto Raptors,29,0.318,0.75,42,20,11,3,0.447,0.957,47,31,10,7
4591,21700902,Phoenix Suns,New Orleans Pelicans,116,125,241,9,New Orleans Pelicans,9,0.292,0.781,51,23,9,5,0.286,0.775,46,30,7,8
4592,21700903,Orlando Magic,Oklahoma City Thunder,105,112,217,7,Oklahoma City Thunder,7,0.414,0.714,35,23,15,6,0.44,0.85,50,24,6,6
4593,21700904,Indiana Pacers,Dallas Mavericks,103,109,212,6,Dallas Mavericks,6,0.25,0.696,50,22,6,4,0.378,0.833,44,20,9,3
4594,21700905,Houston Rockets,Utah Jazz,96,85,181,11,Houston Rockets,11,0.273,0.76,40,15,15,2,0.241,0.727,39,21,6,4
4595,21700906,Minnesota Timberwolves,Sacramento Kings,118,100,218,18,Minnesota Timberwolves,18,0.438,0.917,43,22,11,4,0.364,0.923,31,22,5,3
4596,21700907,Chicago Bulls,Charlotte Hornets,103,118,221,15,Charlotte Hornets,15,0.375,0.762,44,26,8,5,0.429,0.714,35,28,11,8
4597,21700908,Brooklyn Nets,Cleveland Cavaliers,123,129,252,6,Cleveland Cavaliers,6,0.375,0.767,36,29,6,0,0.5,0.63,55,24,7,1
4598,21700909,Philadelphia 76ers,Miami Heat,101,102,203,1,Miami Heat,1,0.387,0.826,44,25,10,3,0.333,0.75,37,19,12,9
4599,21700910,Washington Wizards,Milwaukee Bucks,107,104,211,3,Washington Wizards,3,0.35,0.727,40,30,9,6,0.385,0.857,40,20,10,9
4600,21700911,Sacramento Kings,Portland Trail Blazers,99,116,215,17,Portland Trail Blazers,17,0.318,0.933,36,20,14,4,0.441,0.765,47,27,10,2
4601,21700912,Los Angeles Clippers,Denver Nuggets,122,120,242,2,Los Angeles Clippers,2,0.269,0.742,43,26,12,7,0.323,0.8,41,27,11,7
4602,21700913,Milwaukee Bucks,Detroit Pistons,87,110,197,23,Detroit Pistons,23,0.333,0.821,35,16,7,3,0.31,0.773,57,26,9,0
4603,21700914,Toronto Raptors,Orlando Magic,117,104,221,13,Toronto Raptors,13,0.4,0.625,42,33,9,7,0.433,0.565,42,27,8,2
4604,21700915,Indiana Pacers,Atlanta Hawks,102,107,209,5,Atlanta Hawks,5,0.344,0.75,43,21,13,5,0.31,0.815,49,21,13,11
4605,21700916,Charlotte Hornets,Boston Celtics,106,134,240,28,Boston Celtics,28,0.333,0.591,33,24,6,6,0.6,0.933,47,31,3,4
4606,21700917,Golden State Warriors,Washington Wizards,109,101,210,8,Golden State Warriors,8,0.417,0.833,36,24,10,8,0.344,0.857,51,25,6,4
4607,21700918,Phoenix Suns,Memphis Grizzlies,110,102,212,8,Phoenix Suns,8,0.286,0.737,47,19,12,6,0.419,0.821,48,23,8,8
4608,21700919,Oklahoma City Thunder,Dallas Mavericks,111,110,221,1,Oklahoma City Thunder,1,0.278,0.895,56,19,7,2,0.361,0.6,36,30,11,1
4609,21700920,New Orleans Pelicans,San Antonio Spurs,121,116,237,5,New Orleans Pelicans,5,0.346,0.8,43,26,7,3,0.346,0.786,47,23,7,9
4610,21700921,Houston Rockets,Los Angeles Clippers,105,92,197,13,Houston Rockets,13,0.302,0.833,41,21,11,5,0.304,0.684,39,17,6,2
4611,21700922,Los Angeles Lakers,Miami Heat,131,113,244,18,Los Angeles Lakers,18,0.552,0.808,36,29,9,5,0.29,0.75,40,23,6,5
4612,21700923,Philadelphia 76ers,Cleveland Cavaliers,108,97,205,11,Philadelphia 76ers,11,0.333,0.667,54,22,4,5,0.281,0.696,45,23,4,6
4613,21700924,Brooklyn Nets,Sacramento Kings,111,116,227,5,Sacramento Kings,5,0.37,0.824,51,27,10,4,0.429,0.833,44,23,15,6
4614,21700925,Minnesota Timberwolves,Portland Trail Blazers,99,108,207,9,Portland Trail Blazers,9,0.2,0.905,49,16,5,7,0.3,0.771,48,17,9,6
4615,21700926,Detroit Pistons,Orlando Magic,106,115,221,9,Orlando Magic,9,0.414,0.583,43,22,10,1,0.361,0.737,45,34,8,3
4616,21700927,Charlotte Hornets,Philadelphia 76ers,99,110,209,11,Philadelphia 76ers,11,0.458,0.625,39,21,7,0,0.375,0.76,46,27,4,5
4617,21700928,Golden State Warriors,Atlanta Hawks,114,109,223,5,Golden State Warriors,5,0.355,0.864,35,33,12,5,0.429,0.9,35,21,10,2
4618,21700929,Toronto Raptors,Washington Wizards,102,95,197,7,Toronto Raptors,7,0.303,0.625,34,19,9,5,0.375,0.667,47,24,2,5
4619,21700930,Dallas Mavericks,Chicago Bulls,100,108,208,8,Chicago Bulls,8,0.448,0.81,46,21,6,4,0.37,0.7,45,24,10,2
4620,21700931,Denver Nuggets,Memphis Grizzlies,108,102,210,6,Denver Nuggets,6,0.273,0.846,37,18,17,3,0.37,0.8,40,26,14,3
4621,21700932,Indiana Pacers,Milwaukee Bucks,103,96,199,7,Indiana Pacers,7,0.375,0.767,48,19,12,4,0.36,0.781,43,15,9,13
4622,21700933,Oklahoma City Thunder,Phoenix Suns,124,116,240,8,Oklahoma City Thunder,8,0.324,0.724,48,22,5,11,0.44,0.722,44,26,5,12
4623,21700934,Minnesota Timberwolves,Utah Jazz,108,116,224,8,Utah Jazz,8,0.529,0.742,27,14,9,0,0.31,0.771,45,21,7,5
4624,21700935,New York Knicks,Los Angeles Clippers,105,128,233,23,Los Angeles Clippers,23,0.44,0.75,33,24,4,4,0.36,0.792,51,34,14,6
4625,21700936,Memphis Grizzlies,Orlando Magic,100,107,207,7,Orlando Magic,7,0.273,0.692,46,24,9,3,0.32,0.818,44,19,4,9
4626,21700937,Denver Nuggets,Cleveland Cavaliers,126,117,243,9,Denver Nuggets,9,0.543,0.867,35,35,4,3,0.375,0.762,41,25,5,2
4627,21700938,Detroit Pistons,Miami Heat,96,105,201,9,Miami Heat,9,0.292,0.714,46,18,8,2,0.414,0.679,45,19,11,5
4628,21700939,Boston Celtics,Houston Rockets,120,123,243,3,Houston Rockets,3,0.542,0.905,38,22,6,3,0.388,0.867,40,24,11,5
4629,21700940,Los Angeles Lakers,San Antonio Spurs,116,112,228,4,Los Angeles Lakers,4,0.441,0.778,46,26,10,4,0.233,0.85,50,28,10,5
4630,21700941,Oklahoma City Thunder,Portland Trail Blazers,100,108,208,8,Portland Trail Blazers,8,0.222,0.667,40,18,6,6,0.333,0.826,47,20,6,8
4631,21700942,Utah Jazz,Sacramento Kings,98,91,189,7,Utah Jazz,7,0.344,0.655,52,20,9,7,0.3,0.824,48,15,7,7
4632,21700943,Phoenix Suns,Atlanta Hawks,112,113,225,1,Atlanta Hawks,1,0.423,0.6,41,33,6,6,0.515,0.833,49,23,7,5
4633,21700944,Charlotte Hornets,Toronto Raptors,98,103,201,5,Toronto Raptors,5,0.238,0.829,46,16,7,4,0.293,0.778,50,22,5,8
4634,21700945,Indiana Pacers,Washington Wizards,98,95,193,3,Indiana Pacers,3,0.32,0.917,43,11,10,0,0.37,0.789,42,21,9,2
4635,21700946,New Orleans Pelicans,Dallas Mavericks,126,109,235,17,New Orleans Pelicans,17,0.462,0.762,47,27,9,4,0.435,0.76,43,25,5,2
4636,21700947,Philadelphia 76ers,Milwaukee Bucks,110,118,228,8,Milwaukee Bucks,8,0.5,0.818,32,26,4,9,0.435,0.636,38,27,15,4
4637,21700948,Brooklyn Nets,Los Angeles Clippers,120,123,243,3,Los Angeles Clippers,3,0.422,0.913,44,30,8,4,0.37,0.833,40,18,12,6
4638,21700949,New York Knicks,Sacramento Kings,99,102,201,3,Sacramento Kings,3,0.286,0.722,48,21,8,7,0.433,1,38,21,5,5
4639,21700950,Detroit Pistons,Cleveland Cavaliers,90,112,202,22,Cleveland Cavaliers,22,0.353,0.667,40,17,9,6,0.364,0.824,53,29,8,2
4640,21700951,Milwaukee Bucks,Indiana Pacers,89,92,181,3,Indiana Pacers,3,0.304,0.875,39,15,8,7,0.588,0.762,37,18,13,5
4641,21700952,Phoenix Suns,Miami Heat,103,125,228,22,Miami Heat,22,0.417,0.5,40,21,3,2,0.333,0.826,51,33,12,6
4642,21700953,Boston Celtics,Chicago Bulls,105,89,194,16,Boston Celtics,16,0.333,0.917,53,25,7,4,0.364,0.65,36,18,14,1
4643,21700954,Memphis Grizzlies,San Antonio Spurs,98,100,198,2,San Antonio Spurs,2,0.364,0.667,42,26,8,5,0.273,0.774,36,18,14,4
4644,21700955,Orlando Magic,Utah Jazz,80,94,174,14,Utah Jazz,14,0.324,0.786,36,18,7,4,0.323,0.667,48,23,8,7
4645,21700956,Portland Trail Blazers,Los Angeles Lakers,108,103,211,5,Portland Trail Blazers,5,0.435,0.737,50,19,6,5,0.297,0.774,47,20,9,7
4646,21700957,Philadelphia 76ers,Charlotte Hornets,128,114,242,14,Philadelphia 76ers,14,0.485,0.8,44,35,6,4,0.379,0.742,33,26,7,5
4647,21700958,Atlanta Hawks,Toronto Raptors,90,106,196,16,Toronto Raptors,16,0.286,0.762,44,22,8,6,0.278,0.848,45,25,12,8
4648,21700959,Miami Heat,Washington Wizards,113,117,230,4,Washington Wizards,4,0.273,0.741,41,26,11,3,0.583,0.852,41,25,7,3
4649,21700960,Houston Rockets,Oklahoma City Thunder,122,112,234,10,Houston Rockets,10,0.515,0.853,37,25,11,7,0.353,0.727,34,18,12,4
4650,21700961,Denver Nuggets,Dallas Mavericks,107,118,225,11,Dallas Mavericks,11,0.306,0.769,49,23,5,8,0.556,0.739,51,24,8,3
4651,21700962,New York Knicks,Portland Trail Blazers,87,111,198,24,Portland Trail Blazers,24,0.368,0.667,39,21,7,7,0.606,0.875,51,22,4,4
4652,21700963,Brooklyn Nets,Golden State Warriors,101,114,215,13,Golden State Warriors,13,0.265,0.8,38,24,7,1,0.478,0.818,41,30,8,7
4653,21700964,New Orleans Pelicans,Los Angeles Clippers,121,116,237,5,New Orleans Pelicans,5,0.433,0.889,51,39,11,12,0.259,0.654,57,25,5,2
4654,21700965,Utah Jazz,Indiana Pacers,104,84,188,20,Utah Jazz,20,0.355,0.688,42,30,9,5,0.13,0.765,45,12,9,3
4655,21700966,Toronto Raptors,Detroit Pistons,121,119,240,2,Toronto Raptors,2,0.3,0.905,47,33,9,7,0.5,0.783,51,27,2,7
4656,21700967,Memphis Grizzlies,Chicago Bulls,110,119,229,9,Chicago Bulls,9,0.345,0.8,33,24,12,3,0.379,0.75,41,25,10,1
4657,21700968,Houston Rockets,Milwaukee Bucks,110,99,209,11,Houston Rockets,11,0.35,0.667,47,22,9,5,0.321,0.737,38,21,9,3
4658,21700969,New Orleans Pelicans,Sacramento Kings,114,101,215,13,New Orleans Pelicans,13,0.423,1,40,26,6,7,0.321,0.824,39,20,4,5
4659,21700970,Cleveland Cavaliers,Denver Nuggets,113,108,221,5,Cleveland Cavaliers,5,0.448,0.667,35,25,10,4,0.37,0.778,51,22,7,2
4660,21700971,Orlando Magic,Los Angeles Lakers,107,108,215,1,Los Angeles Lakers,1,0.429,0.579,43,31,5,4,0.333,0.917,39,27,7,3
4661,21700972,Brooklyn Nets,Charlotte Hornets,125,111,236,14,Brooklyn Nets,14,0.344,0.909,43,30,7,7,0.211,0.833,36,19,5,5
4662,21700973,Philadelphia 76ers,Miami Heat,99,108,207,9,Miami Heat,9,0.405,0.762,46,28,9,4,0.538,0.556,49,26,10,8
4663,21700974,Boston Celtics,Minnesota Timberwolves,117,109,226,8,Boston Celtics,8,0.344,0.741,46,28,7,2,0.387,0.692,47,24,3,3
4664,21700975,Phoenix Suns,Oklahoma City Thunder,87,115,202,28,Oklahoma City Thunder,28,0.243,0.889,43,15,9,4,0.394,0.667,49,21,6,11
4665,21700976,San Antonio Spurs,Golden State Warriors,107,110,217,3,Golden State Warriors,3,0.273,0.833,45,29,7,3,0.267,0.87,49,30,6,12
4666,21700977,Chicago Bulls,Detroit Pistons,83,99,182,16,Detroit Pistons,16,0.29,0.8,42,19,11,0,0.333,0.778,50,22,8,9
4667,21700978,Atlanta Hawks,Indiana Pacers,87,112,199,25,Indiana Pacers,25,0.303,0.9,35,21,11,4,0.5,0.8,49,21,11,3
4668,21700979,Houston Rockets,Toronto Raptors,105,108,213,3,Toronto Raptors,3,0.333,0.696,36,15,9,3,0.395,0.786,42,22,7,2
4669,21700980,Utah Jazz,Memphis Grizzlies,95,78,173,17,Utah Jazz,17,0.406,0.727,48,26,10,8,0.273,0.714,39,16,4,5
4670,21700981,New York Knicks,Milwaukee Bucks,112,120,232,8,Milwaukee Bucks,8,0.25,0.786,39,24,6,5,0.444,0.769,42,29,8,6
4671,21700982,Washington Wizards,New Orleans Pelicans,116,97,213,19,Washington Wizards,19,0.346,0.75,49,34,10,4,0.3,0.833,38,23,3,10
4672,21700983,Los Angeles Lakers,Denver Nuggets,116,125,241,9,Denver Nuggets,9,0.4,0.75,44,25,8,6,0.484,0.867,36,30,10,6
4673,21700984,Golden State Warriors,Portland Trail Blazers,108,125,233,17,Portland Trail Blazers,17,0.429,0.833,33,20,5,3,0.41,0.778,46,21,4,2
4674,21700985,Orlando Magic,Sacramento Kings,88,94,182,6,Sacramento Kings,6,0.31,0.813,34,17,7,4,0.36,0.867,50,24,7,3
4675,21700986,Cleveland Cavaliers,Los Angeles Clippers,102,116,218,14,Los Angeles Clippers,14,0.333,0.667,40,22,10,7,0.393,0.633,52,25,6,3
4676,21700987,Phoenix Suns,Charlotte Hornets,115,122,237,7,Charlotte Hornets,7,0.563,0.684,35,27,9,3,0.406,0.778,41,24,11,5
4677,21700988,Washington Wizards,Miami Heat,102,129,231,27,Miami Heat,27,0.35,0.794,40,22,4,2,0.357,0.714,42,27,9,5
4678,21700989,Memphis Grizzlies,Dallas Mavericks,80,114,194,34,Dallas Mavericks,34,0.389,0.765,41,19,4,4,0.345,0.857,52,21,8,3
4679,21700990,San Antonio Spurs,Oklahoma City Thunder,94,104,198,10,Oklahoma City Thunder,10,0.5,0.571,43,26,6,3,0.357,0.667,49,24,8,4
4680,21700991,Orlando Magic,Los Angeles Clippers,105,113,218,8,Los Angeles Clippers,8,0.333,0.778,33,20,12,2,0.389,0.857,41,17,9,3
4681,21700992,Toronto Raptors,New York Knicks,132,106,238,26,Toronto Raptors,26,0.457,0.88,52,32,3,3,0.333,0.792,37,21,7,4
4682,21700993,Chicago Bulls,Atlanta Hawks,129,122,251,7,Chicago Bulls,7,0.459,0.842,47,31,10,4,0.475,0.864,42,32,2,5
4683,21700994,Golden State Warriors,Minnesota Timberwolves,103,109,212,6,Minnesota Timberwolves,6,0.278,0.905,50,22,6,7,0.3,0.714,50,27,7,3
4684,21700995,Utah Jazz,New Orleans Pelicans,116,99,215,17,Utah Jazz,17,0.375,0.96,55,24,4,3,0.286,0.846,38,28,7,14
4685,21700996,Sacramento Kings,Denver Nuggets,104,130,234,26,Denver Nuggets,26,0.194,0.769,38,25,3,1,0.405,0.714,51,38,2,4
4686,21700997,Houston Rockets,Dallas Mavericks,105,82,187,23,Houston Rockets,23,0.378,0.714,45,21,5,5,0.161,0.611,53,27,5,2
4687,21700998,Indiana Pacers,Boston Celtics,99,97,196,2,Indiana Pacers,2,0.545,0.9,39,26,9,7,0.324,0.81,42,26,10,5
4688,21700999,Philadelphia 76ers,Brooklyn Nets,120,97,217,23,Philadelphia 76ers,23,0.346,0.611,48,33,12,7,0.357,0.875,42,17,5,5
4689,21701000,Cleveland Cavaliers,Los Angeles Lakers,113,127,240,14,Los Angeles Lakers,14,0.387,0.826,37,22,4,5,0.382,0.9,51,30,9,4
4690,21701001,San Antonio Spurs,Houston Rockets,93,109,202,16,Houston Rockets,16,0.393,0.696,36,20,5,2,0.295,0.783,50,24,6,4
4691,21701002,Milwaukee Bucks,Memphis Grizzlies,121,103,224,18,Milwaukee Bucks,18,0.48,0.682,47,33,6,5,0.333,0.526,31,27,6,5
4692,21701003,Sacramento Kings,Oklahoma City Thunder,101,106,207,5,Oklahoma City Thunder,5,0.364,0.813,49,21,8,6,0.444,0.778,43,21,5,6
4693,21701004,Miami Heat,Portland Trail Blazers,99,115,214,16,Portland Trail Blazers,16,0.323,0.688,46,24,6,4,0.389,0.833,50,23,5,6
4694,21701005,Indiana Pacers,Philadelphia 76ers,101,98,199,3,Indiana Pacers,3,0.208,0.8,45,20,13,2,0.333,0.818,48,24,3,7
4695,21701006,Minnesota Timberwolves,Washington Wizards,116,111,227,5,Minnesota Timberwolves,5,0.333,0.895,37,23,10,7,0.4,0.76,39,26,6,4
4696,21701007,Oklahoma City Thunder,Atlanta Hawks,119,107,226,12,Oklahoma City Thunder,12,0.457,0.76,38,27,9,11,0.419,0.833,47,26,5,5
4697,21701008,Toronto Raptors,Brooklyn Nets,116,102,218,14,Toronto Raptors,14,0.355,0.81,53,27,7,6,0.417,0.895,38,21,9,6
4698,21701009,Dallas Mavericks,New York Knicks,110,97,207,13,Dallas Mavericks,13,0.4,0.889,40,22,11,1,0.32,0.75,44,19,9,1
4699,21701010,Los Angeles Clippers,Chicago Bulls,112,106,218,6,Los Angeles Clippers,6,0.276,0.732,42,27,4,5,0.241,0.867,45,26,11,2
4700,21701011,Charlotte Hornets,New Orleans Pelicans,115,119,234,4,New Orleans Pelicans,4,0.269,0.818,45,22,8,9,0.409,0.75,50,33,10,7
4701,21701012,Orlando Magic,San Antonio Spurs,72,108,180,36,San Antonio Spurs,36,0.304,1,41,16,5,3,0.474,0.826,48,24,10,7
4702,21701013,Detroit Pistons,Utah Jazz,79,110,189,31,Utah Jazz,31,0.2,0.737,32,14,14,4,0.382,0.565,52,29,10,5
4703,21701014,Cleveland Cavaliers,Phoenix Suns,129,107,236,22,Cleveland Cavaliers,22,0.486,0.867,44,25,12,9,0.188,0.833,47,17,10,2
4704,21701015,Denver Nuggets,Los Angeles Lakers,103,112,215,9,Los Angeles Lakers,9,0.325,0.737,44,26,12,4,0.375,0.68,52,20,6,3
4705,21701016,Milwaukee Bucks,Orlando Magic,117,126,243,9,Orlando Magic,9,0.417,0.75,37,28,12,5,0.529,0.87,42,31,10,4
4706,21701017,Washington Wizards,Boston Celtics,125,124,249,1,Washington Wizards,1,0.375,0.75,52,29,10,6,0.462,0.696,44,30,9,5
4707,21701018,Miami Heat,Sacramento Kings,119,123,242,4,Sacramento Kings,4,0.419,0.905,53,26,5,2,0.333,0.76,43,23,6,7
4708,21701019,Los Angeles Lakers,Golden State Warriors,106,117,223,11,Golden State Warriors,11,0.316,0.643,35,24,11,8,0.3,0.821,50,25,8,6
4709,21701020,Toronto Raptors,Indiana Pacers,106,99,205,7,Toronto Raptors,7,0.375,0.857,57,20,4,8,0.292,0.706,34,17,12,1
4710,21701021,Charlotte Hornets,Atlanta Hawks,129,117,246,12,Charlotte Hornets,12,0.515,0.667,45,30,3,3,0.444,0.654,46,30,5,2
4711,21701022,Philadelphia 76ers,New York Knicks,118,110,228,8,Philadelphia 76ers,8,0.405,0.618,53,29,8,3,0.25,0.625,44,26,8,4
4712,21701023,Los Angeles Clippers,Houston Rockets,96,101,197,5,Houston Rockets,5,0.222,0.5,45,16,3,4,0.293,0.826,50,20,4,9
4713,21701024,Chicago Bulls,Memphis Grizzlies,111,110,221,1,Chicago Bulls,1,0.366,0.788,42,23,10,2,0.371,0.84,47,27,7,4
4714,21701025,New Orleans Pelicans,San Antonio Spurs,93,98,191,5,San Antonio Spurs,5,0.375,0.938,53,18,7,7,0.269,0.895,52,16,10,11
4715,21701026,Detroit Pistons,Denver Nuggets,113,120,233,7,Denver Nuggets,7,0.519,0.647,41,30,8,4,0.429,0.786,45,26,7,8
4716,21701027,Phoenix Suns,Utah Jazz,88,116,204,28,Utah Jazz,28,0.438,0.708,51,14,4,4,0.333,0.625,53,29,12,8
4717,21701028,Cleveland Cavaliers,Portland Trail Blazers,105,113,218,8,Portland Trail Blazers,8,0.333,0.571,34,17,5,7,0.343,0.789,50,26,4,3
4718,21701029,Boston Celtics,Orlando Magic,92,83,175,9,Boston Celtics,9,0.346,0.75,55,16,7,6,0.179,0.909,40,14,12,7
4719,21701030,Brooklyn Nets,Philadelphia 76ers,116,120,236,4,Philadelphia 76ers,4,0.5,0.778,47,25,4,5,0.444,0.846,42,30,9,3
4720,21701031,Dallas Mavericks,Toronto Raptors,115,122,237,7,Toronto Raptors,7,0.273,0.722,36,25,7,5,0.333,0.839,45,26,5,8
4721,21701032,Los Angeles Clippers,Oklahoma City Thunder,113,121,234,8,Oklahoma City Thunder,8,0.423,0.783,48,21,10,3,0.344,0.818,46,30,17,10
4722,21701033,Sacramento Kings,Golden State Warriors,98,93,191,5,Sacramento Kings,5,0.452,0.706,47,25,7,4,0.462,0.722,40,21,10,5
4723,21701034,Miami Heat,Los Angeles Lakers,92,91,183,1,Miami Heat,1,0.278,0.714,43,23,14,6,0.474,0.818,49,22,5,4
4724,21701035,Indiana Pacers,Washington Wizards,102,109,211,7,Washington Wizards,7,0.5,0.8,38,24,6,4,0.5,0.826,38,29,9,2
4725,21701036,Houston Rockets,New Orleans Pelicans,107,101,208,6,Houston Rockets,6,0.366,0.778,46,19,8,7,0.333,0.917,40,18,4,8
4726,21701037,Dallas Mavericks,Brooklyn Nets,106,114,220,8,Brooklyn Nets,8,0.545,0.857,45,25,5,3,0.389,0.737,43,25,4,6
4727,21701038,Charlotte Hornets,New York Knicks,101,124,225,23,New York Knicks,23,0.273,0.813,50,11,7,5,0.462,0.778,56,24,7,5
4728,21701039,Cleveland Cavaliers,Chicago Bulls,114,109,223,5,Cleveland Cavaliers,5,0.351,0.65,44,25,4,5,0.471,0.733,45,30,4,3
4729,21701040,Denver Nuggets,Memphis Grizzlies,94,101,195,7,Memphis Grizzlies,7,0.273,0.724,49,17,10,5,0.406,0.786,47,21,5,9
4730,21701041,Atlanta Hawks,Milwaukee Bucks,117,122,239,5,Milwaukee Bucks,5,0.333,0.964,44,23,7,4,0.44,0.906,44,31,12,8
4731,21701042,Minnesota Timberwolves,San Antonio Spurs,101,117,218,16,San Antonio Spurs,16,0.583,0.8,34,22,3,2,0.231,0.929,41,32,11,8
4732,21701043,Sacramento Kings,Utah Jazz,97,103,200,6,Utah Jazz,6,0.667,0.643,33,23,11,5,0.25,0.816,48,21,8,8
4733,21701044,Golden State Warriors,Phoenix Suns,124,109,233,15,Golden State Warriors,15,0.419,0.786,43,29,8,9,0.458,0.69,42,22,8,5
4734,21701045,Detroit Pistons,Portland Trail Blazers,87,100,187,13,Portland Trail Blazers,13,0.4,0.75,43,17,6,2,0.258,0.889,49,23,8,8
4735,21701046,Oklahoma City Thunder,Toronto Raptors,132,125,257,7,Oklahoma City Thunder,7,0.476,0.706,39,27,11,2,0.5,0.783,31,31,5,1
4736,21701047,Boston Celtics,New Orleans Pelicans,89,108,197,19,New Orleans Pelicans,19,0.346,0.5,44,17,8,3,0.333,0.8,44,33,9,5
4737,21701048,Houston Rockets,Minnesota Timberwolves,129,120,249,9,Houston Rockets,9,0.457,0.75,33,28,7,8,0.5,0.769,41,24,7,1
4738,21701049,Portland Trail Blazers,Los Angeles Clippers,122,109,231,13,Portland Trail Blazers,13,0.483,0.8,47,24,7,6,0.391,0.741,38,21,8,3
4739,21701050,Milwaukee Bucks,Cleveland Cavaliers,117,124,241,7,Cleveland Cavaliers,7,0.258,0.95,32,26,11,7,0.395,0.852,42,24,4,6
4740,21701051,Los Angeles Lakers,Indiana Pacers,100,110,210,10,Indiana Pacers,10,0.242,0.696,47,20,4,3,0.286,0.947,44,24,9,8
4741,21701052,Charlotte Hornets,Philadelphia 76ers,94,108,202,14,Philadelphia 76ers,14,0.273,0.8,39,16,8,4,0.409,0.75,60,30,5,6
4742,21701053,Memphis Grizzlies,Brooklyn Nets,115,118,233,3,Brooklyn Nets,3,0.435,0.65,42,21,11,3,0.4,0.75,41,27,5,9
4743,21701054,Denver Nuggets,Miami Heat,141,149,290,8,Miami Heat,8,0.474,0.838,46,23,10,5,0.556,0.63,46,36,5,11
4744,21701055,Chicago Bulls,New York Knicks,92,110,202,18,New York Knicks,18,0.1,0.742,48,21,9,7,0.314,0.765,61,28,6,7
4745,21701056,Golden State Warriors,San Antonio Spurs,75,89,164,14,San Antonio Spurs,14,0.158,0.75,36,17,7,9,0.348,0.714,48,21,6,5
4746,21701057,Detroit Pistons,Sacramento Kings,106,90,196,16,Detroit Pistons,16,0.483,0.818,44,17,6,5,0.261,0.444,39,23,7,3
4747,21701058,Toronto Raptors,Orlando Magic,93,86,179,7,Toronto Raptors,7,0.389,0.529,45,19,7,8,0.36,0.6,45,22,13,7
4748,21701059,Oklahoma City Thunder,Boston Celtics,99,100,199,1,Boston Celtics,1,0.37,0.655,44,19,6,6,0.361,0.938,52,22,6,5
4749,21701060,Los Angeles Clippers,Minnesota Timberwolves,109,123,232,14,Minnesota Timberwolves,14,0.333,0.808,41,21,4,5,0.4,0.958,40,23,5,6
4750,21701061,Dallas Mavericks,New Orleans Pelicans,105,115,220,10,New Orleans Pelicans,10,0.286,0.818,40,25,4,2,0.4,0.6,46,33,5,2
4751,21701062,Atlanta Hawks,Utah Jazz,99,94,193,5,Atlanta Hawks,5,0.273,0.737,52,21,7,3,0.176,0.88,51,16,8,8
4752,21701063,Detroit Pistons,Phoenix Suns,115,88,203,27,Detroit Pistons,27,0.417,0.875,50,22,12,14,0.206,0.65,49,22,1,8
4753,21701064,Houston Rockets,Portland Trail Blazers,115,111,226,4,Houston Rockets,4,0.528,0.69,38,18,3,4,0.393,0.741,44,20,6,7
4754,21701065,Toronto Raptors,Cleveland Cavaliers,129,132,261,3,Cleveland Cavaliers,3,0.441,0.87,33,32,4,5,0.625,0.821,33,28,3,4
4755,21701066,Memphis Grizzlies,Philadelphia 76ers,105,119,224,14,Philadelphia 76ers,14,0.333,0.8,47,25,6,2,0.355,0.8,38,32,8,4
4756,21701067,Charlotte Hornets,Brooklyn Nets,111,105,216,6,Charlotte Hornets,6,0.188,0.766,68,18,3,2,0.351,0.667,46,22,6,11
4757,21701068,New York Knicks,Miami Heat,98,119,217,21,Miami Heat,21,0.323,0.833,40,21,6,1,0.441,0.737,32,31,9,2
4758,21701069,Denver Nuggets,Chicago Bulls,135,102,237,33,Denver Nuggets,33,0.571,0.813,45,34,9,6,0.342,0.786,34,29,12,4
4759,21701070,Los Angeles Clippers,Milwaukee Bucks,127,120,247,7,Los Angeles Clippers,7,0.5,0.759,47,26,12,3,0.308,0.706,33,33,10,5
4760,21701071,Washington Wizards,San Antonio Spurs,90,98,188,8,San Antonio Spurs,8,0.32,0.75,35,27,11,4,0.304,0.722,42,21,7,10
4761,21701072,Memphis Grizzlies,Charlotte Hornets,79,140,219,61,Charlotte Hornets,61,0.222,0.714,38,13,4,7,0.475,0.852,53,25,10,4
4762,21701073,Philadelphia 76ers,Orlando Magic,118,98,216,20,Philadelphia 76ers,20,0.405,0.792,56,30,7,5,0.303,0.636,40,26,10,3
4763,21701074,Detroit Pistons,Houston Rockets,96,100,196,4,Houston Rockets,4,0.158,0.526,66,22,9,5,0.235,0.643,52,19,9,3
4764,21701075,Los Angeles Lakers,New Orleans Pelicans,125,128,253,3,New Orleans Pelicans,3,0.436,0.786,40,19,4,3,0.25,0.818,42,28,13,4
4765,21701076,Utah Jazz,Dallas Mavericks,119,112,231,7,Utah Jazz,7,0.414,0.938,39,32,11,6,0.531,0.786,35,22,5,7
4766,21701077,Atlanta Hawks,Sacramento Kings,90,105,195,15,Sacramento Kings,15,0.333,0.667,40,19,7,2,0.476,1,51,28,8,9
4767,21701078,Los Angeles Clippers,Indiana Pacers,104,109,213,5,Indiana Pacers,5,0.385,0.714,32,24,4,3,0.355,0.857,42,25,6,2
4768,21701079,Denver Nuggets,Washington Wizards,108,100,208,8,Denver Nuggets,8,0.5,0.944,38,25,5,10,0.5,0.714,46,28,3,2
4769,21701080,Phoenix Suns,Cleveland Cavaliers,95,120,215,25,Cleveland Cavaliers,25,0.25,0.6,36,24,9,4,0.276,0.75,54,23,9,4
4770,21701081,Minnesota Timberwolves,New York Knicks,108,104,212,4,Minnesota Timberwolves,4,0.385,0.875,45,23,6,6,0.429,0.706,42,25,9,0
4771,21701082,Brooklyn Nets,Toronto Raptors,112,116,228,4,Toronto Raptors,4,0.407,0.613,40,21,5,9,0.5,0.69,43,26,5,7
4772,21701083,Milwaukee Bucks,Chicago Bulls,118,105,223,13,Milwaukee Bucks,13,0.5,0.895,36,27,8,7,0.462,0.913,51,21,3,2
4773,21701084,Miami Heat,Oklahoma City Thunder,99,105,204,6,Oklahoma City Thunder,6,0.433,0.9,41,22,4,1,0.308,0.758,51,17,7,1
4774,21701085,Utah Jazz,San Antonio Spurs,120,124,244,4,San Antonio Spurs,4,0.393,0.793,34,24,10,3,0.412,0.852,49,21,9,7
4775,21701086,Boston Celtics,Portland Trail Blazers,105,100,205,5,Boston Celtics,5,0.611,0.923,45,22,5,4,0.242,0.8,43,16,8,5
4776,21701087,Atlanta Hawks,Golden State Warriors,94,106,200,12,Golden State Warriors,12,0.344,0.45,44,24,5,5,0.4,0.909,46,28,8,6
4777,21701088,Minnesota Timberwolves,Philadelphia 76ers,108,120,228,12,Philadelphia 76ers,12,0.261,0.737,53,19,7,3,0.351,0.639,51,33,9,10
4778,21701089,Chicago Bulls,Detroit Pistons,95,117,212,22,Detroit Pistons,22,0.314,0.667,44,27,10,1,0.381,0.833,49,33,6,7
4779,21701090,Phoenix Suns,Orlando Magic,99,105,204,6,Orlando Magic,6,0.241,0.769,41,21,14,2,0.367,0.741,54,29,9,8
4780,21701091,New Orleans Pelicans,Houston Rockets,91,114,205,23,Houston Rockets,23,0.286,0.75,46,19,10,6,0.383,0.75,48,22,10,8
4781,21701092,Los Angeles Lakers,Memphis Grizzlies,100,93,193,7,Los Angeles Lakers,7,0.342,0.68,44,19,7,2,0.172,0.818,43,20,7,6
4782,21701093,Charlotte Hornets,Dallas Mavericks,102,98,200,4,Charlotte Hornets,4,0.48,0.69,62,21,10,4,0.293,0.737,52,22,10,6
4783,21701094,Cleveland Cavaliers,Brooklyn Nets,121,114,235,7,Cleveland Cavaliers,7,0.429,0.808,49,25,5,2,0.459,0.808,38,27,7,3
4784,21701095,San Antonio Spurs,Milwaukee Bucks,103,106,209,3,Milwaukee Bucks,3,0.235,0.81,53,16,4,2,0.333,0.722,37,27,6,6
4785,21701096,Miami Heat,Indiana Pacers,107,113,220,6,Indiana Pacers,6,0.4,0.786,39,32,10,3,0.348,0.81,51,26,12,7
4786,21701097,Los Angeles Clippers,Toronto Raptors,117,106,223,11,Los Angeles Clippers,11,0.444,0.778,44,17,7,5,0.444,0.571,48,24,3,6
4787,21701098,New York Knicks,Washington Wizards,101,97,198,4,New York Knicks,4,0.273,0.867,44,26,10,6,0.316,0.739,46,25,10,7
4788,21701099,Boston Celtics,Sacramento Kings,104,93,197,11,Boston Celtics,11,0.545,0.706,35,23,9,2,0.269,1,34,18,7,1
4789,21701100,Portland Trail Blazers,Oklahoma City Thunder,108,105,213,3,Portland Trail Blazers,3,0.265,0.789,49,20,8,7,0.296,0.821,39,16,9,5
4790,21701101,Atlanta Hawks,Houston Rockets,99,118,217,19,Houston Rockets,19,0.275,0.909,45,18,5,2,0.385,0.909,45,28,7,4
4791,21701102,Utah Jazz,Golden State Warriors,110,91,201,19,Utah Jazz,19,0.429,0.778,47,27,6,8,0.4,0.9,41,24,9,7
4792,21701103,New York Knicks,Charlotte Hornets,128,137,265,9,Charlotte Hornets,9,0.3,1,41,25,6,1,0.393,0.857,43,25,5,4
4793,21701104,Los Angeles Lakers,Detroit Pistons,106,112,218,6,Detroit Pistons,6,0.261,0.8,47,29,3,7,0.394,0.733,50,21,4,2
4794,21701105,Denver Nuggets,Philadelphia 76ers,104,123,227,19,Philadelphia 76ers,19,0.344,0.618,37,27,10,7,0.448,0.72,53,35,6,6
4795,21701106,Memphis Grizzlies,Minnesota Timberwolves,101,93,194,8,Memphis Grizzlies,8,0.484,0.667,35,25,8,4,0.333,0.792,37,21,7,6
4796,21701107,Boston Celtics,Phoenix Suns,102,94,196,8,Boston Celtics,8,0.483,1,44,24,10,3,0.343,0.526,47,18,8,5
4797,21701108,San Antonio Spurs,Washington Wizards,106,116,222,10,Washington Wizards,10,0.4,0.545,37,29,7,5,0.417,0.778,50,33,5,7
4798,21701109,Denver Nuggets,Toronto Raptors,110,114,224,4,Toronto Raptors,4,0.433,0.929,40,26,6,6,0.382,0.778,37,33,6,16
4799,21701110,Cleveland Cavaliers,Miami Heat,79,98,177,19,Miami Heat,19,0.154,0.684,42,15,8,1,0.31,0.75,44,24,10,9
4800,21701111,Chicago Bulls,Houston Rockets,86,118,204,32,Houston Rockets,32,0.216,0.588,51,17,8,1,0.316,0.857,46,28,15,6
4801,21701112,Portland Trail Blazers,New Orleans Pelicans,107,103,210,4,Portland Trail Blazers,4,0.313,0.9,47,20,11,7,0.167,0.929,54,28,3,10
4802,21701113,Dallas Mavericks,Sacramento Kings,103,97,200,6,Dallas Mavericks,6,0.35,0.68,43,25,7,9,0.261,0.789,45,25,6,6
4803,21701114,Indiana Pacers,Golden State Warriors,92,81,173,11,Indiana Pacers,11,0.286,0.667,38,22,10,2,0.294,0.667,51,21,4,9
4804,21701115,Milwaukee Bucks,Los Angeles Clippers,98,105,203,7,Los Angeles Clippers,7,0.261,0.696,44,24,12,11,0.536,0.556,41,23,8,4
4805,21701116,Cleveland Cavaliers,Charlotte Hornets,118,105,223,13,Cleveland Cavaliers,13,0.393,0.85,38,22,9,1,0.238,0.917,40,20,2,2
4806,21701117,Brooklyn Nets,Orlando Magic,111,104,215,7,Brooklyn Nets,7,0.353,0.864,48,28,6,5,0.355,0.813,44,25,4,4
4807,21701118,New York Knicks,Philadelphia 76ers,101,118,219,17,Philadelphia 76ers,17,0.29,0.769,46,20,4,5,0.29,0.704,58,34,9,3
4808,21701119,Portland Trail Blazers,Memphis Grizzlies,103,108,211,5,Memphis Grizzlies,5,0.267,0.633,38,15,7,8,0.52,0.565,46,23,7,2
4809,21701120,Atlanta Hawks,Minnesota Timberwolves,114,126,240,12,Minnesota Timberwolves,12,0.481,0.826,37,26,10,2,0.433,0.81,37,33,9,1
4810,21701121,Boston Celtics,Utah Jazz,97,94,191,3,Boston Celtics,3,0.571,0.75,42,20,11,2,0.273,0.81,45,25,7,6
4811,21701122,Los Angeles Clippers,Phoenix Suns,111,99,210,12,Los Angeles Clippers,12,0.471,0.68,51,26,7,4,0.294,0.722,39,17,13,4
4812,21701123,Dallas Mavericks,Los Angeles Lakers,93,103,196,10,Los Angeles Lakers,10,0.295,0.737,40,17,10,1,0.273,0.688,49,25,6,5
4813,21701124,Washington Wizards,Detroit Pistons,92,103,195,11,Detroit Pistons,11,0.188,0.8,43,28,9,6,0.286,0.75,44,26,9,3
4814,21701125,Chicago Bulls,Miami Heat,92,103,195,11,Miami Heat,11,0.231,0.769,50,19,10,5,0.259,0.917,44,20,7,7
4815,21701126,Oklahoma City Thunder,San Antonio Spurs,99,103,202,4,San Antonio Spurs,4,0.367,0.667,43,19,11,3,0.419,0.733,48,22,13,6
4816,21701127,Indiana Pacers,Sacramento Kings,106,103,209,3,Indiana Pacers,3,0.308,0.9,34,23,9,4,0.419,0.667,32,27,3,2
4817,21701128,Milwaukee Bucks,Golden State Warriors,116,107,223,9,Milwaukee Bucks,9,0.55,0.9,36,30,16,3,0.5,1,31,26,10,7
4818,21701129,Chicago Bulls,Orlando Magic,90,82,172,8,Chicago Bulls,8,0.341,0.696,53,16,11,7,0.179,0.929,55,16,11,5
4819,21701130,Philadelphia 76ers,Atlanta Hawks,101,91,192,10,Philadelphia 76ers,10,0.211,0.692,53,34,10,6,0.231,0.667,59,24,9,4
4820,21701131,New Orleans Pelicans,Cleveland Cavaliers,102,107,209,5,Cleveland Cavaliers,5,0.423,0.833,41,25,4,2,0.417,0.733,45,22,6,2
4821,21701132,Phoenix Suns,Houston Rockets,103,104,207,1,Houston Rockets,1,0.375,0.692,46,23,8,5,0.368,0.69,39,22,9,7
4822,21701133,Denver Nuggets,Oklahoma City Thunder,126,125,251,1,Denver Nuggets,1,0.333,0.857,58,27,4,5,0.455,0.556,50,25,13,2
4823,21701134,Minnesota Timberwolves,Dallas Mavericks,93,92,185,1,Minnesota Timberwolves,1,0.32,0.882,44,14,10,6,0.393,0.714,46,22,5,5
4824,21701135,Memphis Grizzlies,Utah Jazz,97,107,204,10,Utah Jazz,10,0.391,0.667,33,24,8,4,0.387,0.577,38,24,7,5
4825,21701136,Milwaukee Bucks,Los Angeles Lakers,124,122,246,2,Milwaukee Bucks,2,0.379,0.821,39,24,14,6,0.296,0.72,56,33,5,3
4826,21701137,Los Angeles Clippers,Portland Trail Blazers,96,105,201,9,Portland Trail Blazers,9,0.308,0.571,46,13,5,5,0.267,0.938,50,30,9,10
4827,21701138,Charlotte Hornets,Washington Wizards,93,107,200,14,Washington Wizards,14,0.261,0.63,46,22,6,2,0.462,0.75,44,30,11,4
4828,21701139,Detroit Pistons,New York Knicks,115,109,224,6,Detroit Pistons,6,0.417,0.773,43,24,8,5,0.448,0.833,40,31,4,1
4829,21701140,Toronto Raptors,Boston Celtics,99,110,209,11,Boston Celtics,11,0.229,0.773,46,23,1,5,0.412,0.852,41,19,6,3
4830,21701141,Brooklyn Nets,Miami Heat,110,109,219,1,Brooklyn Nets,1,0.286,0.786,47,28,11,5,0.412,0.762,51,19,6,6
4831,21701142,Golden State Warriors,Sacramento Kings,112,96,208,16,Golden State Warriors,16,0.346,0.75,42,28,9,6,0.286,0.842,47,27,5,6
4832,21701143,Philadelphia 76ers,Charlotte Hornets,119,102,221,17,Philadelphia 76ers,17,0.438,0.9,44,36,15,5,0.3,0.794,40,17,8,7
4833,21701144,Washington Wizards,Chicago Bulls,94,113,207,19,Chicago Bulls,19,0.267,1,37,27,5,4,0.529,0.692,40,30,7,1
4834,21701145,Houston Rockets,San Antonio Spurs,83,100,183,17,San Antonio Spurs,17,0.226,0.828,42,12,3,3,0.353,0.667,48,19,8,8
4835,21701146,Indiana Pacers,Los Angeles Clippers,111,104,215,7,Indiana Pacers,7,0.393,0.762,40,23,8,4,0.36,0.786,36,24,6,6
4836,21701147,Orlando Magic,Atlanta Hawks,88,94,182,6,Atlanta Hawks,6,0.278,0.923,41,19,8,6,0.306,1,52,33,0,3
4837,21701148,Detroit Pistons,Brooklyn Nets,108,96,204,12,Detroit Pistons,12,0.368,0.781,53,17,9,3,0.279,0.667,40,23,5,5
4838,21701149,Dallas Mavericks,Cleveland Cavaliers,87,98,185,11,Cleveland Cavaliers,11,0.351,0.909,38,15,5,3,0.423,0.739,50,21,7,1
4839,21701150,Oklahoma City Thunder,New Orleans Pelicans,109,104,213,5,Oklahoma City Thunder,5,0.29,0.72,51,24,13,4,0.344,0.739,44,28,13,3
4840,21701151,Utah Jazz,Minnesota Timberwolves,121,97,218,24,Utah Jazz,24,0.393,0.72,45,29,8,7,0.333,0.929,32,19,10,1
4841,21701152,Milwaukee Bucks,Denver Nuggets,125,128,253,3,Denver Nuggets,3,0.364,0.852,45,27,9,3,0.306,0.804,57,27,2,8
4842,21701153,Phoenix Suns,Golden State Warriors,107,117,224,10,Golden State Warriors,10,0.355,0.875,42,26,8,4,0.464,0.889,45,31,10,7
4843,21701154,Memphis Grizzlies,Portland Trail Blazers,98,113,211,15,Portland Trail Blazers,15,0.429,0.75,42,20,7,5,0.316,0.92,43,28,9,2
4844,21701155,Sacramento Kings,Los Angeles Lakers,84,83,167,1,Sacramento Kings,1,0.292,0.5,47,17,9,5,0.219,0.64,47,18,5,6
4845,21701156,Toronto Raptors,Cleveland Cavaliers,106,112,218,6,Cleveland Cavaliers,6,0.324,0.786,46,28,7,1,0.433,0.885,42,18,8,6
4846,21701157,Brooklyn Nets,Philadelphia 76ers,95,121,216,26,Philadelphia 76ers,26,0.405,0.435,36,20,5,6,0.429,0.667,55,28,10,10
4847,21701158,Atlanta Hawks,Miami Heat,98,101,199,3,Miami Heat,3,0.394,0.733,49,24,10,1,0.242,0.846,46,22,10,8
4848,21701159,Orlando Magic,New York Knicks,97,73,170,24,Orlando Magic,24,0.306,0.667,53,28,7,5,0.148,0.75,42,17,5,9
4849,21701160,Charlotte Hornets,Chicago Bulls,114,120,234,6,Chicago Bulls,6,0.382,0.75,49,24,3,4,0.441,0.722,44,26,9,4
4850,21701161,Washington Wizards,Houston Rockets,104,120,224,16,Houston Rockets,16,0.48,0.696,36,25,6,1,0.348,0.667,46,26,13,3
4851,21701162,Boston Celtics,Milwaukee Bucks,102,106,208,4,Milwaukee Bucks,4,0.304,0.792,37,19,10,6,0.25,0.714,41,27,6,5
4852,21701163,Golden State Warriors,Oklahoma City Thunder,111,107,218,4,Golden State Warriors,4,0.276,0.875,40,27,9,5,0.237,0.757,58,13,8,3
4853,21701164,Portland Trail Blazers,Dallas Mavericks,109,115,224,6,Dallas Mavericks,6,0.25,0.875,46,28,6,2,0.386,0.7,43,27,8,5
4854,21701165,Indiana Pacers,Denver Nuggets,104,107,211,3,Denver Nuggets,3,0.474,0.813,35,23,11,4,0.313,0.75,49,31,10,8
4855,21701166,Los Angeles Lakers,Utah Jazz,110,117,227,7,Utah Jazz,7,0.5,0.667,39,23,7,5,0.424,0.63,47,29,10,5
4856,21701167,Sacramento Kings,Phoenix Suns,94,97,191,3,Phoenix Suns,3,0.407,0.739,40,20,5,5,0.353,0.636,52,18,6,5
4857,21701168,San Antonio Spurs,Los Angeles Clippers,110,113,223,3,Los Angeles Clippers,3,0.333,0.857,39,24,13,10,0.313,0.791,47,21,8,2
4858,21701169,Philadelphia 76ers,Detroit Pistons,115,108,223,7,Philadelphia 76ers,7,0.433,0.737,44,32,11,3,0.444,0.609,42,30,4,5
4859,21701170,Dallas Mavericks,Orlando Magic,100,105,205,5,Orlando Magic,5,0.333,0.706,43,24,3,1,0.276,0.704,47,27,4,10
4860,21701171,Boston Celtics,Toronto Raptors,78,96,174,18,Toronto Raptors,18,0.136,0.893,43,10,7,3,0.303,0.75,48,23,10,6
4861,21701172,Miami Heat,Atlanta Hawks,115,86,201,29,Miami Heat,29,0.447,0.824,54,23,9,10,0.3,0.647,48,20,5,6
4862,21701173,Memphis Grizzlies,New Orleans Pelicans,95,123,218,28,New Orleans Pelicans,28,0.313,0.733,37,19,9,1,0.444,0.895,48,32,14,7
4863,21701174,San Antonio Spurs,Los Angeles Lakers,112,122,234,10,Los Angeles Lakers,10,0.391,0.704,46,25,7,5,0.542,0.833,44,32,4,3
4864,21701175,Golden State Warriors,Indiana Pacers,106,126,232,20,Indiana Pacers,20,0.31,0.958,39,29,6,5,0.517,0.733,47,32,11,3
4865,21701176,Washington Wizards,Cleveland Cavaliers,115,119,234,4,Cleveland Cavaliers,4,0.429,0.857,41,34,8,7,0.481,0.786,35,26,10,3
4866,21701177,Portland Trail Blazers,Houston Rockets,94,96,190,2,Houston Rockets,2,0.318,0.643,47,16,10,2,0.351,0.625,38,16,10,5
4867,21701178,Brooklyn Nets,Milwaukee Bucks,119,111,230,8,Brooklyn Nets,8,0.487,0.857,41,30,3,12,0.25,0.8,41,21,12,2
4868,21701179,Los Angeles Clippers,Utah Jazz,95,117,212,22,Utah Jazz,22,0.176,0.786,39,18,7,3,0.37,0.679,38,27,7,8
4869,21701180,Minnesota Timberwolves,Denver Nuggets,96,100,196,4,Denver Nuggets,4,0.25,0.75,47,22,4,1,0.306,0.864,47,21,3,7
4870,21701181,Dallas Mavericks,Detroit Pistons,106,113,219,7,Detroit Pistons,7,0.333,0.722,46,26,7,5,0.4,0.529,49,24,6,4
4871,21701182,Charlotte Hornets,Orlando Magic,137,100,237,37,Charlotte Hornets,37,0.548,0.923,50,32,4,5,0.391,0.538,36,27,2,3
4872,21701183,Cleveland Cavaliers,Philadelphia 76ers,130,132,262,2,Philadelphia 76ers,2,0.471,0.727,41,24,6,2,0.359,0.857,44,35,11,7
4873,21701184,Atlanta Hawks,Washington Wizards,103,97,200,6,Atlanta Hawks,6,0.333,0.696,50,24,5,5,0.36,0.783,45,18,8,4
4874,21701185,Chicago Bulls,Boston Celtics,104,111,215,7,Boston Celtics,7,0.467,0.588,43,25,15,0,0.412,0.412,46,35,9,6
4875,21701186,Miami Heat,New York Knicks,98,122,220,24,New York Knicks,24,0.259,0.955,42,20,7,5,0.486,0.667,51,33,7,5
4876,21701187,Indiana Pacers,Toronto Raptors,73,92,165,19,Toronto Raptors,19,0.333,0.7,44,16,8,8,0.3,0.688,52,27,9,8
4877,21701188,Sacramento Kings,Memphis Grizzlies,94,93,187,1,Sacramento Kings,1,0.25,0.667,42,23,8,5,0.25,0.722,38,20,7,7
4878,21701189,New Orleans Pelicans,Phoenix Suns,122,103,225,19,New Orleans Pelicans,19,0.421,0.8,55,29,9,7,0.273,0.769,48,20,8,4
4879,21701190,Minnesota Timberwolves,Los Angeles Lakers,113,96,209,17,Minnesota Timberwolves,17,0.308,0.731,48,25,14,8,0.333,0.813,53,16,3,2
4880,21701191,Denver Nuggets,Los Angeles Clippers,134,115,249,19,Denver Nuggets,19,0.414,0.696,33,36,4,6,0.353,0.676,38,25,6,0
4881,21701192,Milwaukee Bucks,New York Knicks,115,102,217,13,Milwaukee Bucks,13,0.4,0.882,48,30,6,10,0.429,1,44,30,3,7
4882,21701193,Brooklyn Nets,Chicago Bulls,124,96,220,28,Brooklyn Nets,28,0.436,0.727,46,36,11,10,0.207,0.857,39,16,8,1
4883,21701194,Oklahoma City Thunder,Houston Rockets,108,102,210,6,Oklahoma City Thunder,6,0.303,0.788,42,21,11,5,0.378,0.696,41,23,7,5
4884,21701195,New Orleans Pelicans,Golden State Warriors,126,120,246,6,New Orleans Pelicans,6,0.407,0.773,34,39,15,6,0.455,0.636,42,31,3,0
4885,21701196,Portland Trail Blazers,San Antonio Spurs,105,116,221,11,San Antonio Spurs,11,0.393,0.909,40,18,4,5,0.333,0.714,36,21,12,3
4886,21701197,Indiana Pacers,Charlotte Hornets,123,117,240,6,Indiana Pacers,6,0.36,0.778,39,27,11,1,0.367,0.867,36,27,6,3
4887,21701198,Dallas Mavericks,Philadelphia 76ers,97,109,206,12,Philadelphia 76ers,12,0.275,0.462,43,24,6,6,0.296,0.643,52,32,9,4
4888,21701199,Detroit Pistons,Memphis Grizzlies,117,130,247,13,Memphis Grizzlies,13,0.489,0.783,38,30,10,0,0.485,0.75,43,36,11,4
4889,21701200,Orlando Magic,Toronto Raptors,101,112,213,11,Toronto Raptors,11,0.304,0.588,42,25,12,4,0.425,0.708,47,28,8,5
4890,21701201,Utah Jazz,Los Angeles Lakers,112,97,209,15,Utah Jazz,15,0.361,0.682,45,35,8,4,0.2,0.818,44,20,8,4
4891,21701202,Atlanta Hawks,Boston Celtics,112,106,218,6,Atlanta Hawks,6,0.429,0.786,37,23,7,4,0.391,0.65,41,33,9,6
4892,21701203,Golden State Warriors,Phoenix Suns,117,100,217,17,Golden State Warriors,17,0.406,0.667,41,27,9,7,0.286,0.75,44,24,4,0
4893,21701204,Toronto Raptors,Detroit Pistons,108,98,206,10,Toronto Raptors,10,0.308,1,48,27,3,5,0.3,0.76,33,22,7,2
4894,21701205,Chicago Bulls,Brooklyn Nets,105,114,219,9,Brooklyn Nets,9,0.429,0.583,44,26,7,6,0.429,0.933,38,32,8,10
4895,21701206,Oklahoma City Thunder,Miami Heat,115,93,208,22,Oklahoma City Thunder,22,0.4,0.816,43,21,9,4,0.227,0.571,43,21,6,4
4896,21701207,Cleveland Cavaliers,New York Knicks,123,109,232,14,Cleveland Cavaliers,14,0.422,0.857,42,29,9,2,0.367,0.5,37,26,4,7
4897,21701208,Orlando Magic,Milwaukee Bucks,86,102,188,16,Milwaukee Bucks,16,0.208,0.65,43,24,8,4,0.346,0.833,56,26,13,2
4898,21701209,Memphis Grizzlies,Minnesota Timberwolves,94,113,207,19,Minnesota Timberwolves,19,0.278,0.905,35,20,11,5,0.318,0.846,52,27,10,7
4899,21701210,Sacramento Kings,San Antonio Spurs,85,98,183,13,San Antonio Spurs,13,0.444,0.647,45,16,4,2,0.222,0.828,45,18,6,6
4900,21701211,Portland Trail Blazers,Denver Nuggets,82,88,170,6,Denver Nuggets,6,0.212,0.722,57,10,8,2,0.231,0.769,52,22,7,5
4901,21701212,New Orleans Pelicans,Los Angeles Clippers,113,100,213,13,New Orleans Pelicans,13,0.367,0.7,50,34,13,10,0.118,0.421,61,29,6,6
4902,21701213,Charlotte Hornets,Indiana Pacers,119,93,212,26,Charlotte Hornets,26,0.429,0.75,55,27,5,7,0.258,0.625,53,22,3,4
4903,21701214,Philadelphia 76ers,Atlanta Hawks,121,113,234,8,Philadelphia 76ers,8,0.459,0.6,54,29,7,8,0.351,0.692,39,27,10,3
4904,21701215,Boston Celtics,Washington Wizards,101,113,214,12,Washington Wizards,12,0.394,0.815,44,22,14,1,0.5,0.8,51,32,8,3
4905,21701216,Phoenix Suns,Dallas Mavericks,124,97,221,27,Phoenix Suns,27,0.5,0.714,46,35,5,6,0.242,0.682,40,20,8,1
4906,21701217,Golden State Warriors,Utah Jazz,79,119,198,40,Utah Jazz,40,0.263,0.875,39,14,7,3,0.371,0.769,54,25,10,6
4907,21701218,Houston Rockets,Los Angeles Lakers,105,99,204,6,Houston Rockets,6,0.34,0.938,49,19,9,5,0.278,0.867,47,22,14,4
4908,21701219,Brooklyn Nets,Boston Celtics,97,110,207,13,Boston Celtics,13,0.275,0.75,44,27,10,6,0.25,0.8,62,22,6,6
4909,21701220,New York Knicks,Cleveland Cavaliers,110,98,208,12,New York Knicks,12,0.444,0.923,39,30,10,3,0.25,0.643,48,15,9,3
4910,21701221,Toronto Raptors,Miami Heat,109,116,225,7,Miami Heat,7,0.3,0.762,47,24,5,10,0.423,0.65,56,26,8,7
4911,21701222,Washington Wizards,Orlando Magic,92,101,193,9,Orlando Magic,9,0.294,0.593,50,17,5,1,0.406,0.815,42,20,6,7
4912,21701223,Milwaukee Bucks,Philadelphia 76ers,95,130,225,35,Philadelphia 76ers,35,0.28,0.875,43,22,6,5,0.417,0.733,57,35,15,7
4913,21701224,Detroit Pistons,Chicago Bulls,119,87,206,32,Detroit Pistons,32,0.429,1,47,27,12,4,0.324,0.667,40,21,8,1
4914,21701225,Denver Nuggets,Minnesota Timberwolves,106,112,218,6,Minnesota Timberwolves,6,0.406,0.611,47,19,4,4,0.391,0.76,40,24,10,2
4915,21701226,San Antonio Spurs,New Orleans Pelicans,98,122,220,24,New Orleans Pelicans,24,0.333,0.842,38,22,9,1,0.263,0.684,51,30,11,5
4916,21701227,Memphis Grizzlies,Oklahoma City Thunder,123,137,260,14,Oklahoma City Thunder,14,0.419,0.917,41,22,9,2,0.465,0.719,45,32,8,3
4917,21701228,Los Angeles Lakers,Los Angeles Clippers,115,100,215,15,Los Angeles Lakers,15,0.436,0.875,49,25,8,6,0.333,0.429,41,27,8,1
4918,21701229,Utah Jazz,Portland Trail Blazers,93,102,195,9,Portland Trail Blazers,9,0.348,0.792,53,18,5,7,0.375,0.688,46,19,9,9
4919,21701230,Houston Rockets,Sacramento Kings,83,96,179,13,Sacramento Kings,13,0.283,0.667,40,11,2,6,0.269,0.65,48,22,6,3
4920,21800001,Philadelphia 76ers,Boston Celtics,87,105,192,18,Boston Celtics,18,0.192,0.609,47,18,8,5,0.297,0.714,55,21,7,5
4921,21800002,Oklahoma City Thunder,Golden State Warriors,100,108,208,8,Golden State Warriors,8,0.27,0.649,45,21,12,6,0.269,0.944,58,28,7,7
4922,21800003,Milwaukee Bucks,Charlotte Hornets,113,112,225,1,Milwaukee Bucks,1,0.412,0.75,57,26,5,4,0.421,0.636,41,21,8,9
4923,21800004,Brooklyn Nets,Detroit Pistons,100,103,203,3,Detroit Pistons,3,0.185,0.682,39,28,9,5,0.25,0.864,46,21,5,5
4924,21800005,Memphis Grizzlies,Indiana Pacers,83,111,194,28,Indiana Pacers,28,0.345,0.821,28,16,11,3,0.385,0.538,57,29,2,7
4925,21800006,Miami Heat,Orlando Magic,101,104,205,3,Orlando Magic,3,0.273,0.727,52,16,4,5,0.28,0.613,51,20,7,7
4926,21800007,Atlanta Hawks,New York Knicks,107,126,233,19,New York Knicks,19,0.278,0.833,45,19,7,3,0.364,0.774,46,21,12,6
4927,21800008,Cleveland Cavaliers,Toronto Raptors,104,116,220,12,Toronto Raptors,12,0.368,0.744,49,17,4,0,0.424,0.6,43,21,6,7
4928,21800009,New Orleans Pelicans,Houston Rockets,131,112,243,19,New Orleans Pelicans,19,0.4,0.773,54,36,8,3,0.333,0.75,37,21,8,7
4929,21800010,Minnesota Timberwolves,San Antonio Spurs,108,112,220,4,San Antonio Spurs,4,0.316,0.889,46,20,9,2,0.44,0.724,52,22,3,4
4930,21800011,Utah Jazz,Sacramento Kings,123,117,240,6,Utah Jazz,6,0.481,0.737,44,21,8,4,0.368,0.667,37,17,8,3
4931,21800012,Denver Nuggets,Los Angeles Clippers,107,98,205,9,Denver Nuggets,9,0.333,0.786,56,20,6,9,0.286,0.833,47,21,3,9
4932,21800013,Dallas Mavericks,Phoenix Suns,100,121,221,21,Phoenix Suns,21,0.303,0.7,38,28,7,5,0.559,0.875,44,35,5,2
4933,21800014,Chicago Bulls,Philadelphia 76ers,108,127,235,19,Philadelphia 76ers,19,0.333,0.75,39,28,4,6,0.333,0.9,55,30,10,8
4934,21800015,Miami Heat,Washington Wizards,113,112,225,1,Miami Heat,1,0.343,0.735,55,25,6,5,0.269,0.744,40,19,7,15
4935,21800016,Los Angeles Lakers,Portland Trail Blazers,119,128,247,9,Portland Trail Blazers,9,0.233,0.759,46,23,10,6,0.351,0.931,54,21,9,10
4936,21800017,Charlotte Hornets,Orlando Magic,120,88,208,32,Charlotte Hornets,32,0.447,0.85,55,32,6,4,0.194,0.714,44,18,8,7
4937,21800018,New York Knicks,Brooklyn Nets,105,107,212,2,Brooklyn Nets,2,0.321,0.9,36,14,10,1,0.4,0.875,55,22,2,6
4938,21800019,Boston Celtics,Toronto Raptors,101,113,214,12,Toronto Raptors,12,0.389,0.7,49,29,4,6,0.371,0.737,49,24,3,3
4939,21800020,Atlanta Hawks,Memphis Grizzlies,117,131,248,14,Memphis Grizzlies,14,0.467,0.583,40,27,9,5,0.5,0.698,41,32,9,4
4940,21800021,Cleveland Cavaliers,Minnesota Timberwolves,123,131,254,8,Minnesota Timberwolves,8,0.348,0.862,43,26,5,2,0.4,0.943,40,28,9,7
4941,21800022,Sacramento Kings,New Orleans Pelicans,129,149,278,20,New Orleans Pelicans,20,0.4,0.731,39,24,6,2,0.516,0.636,52,35,6,4
4942,21800023,Indiana Pacers,Milwaukee Bucks,101,118,219,17,Milwaukee Bucks,17,0.333,0.704,41,14,7,3,0.37,0.619,50,27,9,8
4943,21800024,Golden State Warriors,Utah Jazz,124,123,247,1,Golden State Warriors,1,0.526,0.889,43,27,10,6,0.413,0.828,38,24,11,4
4944,21800025,Oklahoma City Thunder,Los Angeles Clippers,92,108,200,16,Los Angeles Clippers,16,0.212,0.739,52,18,5,4,0.423,0.75,48,21,3,3
4945,21800026,Brooklyn Nets,Indiana Pacers,112,132,244,20,Indiana Pacers,20,0.432,0.636,40,25,6,6,0.667,0.636,40,21,12,5
4946,21800027,Toronto Raptors,Washington Wizards,117,113,230,4,Toronto Raptors,4,0.345,0.806,52,21,5,5,0.333,0.813,37,20,11,9
4947,21800028,Boston Celtics,New York Knicks,103,101,204,2,Boston Celtics,2,0.36,0.848,47,21,8,2,0.343,0.63,46,23,8,1
4948,21800029,Orlando Magic,Philadelphia 76ers,115,116,231,1,Philadelphia 76ers,1,0.552,0.773,49,31,7,7,0.515,0.9,46,33,8,3
4949,21800030,Charlotte Hornets,Miami Heat,113,112,225,1,Charlotte Hornets,1,0.381,0.652,40,23,6,12,0.324,0.704,49,21,4,11
4950,21800031,Detroit Pistons,Chicago Bulls,118,116,234,2,Detroit Pistons,2,0.45,0.783,49,21,4,4,0.333,0.808,41,26,4,3
4951,21800032,Minnesota Timberwolves,Dallas Mavericks,136,140,276,4,Dallas Mavericks,4,0.519,0.85,33,23,10,3,0.34,0.735,42,29,8,8
4952,21800033,Phoenix Suns,Denver Nuggets,91,119,210,28,Denver Nuggets,28,0.282,0.629,40,20,6,4,0.321,0.828,54,28,12,6
4953,21800034,San Antonio Spurs,Portland Trail Blazers,108,121,229,13,Portland Trail Blazers,13,0.433,0.786,40,29,5,4,0.469,0.842,46,24,5,3
4954,21800035,Houston Rockets,Los Angeles Lakers,124,115,239,9,Houston Rockets,9,0.381,0.667,54,22,7,4,0.25,0.611,44,28,8,10
4955,21800036,Atlanta Hawks,Cleveland Cavaliers,133,111,244,22,Atlanta Hawks,22,0.468,0.789,44,32,9,7,0.37,0.643,49,23,5,2
4956,21800037,Sacramento Kings,Oklahoma City Thunder,131,120,251,11,Sacramento Kings,11,0.455,0.75,46,28,11,7,0.231,0.633,51,23,11,9
4957,21800038,Golden State Warriors,Denver Nuggets,98,100,198,2,Denver Nuggets,2,0.241,0.792,40,22,4,6,0.188,0.571,47,21,11,4
4958,21800039,Houston Rockets,Los Angeles Clippers,112,115,227,3,Los Angeles Clippers,3,0.429,0.733,35,28,6,6,0.2,1,49,22,8,7
4959,21800040,Orlando Magic,Boston Celtics,93,90,183,3,Orlando Magic,3,0.286,0.7,49,28,6,2,0.225,0.778,51,21,6,3
4960,21800041,Charlotte Hornets,Toronto Raptors,106,127,233,21,Toronto Raptors,21,0.321,0.833,41,21,5,5,0.385,0.857,46,36,10,8
4961,21800042,New York Knicks,Milwaukee Bucks,113,124,237,11,Milwaukee Bucks,11,0.345,0.867,43,22,6,2,0.425,0.708,55,27,5,9
4962,21800043,Indiana Pacers,Minnesota Timberwolves,91,101,192,10,Minnesota Timberwolves,10,0.308,0.688,45,18,6,6,0.212,0.917,47,24,9,12
4963,21800044,Chicago Bulls,Dallas Mavericks,109,115,224,6,Dallas Mavericks,6,0.565,0.667,34,18,6,4,0.319,0.952,41,25,8,2
4964,21800045,Memphis Grizzlies,Utah Jazz,92,84,176,8,Memphis Grizzlies,8,0.321,0.808,43,18,10,2,0.25,0.783,50,18,6,6
4965,21800046,Washington Wizards,Portland Trail Blazers,125,124,249,1,Washington Wizards,1,0.405,0.692,54,23,6,7,0.282,0.871,70,22,6,4
4966,21800047,Phoenix Suns,Golden State Warriors,103,123,226,20,Golden State Warriors,20,0.265,0.889,45,24,8,1,0.378,0.731,40,35,12,4
4967,21800048,San Antonio Spurs,Los Angeles Lakers,143,142,285,1,San Antonio Spurs,1,0.536,0.737,47,32,9,3,0.359,0.692,52,33,5,6
4968,21800049,Philadelphia 76ers,Detroit Pistons,132,133,265,1,Detroit Pistons,1,0.326,0.714,48,32,3,8,0.364,0.704,46,22,4,4
4969,21800050,Los Angeles Clippers,New Orleans Pelicans,109,116,225,7,New Orleans Pelicans,7,0.25,0.815,47,18,5,4,0.25,0.75,48,22,12,8
4970,21800051,Sacramento Kings,Denver Nuggets,112,126,238,14,Denver Nuggets,14,0.419,0.45,39,29,7,6,0.367,0.867,49,31,11,3
4971,21800052,Dallas Mavericks,Atlanta Hawks,104,111,215,7,Atlanta Hawks,7,0.3,0.615,52,25,7,9,0.395,0.71,54,28,6,6
4972,21800053,Brooklyn Nets,Cleveland Cavaliers,102,86,188,16,Brooklyn Nets,16,0.412,0.8,44,23,8,1,0.167,0.938,53,18,5,2
4973,21800054,New York Knicks,Miami Heat,87,110,197,23,Miami Heat,23,0.364,0.643,45,20,5,3,0.448,0.679,51,24,7,5
4974,21800055,Minnesota Timberwolves,Toronto Raptors,105,112,217,7,Toronto Raptors,7,0.5,0.625,44,25,10,5,0.344,0.75,44,26,9,8
4975,21800056,Charlotte Hornets,Chicago Bulls,110,112,222,2,Chicago Bulls,2,0.286,0.897,36,23,5,5,0.345,0.8,45,21,4,5
4976,21800057,Utah Jazz,Houston Rockets,100,89,189,11,Utah Jazz,11,0.345,0.786,47,21,7,5,0.275,0.571,35,16,12,5
4977,21800058,Indiana Pacers,San Antonio Spurs,116,96,212,20,Indiana Pacers,20,0.531,0.875,40,34,9,5,0.316,0.952,46,16,3,3
4978,21800059,Philadelphia 76ers,Milwaukee Bucks,108,123,231,15,Milwaukee Bucks,15,0.324,0.7,50,29,4,5,0.302,0.933,51,24,7,10
4979,21800060,Los Angeles Lakers,Phoenix Suns,131,113,244,18,Los Angeles Lakers,18,0.357,0.739,43,34,13,5,0.323,0.714,44,27,4,4
4980,21800061,Memphis Grizzlies,Sacramento Kings,92,97,189,5,Sacramento Kings,5,0.27,0.769,49,18,7,6,0.333,0.636,57,19,7,5
4981,21800062,Washington Wizards,Golden State Warriors,122,144,266,22,Golden State Warriors,22,0.286,0.929,34,22,7,1,0.455,0.92,48,37,6,5
4982,21800063,Cleveland Cavaliers,Detroit Pistons,103,110,213,7,Detroit Pistons,7,0.333,0.867,30,18,11,1,0.393,0.586,48,21,4,5
4983,21800064,Portland Trail Blazers,Orlando Magic,128,114,242,14,Portland Trail Blazers,14,0.407,0.808,44,24,6,6,0.4,0.8,40,29,5,7
4984,21800065,Boston Celtics,Oklahoma City Thunder,101,95,196,6,Boston Celtics,6,0.344,0.727,45,19,7,1,0.25,0.56,57,19,5,6
4985,21800066,Denver Nuggets,Los Angeles Lakers,114,121,235,7,Los Angeles Lakers,7,0.261,0.8,44,22,8,5,0.345,0.826,42,27,13,3
4986,21800067,Chicago Bulls,Charlotte Hornets,106,135,241,29,Charlotte Hornets,29,0.444,0.727,34,21,5,7,0.438,0.938,50,30,10,10
4987,21800068,Golden State Warriors,New York Knicks,128,100,228,28,Golden State Warriors,28,0.485,0.833,39,26,10,6,0.333,0.75,40,17,6,1
4988,21800069,Dallas Mavericks,Toronto Raptors,107,116,223,9,Toronto Raptors,9,0.4,0.792,44,22,6,6,0.407,0.85,50,23,10,5
4989,21800070,Los Angeles Clippers,Houston Rockets,133,113,246,20,Los Angeles Clippers,20,0.522,0.921,44,17,8,4,0.366,0.88,42,21,11,7
4990,21800071,Milwaukee Bucks,Minnesota Timberwolves,125,95,220,30,Milwaukee Bucks,30,0.413,0.727,62,32,4,8,0.233,0.722,49,19,10,6
4991,21800072,Brooklyn Nets,New Orleans Pelicans,115,117,232,2,New Orleans Pelicans,2,0.475,0.667,54,26,6,8,0.391,0.769,46,23,11,11
4992,21800073,Washington Wizards,Sacramento Kings,112,116,228,4,Sacramento Kings,4,0.333,0.783,42,22,8,7,0.378,0.609,53,25,8,4
4993,21800074,Boston Celtics,Detroit Pistons,109,89,198,20,Boston Celtics,20,0.412,0.68,54,25,4,8,0.189,0.8,47,16,4,3
4994,21800075,Utah Jazz,New Orleans Pelicans,132,111,243,21,Utah Jazz,21,0.313,0.811,43,32,7,7,0.265,0.759,40,22,4,5
4995,21800076,Chicago Bulls,Atlanta Hawks,97,85,182,12,Chicago Bulls,12,0.364,0.813,52,25,14,6,0.3,0.826,48,20,9,8
4996,21800077,Indiana Pacers,Cleveland Cavaliers,119,107,226,12,Indiana Pacers,12,0.385,0.692,24,28,13,3,0.28,0.909,39,21,9,2
4997,21800078,Charlotte Hornets,Philadelphia 76ers,103,105,208,2,Philadelphia 76ers,2,0.257,0.833,48,19,3,8,0.357,0.833,56,18,4,8
4998,21800079,Portland Trail Blazers,Miami Heat,111,120,231,9,Miami Heat,9,0.364,0.893,42,14,7,8,0.385,0.654,56,21,7,8
4999,21800080,Phoenix Suns,Memphis Grizzlies,96,117,213,21,Memphis Grizzlies,21,0.273,0.789,35,28,5,1,0.346,0.909,39,30,12,1
5000,21800081,Orlando Magic,Milwaukee Bucks,91,113,204,22,Milwaukee Bucks,22,0.233,0.882,41,21,9,6,0.333,0.913,57,24,6,7
5001,21800082,Los Angeles Lakers,San Antonio Spurs,106,110,216,4,San Antonio Spurs,4,0.394,0.611,42,19,5,5,0.188,0.792,49,20,7,5
5002,21800083,Golden State Warriors,Brooklyn Nets,120,114,234,6,Golden State Warriors,6,0.333,0.875,47,28,11,7,0.476,0.667,37,28,5,3
5003,21800084,Utah Jazz,Dallas Mavericks,113,104,217,9,Utah Jazz,9,0.4,0.864,43,25,8,6,0.321,0.76,43,24,6,3
5004,21800085,Phoenix Suns,Oklahoma City Thunder,110,117,227,7,Oklahoma City Thunder,7,0.296,0.963,44,21,10,3,0.292,0.686,43,22,16,3
5005,21800086,Washington Wizards,Los Angeles Clippers,104,136,240,32,Los Angeles Clippers,32,0.185,0.821,45,18,7,3,0.552,0.615,57,35,7,9
5006,21800087,Portland Trail Blazers,Indiana Pacers,103,93,196,10,Portland Trail Blazers,10,0.385,0.944,50,19,3,3,0.316,0.65,35,19,8,5
5007,21800088,Atlanta Hawks,Philadelphia 76ers,92,113,205,21,Philadelphia 76ers,21,0.216,0.667,47,20,10,3,0.298,0.944,64,33,7,9
5008,21800089,Sacramento Kings,Miami Heat,123,113,236,10,Sacramento Kings,10,0.462,0.6,46,28,8,8,0.333,0.706,52,20,10,9
5009,21800090,Brooklyn Nets,New York Knicks,96,115,211,19,New York Knicks,19,0.289,0.773,32,22,6,7,0.375,0.889,53,21,5,3
5010,21800091,Golden State Warriors,Chicago Bulls,149,124,273,25,Golden State Warriors,25,0.533,0.731,49,34,9,7,0.314,0.618,44,25,6,3
5011,21800092,Toronto Raptors,Milwaukee Bucks,109,124,233,15,Milwaukee Bucks,15,0.2,0.786,51,25,9,7,0.422,0.789,57,28,5,4
5012,21800093,Los Angeles Lakers,Minnesota Timberwolves,120,124,244,4,Minnesota Timberwolves,4,0.364,0.667,48,24,8,8,0.483,0.867,51,26,11,12
5013,21800094,Dallas Mavericks,San Antonio Spurs,108,113,221,5,San Antonio Spurs,5,0.294,0.706,49,15,9,3,0.45,0.952,41,27,17,2
5014,21800095,New Orleans Pelicans,Denver Nuggets,111,116,227,5,Denver Nuggets,5,0.458,0.7,44,28,8,5,0.314,0.913,41,28,14,5
5015,21800096,Miami Heat,Charlotte Hornets,113,125,238,12,Charlotte Hornets,12,0.393,0.833,34,25,9,5,0.464,0.828,39,27,7,5
5016,21800097,Atlanta Hawks,Cleveland Cavaliers,114,136,250,22,Cleveland Cavaliers,22,0.429,0.647,39,25,6,8,0.52,0.767,48,23,13,1
5017,21800098,Sacramento Kings,Orlando Magic,107,99,206,8,Sacramento Kings,8,0.364,0.654,51,22,8,6,0.256,0.727,48,28,10,8
5018,21800099,Detroit Pistons,Boston Celtics,105,108,213,3,Boston Celtics,3,0.267,0.852,50,17,6,3,0.29,0.781,46,25,8,4
5019,21800100,Philadelphia 76ers,Toronto Raptors,112,129,241,17,Toronto Raptors,17,0.35,0.733,47,25,7,5,0.407,0.857,43,29,13,6
5020,21800101,Portland Trail Blazers,Houston Rockets,104,85,189,19,Portland Trail Blazers,19,0.4,0.87,51,17,4,4,0.233,0.565,49,18,7,9
5021,21800102,Washington Wizards,Memphis Grizzlies,95,107,202,12,Memphis Grizzlies,12,0.4,0.85,37,24,9,7,0.464,0.71,38,28,16,3
5022,21800103,Los Angeles Clippers,Oklahoma City Thunder,110,128,238,18,Oklahoma City Thunder,18,0.35,0.767,38,18,6,7,0.529,0.719,41,19,16,6
5023,21800104,Detroit Pistons,Brooklyn Nets,119,120,239,1,Brooklyn Nets,1,0.324,0.769,55,16,8,6,0.316,0.733,55,26,5,3
5024,21800105,Indiana Pacers,New York Knicks,107,101,208,6,Indiana Pacers,6,0.3,0.647,41,24,10,10,0.48,0.875,35,18,6,6
5025,21800106,Denver Nuggets,Chicago Bulls,108,107,215,1,Denver Nuggets,1,0.269,0.611,56,24,7,9,0.471,0.722,43,27,7,6
5026,21800107,Utah Jazz,Minnesota Timberwolves,125,128,253,3,Minnesota Timberwolves,3,0.433,0.6,48,25,9,5,0.48,0.667,41,19,10,8
5027,21800108,New Orleans Pelicans,Golden State Warriors,121,131,252,10,Golden State Warriors,10,0.343,0.778,42,24,8,2,0.5,0.7,46,39,10,4
5028,21800109,Dallas Mavericks,Los Angeles Lakers,113,114,227,1,Los Angeles Lakers,1,0.448,0.737,40,24,5,5,0.588,0.75,39,23,12,6
5029,21800110,San Antonio Spurs,Phoenix Suns,120,90,210,30,San Antonio Spurs,30,0.222,0.923,47,24,7,6,0.25,0.778,35,21,10,3
5030,21800111,Oklahoma City Thunder,Charlotte Hornets,111,107,218,4,Oklahoma City Thunder,4,0.216,0.724,49,20,12,9,0.268,0.909,51,26,7,3
5031,21800112,Denver Nuggets,Cleveland Cavaliers,110,91,201,19,Denver Nuggets,19,0.385,0.857,44,22,8,7,0.278,0.947,35,18,11,4
5032,21800113,Los Angeles Clippers,Philadelphia 76ers,113,122,235,9,Philadelphia 76ers,9,0.391,0.848,42,19,6,7,0.481,0.75,43,29,7,7
5033,21800114,Sacramento Kings,Atlanta Hawks,146,115,261,31,Sacramento Kings,31,0.4,0.813,46,38,14,3,0.258,0.676,43,26,6,6
5034,21800115,Milwaukee Bucks,Boston Celtics,113,117,230,4,Boston Celtics,4,0.31,0.733,45,20,8,3,0.436,0.846,42,30,5,8
5035,21800116,New Orleans Pelicans,Portland Trail Blazers,119,132,251,13,Portland Trail Blazers,13,0.276,0.838,44,23,7,3,0.514,0.839,46,26,4,4
5036,21800117,Los Angeles Clippers,Orlando Magic,120,95,215,25,Los Angeles Clippers,25,0.5,0.758,50,22,5,3,0.235,0.579,40,20,7,4
5037,21800118,Houston Rockets,Brooklyn Nets,119,111,230,8,Houston Rockets,8,0.385,0.688,41,22,4,10,0.441,0.6,38,22,5,4
5038,21800119,Oklahoma City Thunder,Washington Wizards,134,111,245,23,Oklahoma City Thunder,23,0.469,0.808,38,34,13,5,0.3,0.778,30,27,6,4
5039,21800120,Indiana Pacers,Chicago Bulls,107,105,212,2,Indiana Pacers,2,0.269,0.909,42,21,8,9,0.419,0.889,43,33,2,7
5040,21800121,New York Knicks,Dallas Mavericks,118,106,224,12,New York Knicks,12,0.241,0.731,40,26,13,4,0.379,0.625,40,22,6,1
5041,21800122,Memphis Grizzlies,Utah Jazz,110,100,210,10,Memphis Grizzlies,10,0.5,0.618,39,23,9,3,0.389,0.56,39,21,3,5
5042,21800123,Toronto Raptors,Phoenix Suns,107,98,205,9,Toronto Raptors,9,0.364,0.619,39,29,11,10,0.308,0.556,49,20,3,4
5043,21800124,Minnesota Timberwolves,Golden State Warriors,99,116,215,17,Golden State Warriors,17,0.289,0.714,39,25,8,4,0.382,0.773,61,31,3,9
5044,21800125,Detroit Pistons,Philadelphia 76ers,99,109,208,10,Philadelphia 76ers,10,0.167,0.683,44,16,8,3,0.31,0.863,45,21,11,3
5045,21800126,Cleveland Cavaliers,Charlotte Hornets,94,126,220,32,Charlotte Hornets,32,0.385,0.933,26,22,10,2,0.333,0.923,50,29,3,7
5046,21800127,Boston Celtics,Indiana Pacers,101,102,203,1,Indiana Pacers,1,0.413,0.667,45,23,6,8,0.344,0.76,45,23,10,2
5047,21800128,Miami Heat,Atlanta Hawks,118,123,241,5,Atlanta Hawks,5,0.4,0.769,41,27,6,6,0.406,0.783,37,33,11,7
5048,21800129,Houston Rockets,Chicago Bulls,96,88,184,8,Houston Rockets,8,0.31,0.65,45,21,13,5,0.261,0.963,37,15,13,4
5049,21800130,New Orleans Pelicans,San Antonio Spurs,95,109,204,14,San Antonio Spurs,14,0.286,0.567,48,22,3,8,0.348,0.786,43,29,8,4
5050,21800131,Utah Jazz,Denver Nuggets,88,103,191,15,Denver Nuggets,15,0.194,0.667,40,22,12,7,0.321,0.632,48,32,8,0
5051,21800132,Los Angeles Lakers,Portland Trail Blazers,114,110,224,4,Los Angeles Lakers,4,0.381,0.64,50,20,9,11,0.171,0.727,50,20,10,5
5052,21800133,Sacramento Kings,Milwaukee Bucks,109,144,253,35,Milwaukee Bucks,35,0.389,0.5,44,24,6,4,0.393,0.909,56,30,6,7
5053,21800134,Philadelphia 76ers,Brooklyn Nets,97,122,219,25,Brooklyn Nets,25,0.2,0.756,46,16,6,1,0.321,0.722,38,27,11,3
5054,21800135,New York Knicks,Washington Wizards,95,108,203,13,Washington Wizards,13,0.185,0.75,51,19,5,5,0.231,0.769,47,21,12,11
5055,21800136,Memphis Grizzlies,Phoenix Suns,100,102,202,2,Phoenix Suns,2,0.304,0.724,30,19,13,3,0.438,0.846,37,25,7,3
5056,21800137,Orlando Magic,San Antonio Spurs,117,110,227,7,Orlando Magic,7,0.375,0.722,43,29,7,4,0.343,0.88,43,25,3,5
5057,21800138,Minnesota Timberwolves,Portland Trail Blazers,81,111,192,30,Portland Trail Blazers,30,0.233,0.762,38,18,9,4,0.25,0.875,66,15,7,1
5058,21800139,Toronto Raptors,Los Angeles Lakers,121,107,228,14,Toronto Raptors,14,0.286,0.929,49,32,9,4,0.25,0.793,38,25,6,4
5059,21800140,Miami Heat,Detroit Pistons,120,115,235,5,Miami Heat,5,0.387,0.645,50,24,10,8,0.314,0.643,60,27,8,3
5060,21800141,Houston Rockets,Indiana Pacers,98,94,192,4,Houston Rockets,4,0.319,0.938,39,23,9,6,0.286,0.667,39,17,8,3
5061,21800142,Cleveland Cavaliers,Orlando Magic,100,102,202,2,Orlando Magic,2,0.435,0.667,42,20,8,2,0.324,0.867,40,22,11,5
5062,21800143,Chicago Bulls,New York Knicks,116,115,231,1,Chicago Bulls,1,0.267,0.733,48,15,9,9,0.269,0.897,62,20,7,6
5063,21800144,New Orleans Pelicans,Oklahoma City Thunder,116,122,238,6,Oklahoma City Thunder,6,0.31,0.833,45,27,8,5,0.37,0.71,41,26,15,3
5064,21800145,Boston Celtics,Denver Nuggets,107,115,222,8,Denver Nuggets,8,0.29,0.833,40,22,9,9,0.382,0.714,47,25,5,4
5065,21800146,Toronto Raptors,Utah Jazz,124,111,235,13,Toronto Raptors,13,0.394,0.929,43,21,9,3,0.258,0.659,40,29,10,4
5066,21800147,Memphis Grizzlies,Golden State Warriors,101,117,218,16,Golden State Warriors,16,0.333,0.762,30,31,8,8,0.542,0.957,46,29,4,4
5067,21800148,Minnesota Timberwolves,Los Angeles Clippers,109,120,229,11,Los Angeles Clippers,11,0.238,0.8,38,20,9,8,0.452,0.909,43,30,5,4
5068,21800149,Atlanta Hawks,Charlotte Hornets,102,113,215,11,Charlotte Hornets,11,0.2,0.778,37,22,13,9,0.419,0.556,43,27,9,4
5069,21800150,Washington Wizards,Dallas Mavericks,100,119,219,19,Dallas Mavericks,19,0.314,0.75,32,27,8,6,0.441,0.963,50,25,4,6
5070,21800151,Brooklyn Nets,Phoenix Suns,104,82,186,22,Brooklyn Nets,22,0.25,0.684,52,22,9,5,0.36,0.85,49,16,4,3
5071,21800152,Milwaukee Bucks,Portland Trail Blazers,103,118,221,15,Portland Trail Blazers,15,0.381,0.875,42,26,2,1,0.395,0.625,51,23,7,3
5072,21800153,Oklahoma City Thunder,Cleveland Cavaliers,95,86,181,9,Oklahoma City Thunder,9,0.259,0.692,44,10,13,9,0.29,0.846,51,17,3,4
5073,21800154,Detroit Pistons,Orlando Magic,103,96,199,7,Detroit Pistons,7,0.297,0.9,50,21,13,1,0.333,0.778,40,28,10,8
5074,21800155,New York Knicks,Atlanta Hawks,112,107,219,5,New York Knicks,5,0.367,0.702,48,15,8,7,0.289,0.759,45,26,5,9
5075,21800156,San Antonio Spurs,Miami Heat,88,95,183,7,Miami Heat,7,0.406,0.929,49,19,8,5,0.313,0.722,60,21,8,11
5076,21800157,Philadelphia 76ers,Indiana Pacers,100,94,194,6,Philadelphia 76ers,6,0.313,0.818,43,24,7,8,0.258,0.706,41,19,9,6
5077,21800158,Denver Nuggets,Memphis Grizzlies,87,89,176,2,Memphis Grizzlies,2,0.25,0.789,41,19,9,3,0.381,0.84,36,19,7,7
5078,21800159,Chicago Bulls,New Orleans Pelicans,98,107,205,9,New Orleans Pelicans,9,0.29,0.765,46,18,9,7,0.367,0.706,55,32,5,10
5079,21800160,Dallas Mavericks,Utah Jazz,102,117,219,15,Utah Jazz,15,0.333,0.9,49,14,3,4,0.351,0.692,35,31,12,10
5080,21800161,Toronto Raptors,Sacramento Kings,114,105,219,9,Toronto Raptors,9,0.306,0.913,53,17,10,4,0.348,0.722,31,27,10,5
5081,21800162,Minnesota Timberwolves,Los Angeles Lakers,110,114,224,4,Los Angeles Lakers,4,0.5,0.889,40,22,10,5,0.441,0.786,47,32,6,4
5082,21800163,Houston Rockets,Oklahoma City Thunder,80,98,178,18,Oklahoma City Thunder,18,0.262,0.7,39,16,9,3,0.243,0.708,52,18,10,4
5083,21800164,Boston Celtics,Phoenix Suns,116,109,225,7,Boston Celtics,7,0.378,0.774,56,21,6,6,0.314,0.842,42,25,10,6
5084,21800165,Los Angeles Clippers,Portland Trail Blazers,105,116,221,11,Portland Trail Blazers,11,0.348,0.75,41,19,2,10,0.385,0.929,53,18,4,8
5085,21800166,Milwaukee Bucks,Golden State Warriors,134,111,245,23,Milwaukee Bucks,23,0.257,0.778,46,33,11,7,0.357,0.773,38,31,5,6
5086,21800167,Washington Wizards,Orlando Magic,108,117,225,9,Orlando Magic,9,0.407,0.684,35,24,8,3,0.419,0.842,41,26,8,6
5087,21800168,Charlotte Hornets,Philadelphia 76ers,132,133,265,1,Philadelphia 76ers,1,0.4,0.75,49,25,10,5,0.324,0.756,59,33,3,15
5088,21800169,Detroit Pistons,Atlanta Hawks,124,109,233,15,Detroit Pistons,15,0.426,0.632,44,30,10,6,0.25,0.75,53,17,6,2
5089,21800170,Indiana Pacers,Miami Heat,110,102,212,8,Indiana Pacers,8,0.35,0.586,39,20,10,5,0.519,0.593,38,27,6,6
5090,21800171,Brooklyn Nets,Denver Nuggets,112,110,222,2,Brooklyn Nets,2,0.364,0.667,42,21,7,9,0.278,0.735,54,20,3,5
5091,21800172,Boston Celtics,Utah Jazz,115,123,238,8,Utah Jazz,8,0.395,0.909,28,31,11,3,0.382,0.8,45,29,4,4
5092,21800173,Minnesota Timberwolves,Sacramento Kings,110,121,231,11,Sacramento Kings,11,0.28,0.806,52,20,6,1,0.375,0.793,49,25,7,6
5093,21800174,New York Knicks,Toronto Raptors,112,128,240,16,Toronto Raptors,16,0.273,0.818,47,18,12,6,0.4,0.75,46,24,8,4
5094,21800175,Milwaukee Bucks,Los Angeles Clippers,126,128,254,2,Los Angeles Clippers,2,0.348,0.696,52,31,11,8,0.412,0.815,54,26,6,6
5095,21800176,Phoenix Suns,New Orleans Pelicans,99,119,218,20,New Orleans Pelicans,20,0.278,0.95,37,16,10,7,0.44,0.828,54,28,7,7
5096,21800177,Washington Wizards,Miami Heat,116,110,226,6,Washington Wizards,6,0.364,0.737,48,14,8,5,0.364,0.769,38,25,5,5
5097,21800178,Cleveland Cavaliers,Chicago Bulls,98,99,197,1,Chicago Bulls,1,0.381,0.667,53,15,5,6,0.389,0.667,38,20,7,5
5098,21800179,Philadelphia 76ers,Memphis Grizzlies,106,112,218,6,Memphis Grizzlies,6,0.258,0.625,48,27,10,6,0.367,0.733,45,16,9,3
5099,21800180,Houston Rockets,San Antonio Spurs,89,96,185,7,San Antonio Spurs,7,0.22,0.69,49,11,10,5,0.5,0.741,46,17,3,5
5100,21800181,Oklahoma City Thunder,Dallas Mavericks,96,111,207,15,Dallas Mavericks,15,0.265,0.611,53,17,9,2,0.483,0.647,38,31,9,5
5101,21800182,Brooklyn Nets,Golden State Warriors,100,116,216,16,Golden State Warriors,16,0.292,0.724,41,20,7,2,0.438,0.81,36,27,9,7
5102,21800183,Los Angeles Lakers,Sacramento Kings,101,86,187,15,Los Angeles Lakers,15,0.316,0.412,59,23,11,3,0.24,0.8,50,11,7,5
5103,21800184,Charlotte Hornets,Detroit Pistons,113,103,216,10,Charlotte Hornets,10,0.393,0.889,46,24,6,8,0.273,0.789,51,21,5,4
5104,21800185,Indiana Pacers,Houston Rockets,103,115,218,12,Houston Rockets,12,0.379,0.769,35,24,10,6,0.426,0.719,38,18,6,5
5105,21800186,Orlando Magic,New York Knicks,115,89,204,26,Orlando Magic,26,0.405,0.909,52,31,10,9,0.179,0.733,54,13,4,15
5106,21800187,Milwaukee Bucks,Denver Nuggets,121,114,235,7,Milwaukee Bucks,7,0.5,0.615,41,27,10,7,0.474,0.7,39,27,8,5
5107,21800188,Boston Celtics,Portland Trail Blazers,94,100,194,6,Portland Trail Blazers,6,0.333,0.8,42,19,11,5,0.389,0.8,55,22,4,2
5108,21800189,Atlanta Hawks,Los Angeles Lakers,106,107,213,1,Los Angeles Lakers,1,0.351,0.846,44,25,11,4,0.368,0.625,48,28,12,9
5109,21800190,Orlando Magic,Washington Wizards,109,117,226,8,Washington Wizards,8,0.5,0.727,34,28,5,6,0.394,0.727,41,24,8,7
5110,21800191,Philadelphia 76ers,Miami Heat,124,114,238,10,Philadelphia 76ers,10,0.417,0.795,42,24,5,0,0.419,0.818,40,19,5,6
5111,21800192,New Orleans Pelicans,Toronto Raptors,126,110,236,16,New Orleans Pelicans,16,0.37,0.615,54,30,2,4,0.289,0.864,43,22,9,5
5112,21800193,Dallas Mavericks,Chicago Bulls,103,98,201,5,Dallas Mavericks,5,0.303,0.655,49,18,11,7,0.242,0.909,45,16,11,3
5113,21800194,Utah Jazz,Memphis Grizzlies,96,88,184,8,Utah Jazz,8,0.281,0.767,49,19,7,6,0.167,0.783,42,19,7,9
5114,21800195,Brooklyn Nets,Minnesota Timberwolves,113,120,233,7,Minnesota Timberwolves,7,0.36,0.682,42,28,10,2,0.435,0.839,52,26,8,6
5115,21800196,Phoenix Suns,Oklahoma City Thunder,101,118,219,17,Oklahoma City Thunder,17,0.269,0.842,37,25,5,5,0.481,0.95,42,23,12,6
5116,21800197,San Antonio Spurs,Sacramento Kings,99,104,203,5,Sacramento Kings,5,0.323,0.813,43,25,5,4,0.458,0.583,45,27,12,3
5117,21800198,Golden State Warriors,Los Angeles Clippers,116,121,237,5,Los Angeles Clippers,5,0.387,0.696,46,27,7,8,0.25,0.882,49,23,11,5
5118,21800199,Charlotte Hornets,Cleveland Cavaliers,89,113,202,24,Cleveland Cavaliers,24,0.195,0.789,37,22,12,4,0.542,0.833,60,23,5,3
5119,21800200,Houston Rockets,Denver Nuggets,109,99,208,10,Houston Rockets,10,0.351,0.692,32,23,7,6,0.44,0.75,31,27,11,2
5120,21800201,Atlanta Hawks,Golden State Warriors,103,110,213,7,Golden State Warriors,7,0.375,0.733,42,25,9,2,0.444,0.952,48,28,8,6
5121,21800202,Philadelphia 76ers,Orlando Magic,106,111,217,5,Orlando Magic,5,0.483,0.667,41,32,2,3,0.429,0.864,37,23,7,4
5122,21800203,Cleveland Cavaliers,Washington Wizards,95,119,214,24,Washington Wizards,24,0.19,0.677,42,22,12,6,0.325,0.692,44,30,17,3
5123,21800204,Chicago Bulls,Boston Celtics,82,111,193,29,Boston Celtics,29,0.304,1,47,16,8,3,0.441,0.857,51,27,12,5
5124,21800205,Miami Heat,Brooklyn Nets,120,107,227,13,Miami Heat,13,0.276,0.714,47,23,6,6,0.286,0.708,46,17,10,2
5125,21800206,Detroit Pistons,Toronto Raptors,106,104,210,2,Detroit Pistons,2,0.303,0.615,39,24,8,5,0.2,0.588,49,23,9,3
5126,21800207,Memphis Grizzlies,Milwaukee Bucks,116,113,229,3,Memphis Grizzlies,3,0.389,0.75,34,24,8,4,0.257,0.815,44,22,5,8
5127,21800208,New Orleans Pelicans,Minnesota Timberwolves,100,107,207,7,Minnesota Timberwolves,7,0.321,0.611,46,25,7,6,0.438,0.792,47,29,14,6
5128,21800209,New York Knicks,Oklahoma City Thunder,103,128,231,25,Oklahoma City Thunder,25,0.269,0.783,36,18,8,8,0.485,0.833,47,32,11,7
5129,21800210,Utah Jazz,Dallas Mavericks,68,118,186,50,Dallas Mavericks,50,0.171,0.632,33,16,11,3,0.429,0.667,51,24,12,6
5130,21800211,San Antonio Spurs,Phoenix Suns,96,116,212,20,Phoenix Suns,20,0.304,0.792,43,16,7,4,0.484,0.875,38,27,9,4
5131,21800212,Portland Trail Blazers,Los Angeles Lakers,117,126,243,9,Los Angeles Lakers,9,0.424,0.913,47,24,8,10,0.469,0.885,48,25,11,6
5132,21800213,Golden State Warriors,Houston Rockets,86,107,193,21,Houston Rockets,21,0.222,0.818,44,18,2,5,0.34,0.808,41,20,8,4
5133,21800214,Atlanta Hawks,Denver Nuggets,93,138,231,45,Denver Nuggets,45,0.214,0.741,43,20,7,5,0.419,0.76,56,34,12,6
5134,21800215,San Antonio Spurs,Los Angeles Clippers,111,116,227,5,Los Angeles Clippers,5,0.31,0.8,45,19,7,6,0.348,0.8,50,23,2,3
5135,21800216,Toronto Raptors,Boston Celtics,116,123,239,7,Boston Celtics,7,0.276,0.828,43,20,12,4,0.346,0.833,46,25,9,6
5136,21800217,Miami Heat,Indiana Pacers,91,99,190,8,Indiana Pacers,8,0.389,0.7,51,21,10,5,0.519,0.867,47,22,10,6
5137,21800218,Utah Jazz,Philadelphia 76ers,107,113,220,6,Philadelphia 76ers,6,0.182,0.568,39,15,10,4,0.478,0.625,41,25,7,5
5138,21800219,Brooklyn Nets,Washington Wizards,115,104,219,11,Brooklyn Nets,11,0.273,0.789,47,19,8,3,0.167,0.794,47,18,5,4
5139,21800220,Sacramento Kings,Memphis Grizzlies,104,112,216,8,Memphis Grizzlies,8,0.364,0.75,42,23,9,2,0.44,0.625,40,24,11,5
5140,21800221,Portland Trail Blazers,Minnesota Timberwolves,96,112,208,16,Minnesota Timberwolves,16,0.276,0.7,48,16,6,1,0.429,0.727,43,28,11,4
5141,21800222,New York Knicks,New Orleans Pelicans,124,129,253,5,New Orleans Pelicans,5,0.324,0.708,44,15,10,6,0.294,0.719,54,27,5,5
5142,21800223,Chicago Bulls,Milwaukee Bucks,104,123,227,19,Milwaukee Bucks,19,0.394,0.692,36,22,8,3,0.419,0.647,55,28,8,8
5143,21800224,Los Angeles Clippers,Brooklyn Nets,127,119,246,8,Los Angeles Clippers,8,0.478,0.833,38,23,4,1,0.464,0.765,47,25,4,5
5144,21800225,Philadelphia 76ers,Charlotte Hornets,122,119,241,3,Philadelphia 76ers,3,0.314,0.868,53,23,9,6,0.323,0.926,49,23,10,3
5145,21800226,Atlanta Hawks,Indiana Pacers,89,97,186,8,Indiana Pacers,8,0.276,0.704,41,20,15,6,0.4,0.714,53,25,11,6
5146,21800227,Los Angeles Lakers,Orlando Magic,117,130,247,13,Orlando Magic,13,0.333,0.84,41,22,5,6,0.344,0.826,41,28,5,8
5147,21800228,Denver Nuggets,New Orleans Pelicans,115,125,240,10,New Orleans Pelicans,10,0.385,0.615,43,30,5,6,0.4,0.912,46,29,6,8
5148,21800229,Utah Jazz,Boston Celtics,98,86,184,12,Utah Jazz,12,0.289,0.63,46,23,11,4,0.152,0.55,51,16,11,4
5149,21800230,Toronto Raptors,Chicago Bulls,122,83,205,39,Toronto Raptors,39,0.4,0.923,54,31,14,10,0.296,0.714,34,21,13,3
5150,21800231,Sacramento Kings,Houston Rockets,112,132,244,20,Houston Rockets,20,0.314,0.75,39,23,10,3,0.426,0.833,41,27,9,10
5151,21800232,Golden State Warriors,Dallas Mavericks,109,112,221,3,Dallas Mavericks,3,0.273,0.941,47,24,6,6,0.294,0.647,46,18,6,5
5152,21800233,Oklahoma City Thunder,Phoenix Suns,110,100,210,10,Oklahoma City Thunder,10,0.292,0.844,52,17,9,7,0.414,0.667,31,25,14,6
5153,21800234,Memphis Grizzlies,Minnesota Timberwolves,100,87,187,13,Memphis Grizzlies,13,0.429,0.72,43,26,11,9,0.414,0.813,49,20,8,3
5154,21800235,Los Angeles Lakers,Miami Heat,113,97,210,16,Los Angeles Lakers,16,0.407,0.857,50,16,7,5,0.406,0.737,48,20,3,5
5155,21800236,New York Knicks,Orlando Magic,117,131,248,14,Orlando Magic,14,0.333,0.829,42,12,7,2,0.406,0.846,35,35,5,6
5156,21800237,Portland Trail Blazers,Washington Wizards,119,109,228,10,Portland Trail Blazers,10,0.367,0.857,52,26,4,3,0.406,0.476,43,28,4,9
5157,21800238,Golden State Warriors,San Antonio Spurs,92,104,196,12,San Antonio Spurs,12,0.192,0.81,46,20,6,4,0.417,0.706,48,24,3,5
5158,21800239,Boston Celtics,Charlotte Hornets,112,117,229,5,Charlotte Hornets,5,0.281,0.722,41,31,9,6,0.366,0.727,44,18,5,3
5159,21800240,Cleveland Cavaliers,Detroit Pistons,102,113,215,11,Detroit Pistons,11,0.381,0.706,36,16,8,3,0.342,0.947,50,26,5,4
5160,21800241,Utah Jazz,Indiana Pacers,94,121,215,27,Indiana Pacers,27,0.44,0.688,36,26,6,10,0.48,0.647,44,35,13,3
5161,21800242,Phoenix Suns,Philadelphia 76ers,114,119,233,5,Philadelphia 76ers,5,0.394,0.542,31,25,9,4,0.273,0.738,53,24,8,1
5162,21800243,Los Angeles Clippers,Atlanta Hawks,127,119,246,8,Los Angeles Clippers,8,0.303,0.787,52,24,9,8,0.316,0.895,51,29,6,6
5163,21800244,Dallas Mavericks,Memphis Grizzlies,88,98,186,10,Memphis Grizzlies,10,0.313,0.857,43,17,8,4,0.4,0.857,45,29,8,11
5164,21800245,Denver Nuggets,Milwaukee Bucks,98,104,202,6,Milwaukee Bucks,6,0.293,0.667,43,30,6,4,0.306,0.591,51,21,8,3
5165,21800246,San Antonio Spurs,New Orleans Pelicans,126,140,266,14,New Orleans Pelicans,14,0.5,0.8,44,22,7,0,0.385,0.857,42,34,10,5
5166,21800247,Oklahoma City Thunder,Sacramento Kings,113,117,230,4,Sacramento Kings,4,0.293,0.688,53,22,8,3,0.421,0.647,59,29,7,4
5167,21800248,Toronto Raptors,Orlando Magic,93,91,184,2,Toronto Raptors,2,0.265,0.75,43,23,7,5,0.267,0.789,49,24,5,4
5168,21800249,Los Angeles Clippers,Washington Wizards,118,125,243,7,Washington Wizards,7,0.407,0.833,44,20,6,4,0.333,0.821,44,27,11,8
5169,21800250,Brooklyn Nets,Miami Heat,104,92,196,12,Brooklyn Nets,12,0.258,0.769,53,17,6,4,0.219,0.65,52,18,5,6
5170,21800251,Portland Trail Blazers,New York Knicks,118,114,232,4,Portland Trail Blazers,4,0.457,0.706,43,25,8,4,0.448,0.773,42,22,8,5
5171,21800252,Indiana Pacers,Charlotte Hornets,109,127,236,18,Charlotte Hornets,18,0.333,0.941,37,26,5,7,0.621,0.864,36,30,7,3
5172,21800253,New Orleans Pelicans,Philadelphia 76ers,120,121,241,1,Philadelphia 76ers,1,0.367,0.758,54,24,8,8,0.345,0.885,47,27,7,7
5173,21800254,Toronto Raptors,Atlanta Hawks,124,108,232,16,Toronto Raptors,16,0.379,0.739,55,33,6,1,0.278,0.778,34,24,10,7
5174,21800255,New York Knicks,Boston Celtics,117,109,226,8,New York Knicks,8,0.5,0.824,49,25,3,11,0.303,0.719,50,30,10,9
5175,21800256,Los Angeles Lakers,Cleveland Cavaliers,109,105,214,4,Los Angeles Lakers,4,0.36,0.714,51,23,2,9,0.382,0.933,46,18,3,2
5176,21800257,Phoenix Suns,Chicago Bulls,116,124,240,8,Chicago Bulls,8,0.294,1,36,28,9,5,0.44,0.875,39,28,8,2
5177,21800258,Detroit Pistons,Houston Rockets,124,126,250,2,Houston Rockets,2,0.471,0.757,37,20,8,1,0.394,0.917,36,18,8,7
5178,21800259,Portland Trail Blazers,Milwaukee Bucks,100,143,243,43,Milwaukee Bucks,43,0.22,0.821,40,13,8,6,0.333,0.824,59,34,8,2
5179,21800260,Denver Nuggets,Minnesota Timberwolves,103,101,204,2,Denver Nuggets,2,0.4,0.833,40,29,12,4,0.281,0.846,40,24,8,3
5180,21800261,Brooklyn Nets,Dallas Mavericks,113,119,232,6,Dallas Mavericks,6,0.333,0.714,42,23,8,2,0.407,0.78,45,21,10,3
5181,21800262,Memphis Grizzlies,San Antonio Spurs,104,103,207,1,Memphis Grizzlies,1,0.32,0.857,40,21,4,7,0.318,0.867,43,21,4,5
5182,21800263,Sacramento Kings,Utah Jazz,119,110,229,9,Sacramento Kings,9,0.44,0.737,48,27,5,4,0.308,0.71,46,21,7,7
5183,21800264,Oklahoma City Thunder,Golden State Warriors,123,95,218,28,Oklahoma City Thunder,28,0.371,0.533,61,29,10,5,0.241,0.667,42,24,7,10
5184,21800265,Minnesota Timberwolves,Brooklyn Nets,112,102,214,10,Minnesota Timberwolves,10,0.36,0.882,38,25,15,4,0.311,0.846,46,26,2,4
5185,21800266,Memphis Grizzlies,Los Angeles Clippers,107,112,219,5,Los Angeles Clippers,5,0.333,0.778,47,29,6,7,0.348,0.889,48,26,6,5
5186,21800267,Houston Rockets,Detroit Pistons,111,116,227,5,Detroit Pistons,5,0.278,0.905,44,22,6,7,0.259,0.725,49,18,11,5
5187,21800268,Boston Celtics,Atlanta Hawks,114,96,210,18,Boston Celtics,18,0.325,0.81,43,31,11,7,0.171,0.69,40,22,9,7
5188,21800269,New Orleans Pelicans,New York Knicks,109,114,223,5,New York Knicks,5,0.25,0.759,55,26,5,5,0.364,0.741,46,22,9,10
5189,21800270,Cleveland Cavaliers,Philadelphia 76ers,121,112,233,9,Cleveland Cavaliers,9,0.5,0.75,42,16,7,1,0.364,0.769,31,27,5,2
5190,21800271,Washington Wizards,Toronto Raptors,107,125,232,18,Toronto Raptors,18,0.196,0.947,44,28,8,7,0.436,0.842,50,32,5,6
5191,21800272,San Antonio Spurs,Indiana Pacers,111,100,211,11,San Antonio Spurs,11,0.476,0.708,46,28,3,4,0.125,0.556,45,31,9,2
5192,21800273,Miami Heat,Chicago Bulls,103,96,199,7,Miami Heat,7,0.294,0.613,48,20,10,11,0.25,0.95,51,23,8,6
5193,21800274,Charlotte Hornets,Oklahoma City Thunder,104,109,213,5,Oklahoma City Thunder,5,0.194,0.857,46,24,8,5,0.333,0.667,46,24,6,2
5194,21800275,Phoenix Suns,Milwaukee Bucks,116,114,230,2,Phoenix Suns,2,0.346,0.773,40,21,8,4,0.227,0.667,43,30,6,7
5195,21800276,Orlando Magic,Denver Nuggets,87,112,199,25,Denver Nuggets,25,0.25,0.789,37,24,7,2,0.321,0.882,51,33,10,5
5196,21800277,Portland Trail Blazers,Golden State Warriors,97,125,222,28,Golden State Warriors,28,0.375,0.545,39,22,9,2,0.531,0.75,43,29,11,10
5197,21800278,Utah Jazz,Los Angeles Lakers,83,90,173,7,Los Angeles Lakers,7,0.174,0.765,41,22,12,3,0.304,0.611,47,10,11,5
5198,21800279,Houston Rockets,Cleveland Cavaliers,108,117,225,9,Cleveland Cavaliers,9,0.385,0.679,31,18,5,4,0.318,0.759,49,15,11,2
5199,21800280,New Orleans Pelicans,Washington Wizards,114,124,238,10,Washington Wizards,10,0.355,0.81,43,23,10,3,0.345,0.522,45,30,12,9
5200,21800281,Chicago Bulls,Minnesota Timberwolves,96,111,207,15,Minnesota Timberwolves,15,0.303,0.71,40,22,7,4,0.206,0.87,59,22,7,5
5201,21800282,Denver Nuggets,Oklahoma City Thunder,105,98,203,7,Denver Nuggets,7,0.333,0.708,54,26,6,9,0.231,0.652,54,22,9,5
5202,21800283,Boston Celtics,Dallas Mavericks,104,113,217,9,Dallas Mavericks,9,0.357,0.923,42,19,8,3,0.39,0.619,43,27,12,3
5203,21800284,San Antonio Spurs,Milwaukee Bucks,129,135,264,6,Milwaukee Bucks,6,0.476,0.75,39,27,8,3,0.375,0.759,41,30,7,3
5204,21800285,Sacramento Kings,Golden State Warriors,116,117,233,1,Golden State Warriors,1,0.393,0.724,47,28,6,4,0.294,0.862,54,28,5,6
5205,21800286,Orlando Magic,Los Angeles Lakers,108,104,212,4,Orlando Magic,4,0.355,0.929,45,31,8,5,0.385,0.645,42,22,9,10
5206,21800287,Phoenix Suns,Detroit Pistons,107,118,225,11,Detroit Pistons,11,0.32,0.714,42,22,6,6,0.39,0.64,41,30,9,0
5207,21800288,Charlotte Hornets,Atlanta Hawks,123,124,247,1,Atlanta Hawks,1,0.4,0.821,42,30,8,4,0.41,0.727,41,34,5,9
5208,21800289,Philadelphia 76ers,Brooklyn Nets,127,125,252,2,Philadelphia 76ers,2,0.414,0.818,42,28,9,6,0.4,0.75,43,19,2,4
5209,21800290,Miami Heat,Toronto Raptors,115,125,240,10,Toronto Raptors,10,0.417,0.688,46,21,6,5,0.314,0.8,47,25,4,7
5210,21800291,New York Knicks,Memphis Grizzlies,103,98,201,5,New York Knicks,5,0.364,0.844,56,17,4,5,0.367,0.579,41,27,5,19
5211,21800292,Utah Jazz,Sacramento Kings,133,112,245,21,Utah Jazz,21,0.333,0.758,49,30,11,5,0.391,0.742,36,20,10,7
5212,21800293,Los Angeles Clippers,Portland Trail Blazers,104,100,204,4,Los Angeles Clippers,4,0.2,0.676,48,15,9,5,0.211,0.8,58,18,2,5
5213,21800294,Milwaukee Bucks,Charlotte Hornets,107,110,217,3,Charlotte Hornets,3,0.348,0.81,48,25,7,5,0.448,0.7,44,21,9,5
5214,21800295,Minnesota Timberwolves,Cleveland Cavaliers,102,95,197,7,Minnesota Timberwolves,7,0.308,0.737,39,18,8,8,0.323,0.929,40,24,4,3
5215,21800296,Houston Rockets,Washington Wizards,131,135,266,4,Washington Wizards,4,0.375,0.778,48,22,8,5,0.379,0.75,38,29,7,7
5216,21800297,San Antonio Spurs,Chicago Bulls,108,107,215,1,San Antonio Spurs,1,0.333,0.889,46,29,7,2,0.424,0.818,43,23,6,5
5217,21800298,Boston Celtics,New Orleans Pelicans,124,107,231,17,Boston Celtics,17,0.487,0.9,42,27,14,4,0.375,0.931,40,21,8,5
5218,21800299,Indiana Pacers,Utah Jazz,121,88,209,33,Indiana Pacers,33,0.5,0.824,39,33,13,4,0.258,0.706,38,25,10,4
5219,21800300,Orlando Magic,Golden State Warriors,110,116,226,6,Golden State Warriors,6,0.467,0.762,34,28,11,2,0.371,0.913,46,21,8,7
5220,21800301,New York Knicks,Detroit Pistons,108,115,223,7,Detroit Pistons,7,0.333,0.844,50,16,5,5,0.292,0.711,48,20,5,7
5221,21800302,Atlanta Hawks,Miami Heat,115,113,228,2,Atlanta Hawks,2,0.387,0.844,46,22,13,7,0.342,0.667,43,22,20,3
5222,21800303,Toronto Raptors,Memphis Grizzlies,122,114,236,8,Toronto Raptors,8,0.545,0.714,31,25,5,5,0.345,0.857,35,27,9,5
5223,21800304,Los Angeles Lakers,Denver Nuggets,85,117,202,32,Denver Nuggets,32,0.143,0.667,39,19,5,8,0.36,0.933,60,28,7,4
5224,21800305,Indiana Pacers,Phoenix Suns,109,104,213,5,Indiana Pacers,5,0.423,0.759,55,25,8,6,0.333,0.667,45,20,8,6
5225,21800306,Atlanta Hawks,Charlotte Hornets,94,108,202,14,Charlotte Hornets,14,0.25,0.864,54,20,11,8,0.2,0.757,44,20,15,5
5226,21800307,New York Knicks,Philadelphia 76ers,91,117,208,26,Philadelphia 76ers,26,0.207,0.955,41,14,11,5,0.48,0.688,50,34,7,5
5227,21800308,Utah Jazz,Brooklyn Nets,101,91,192,10,Utah Jazz,10,0.321,0.667,48,17,10,6,0.367,0.714,48,11,12,5
5228,21800309,Dallas Mavericks,Houston Rockets,128,108,236,20,Dallas Mavericks,20,0.5,0.792,37,27,10,7,0.289,0.652,38,28,10,5
5229,21800310,Chicago Bulls,Milwaukee Bucks,113,116,229,3,Milwaukee Bucks,3,0.297,0.759,45,28,9,3,0.343,0.75,48,29,6,8
5230,21800311,San Antonio Spurs,Minnesota Timberwolves,89,128,217,39,Minnesota Timberwolves,39,0.296,1,46,23,1,8,0.439,0.667,48,33,12,6
5231,21800312,Washington Wizards,New Orleans Pelicans,104,125,229,21,New Orleans Pelicans,21,0.333,0.563,38,26,12,2,0.306,0.786,64,24,10,5
5232,21800313,Cleveland Cavaliers,Oklahoma City Thunder,83,100,183,17,Oklahoma City Thunder,17,0.391,0.444,43,20,4,1,0.222,0.8,50,25,5,11
5233,21800314,Orlando Magic,Portland Trail Blazers,112,115,227,3,Portland Trail Blazers,3,0.467,0.933,37,28,3,8,0.487,0.688,47,24,8,1
5234,21800315,Phoenix Suns,Los Angeles Clippers,99,115,214,16,Los Angeles Clippers,16,0.308,0.722,34,20,17,6,0.524,0.75,56,21,6,7
5235,21800316,Golden State Warriors,Toronto Raptors,128,131,259,3,Toronto Raptors,3,0.367,0.85,46,27,6,5,0.395,0.917,37,25,5,6
5236,21800317,Indiana Pacers,Los Angeles Lakers,96,104,200,8,Los Angeles Lakers,8,0.435,0.815,44,23,14,4,0.292,0.565,50,25,8,11
5237,21800318,Los Angeles Clippers,Sacramento Kings,133,121,254,12,Los Angeles Clippers,12,0.429,0.75,38,25,7,5,0.292,0.846,48,26,4,2
5238,21800319,Cleveland Cavaliers,Boston Celtics,95,128,223,33,Boston Celtics,33,0.318,0.8,36,18,5,1,0.548,0.813,47,30,4,4
5239,21800320,Utah Jazz,Charlotte Hornets,119,111,230,8,Utah Jazz,8,0.45,0.722,41,32,5,5,0.321,0.615,38,19,8,3
5240,21800321,Chicago Bulls,Detroit Pistons,88,107,195,19,Detroit Pistons,19,0.143,0.786,40,25,5,7,0.382,0.75,52,24,5,5
5241,21800322,Washington Wizards,Philadelphia 76ers,98,123,221,25,Philadelphia 76ers,25,0.286,0.842,42,22,10,4,0.316,0.758,58,28,11,7
5242,21800323,Memphis Grizzlies,Brooklyn Nets,131,125,256,6,Memphis Grizzlies,6,0.4,0.864,45,27,8,6,0.364,0.833,51,26,7,4
5243,21800324,New Orleans Pelicans,Miami Heat,101,106,207,5,Miami Heat,5,0.214,0.862,46,25,4,8,0.333,0.625,46,22,10,4
5244,21800325,Atlanta Hawks,Oklahoma City Thunder,109,124,233,15,Oklahoma City Thunder,15,0.306,0.6,42,26,15,3,0.439,0.933,46,30,12,7
5245,21800326,Houston Rockets,San Antonio Spurs,136,105,241,31,Houston Rockets,31,0.407,0.8,49,32,9,6,0.357,0.85,41,24,4,4
5246,21800327,Orlando Magic,Phoenix Suns,99,85,184,14,Orlando Magic,14,0.296,0.722,44,23,7,5,0.25,0.714,40,22,5,0
5247,21800328,Dallas Mavericks,Los Angeles Lakers,103,114,217,11,Los Angeles Lakers,11,0.256,0.735,46,20,9,4,0.3,0.656,47,23,8,3
5248,21800329,Denver Nuggets,Portland Trail Blazers,113,112,225,1,Denver Nuggets,1,0.467,0.731,41,28,11,3,0.273,0.762,44,19,7,6
5249,21800330,Milwaukee Bucks,New York Knicks,134,136,270,2,New York Knicks,2,0.429,0.774,51,28,11,4,0.588,0.667,41,30,5,2
5250,21800331,Golden State Warriors,Detroit Pistons,102,111,213,9,Detroit Pistons,9,0.231,0.857,44,23,6,5,0.343,0.65,47,22,8,2
5251,21800332,Toronto Raptors,Cleveland Cavaliers,106,95,201,11,Toronto Raptors,11,0.269,0.84,42,15,5,5,0.227,0.88,44,14,6,0
5252,21800333,Brooklyn Nets,Washington Wizards,88,102,190,14,Washington Wizards,14,0.242,0.8,42,19,8,2,0.308,0.667,38,19,8,3
5253,21800334,Chicago Bulls,Houston Rockets,105,121,226,16,Houston Rockets,16,0.25,0.792,41,15,11,6,0.39,0.7,47,23,8,7
5254,21800335,Boston Celtics,Minnesota Timberwolves,118,109,227,9,Boston Celtics,9,0.386,1,40,30,9,3,0.321,0.813,39,19,6,2
5255,21800336,Indiana Pacers,Sacramento Kings,110,111,221,1,Sacramento Kings,1,0.417,0.778,42,32,11,5,0.448,0.667,46,25,10,3
5256,21800337,Phoenix Suns,Los Angeles Lakers,96,120,216,24,Los Angeles Lakers,24,0.394,0.818,40,24,12,8,0.407,0.739,56,26,9,4
5257,21800338,New Orleans Pelicans,Charlotte Hornets,119,109,228,10,New Orleans Pelicans,10,0.344,0.833,50,30,6,5,0.278,0.75,41,25,9,6
5258,21800339,Utah Jazz,Miami Heat,100,102,202,2,Miami Heat,2,0.333,0.733,50,21,8,6,0.419,0.708,50,20,8,8
5259,21800340,Memphis Grizzlies,Philadelphia 76ers,95,103,198,8,Philadelphia 76ers,8,0.393,0.783,35,19,7,7,0.364,0.767,44,22,5,2
5260,21800341,Los Angeles Clippers,Dallas Mavericks,110,114,224,4,Dallas Mavericks,4,0.375,0.773,44,23,9,5,0.348,0.846,64,20,6,5
5261,21800342,Portland Trail Blazers,San Antonio Spurs,118,131,249,13,San Antonio Spurs,13,0.414,1,35,25,6,5,0.733,0.909,34,29,5,4
5262,21800343,Oklahoma City Thunder,Detroit Pistons,110,83,193,27,Oklahoma City Thunder,27,0.28,0.85,52,23,10,8,0.188,0.789,41,16,10,3
5263,21800344,Golden State Warriors,Atlanta Hawks,128,111,239,17,Golden State Warriors,17,0.542,0.864,39,33,10,8,0.192,0.75,35,23,10,4
5264,21800345,Cleveland Cavaliers,Brooklyn Nets,99,97,196,2,Cleveland Cavaliers,2,0.267,0.95,55,15,5,4,0.25,0.563,50,17,5,2
5265,21800346,Washington Wizards,New York Knicks,110,107,217,3,Washington Wizards,3,0.406,0.75,38,30,7,8,0.353,0.75,55,20,4,5
5266,21800347,Denver Nuggets,Toronto Raptors,106,103,209,3,Denver Nuggets,3,0.393,0.625,49,32,9,2,0.268,1,41,28,11,5
5267,21800348,Houston Rockets,Minnesota Timberwolves,91,103,194,12,Minnesota Timberwolves,12,0.282,0.842,34,24,9,6,0.5,0.714,42,22,11,7
5268,21800349,Los Angeles Clippers,New Orleans Pelicans,129,126,255,3,Los Angeles Clippers,3,0.4,0.767,39,29,4,1,0.382,0.682,35,32,10,5
5269,21800350,Chicago Bulls,Indiana Pacers,90,96,186,6,Indiana Pacers,6,0.355,1,44,26,8,2,0.273,0.833,45,22,10,6
5270,21800351,Orlando Magic,Miami Heat,105,90,195,15,Orlando Magic,15,0.5,0.75,43,22,5,4,0.343,0.4,47,19,7,11
5271,21800352,Portland Trail Blazers,Dallas Mavericks,102,111,213,9,Dallas Mavericks,9,0.292,0.826,48,20,7,6,0.367,0.686,50,25,11,4
5272,21800353,Sacramento Kings,Phoenix Suns,122,105,227,17,Sacramento Kings,17,0.458,0.656,42,27,13,3,0.279,0.81,43,27,9,4
5273,21800354,San Antonio Spurs,Utah Jazz,105,139,244,34,Utah Jazz,34,0.318,0.909,32,25,7,5,0.606,0.85,42,38,12,5
5274,21800355,Golden State Warriors,Cleveland Cavaliers,129,105,234,24,Golden State Warriors,24,0.529,0.875,46,29,6,5,0.344,0.696,41,17,7,2
5275,21800356,Denver Nuggets,Orlando Magic,124,118,242,6,Denver Nuggets,6,0.579,0.622,43,34,5,2,0.408,1,40,30,4,4
5276,21800357,Washington Wizards,Atlanta Hawks,131,117,248,14,Washington Wizards,14,0.316,0.844,49,35,9,4,0.316,0.742,43,28,13,4
5277,21800358,Oklahoma City Thunder,Brooklyn Nets,114,112,226,2,Oklahoma City Thunder,2,0.342,0.577,60,28,8,6,0.417,0.767,45,21,7,4
5278,21800359,Philadelphia 76ers,Toronto Raptors,102,113,215,11,Toronto Raptors,11,0.314,0.786,49,26,7,5,0.276,0.864,53,25,12,3
5279,21800360,Los Angeles Clippers,Memphis Grizzlies,86,96,182,10,Memphis Grizzlies,10,0.348,0.8,47,16,9,4,0.25,0.625,49,18,9,6
5280,21800361,Detroit Pistons,Milwaukee Bucks,92,115,207,23,Milwaukee Bucks,23,0.237,0.684,51,19,6,1,0.341,0.833,46,25,13,4
5281,21800362,Charlotte Hornets,Minnesota Timberwolves,104,121,225,17,Minnesota Timberwolves,17,0.364,0.8,40,27,7,1,0.5,0.65,50,34,6,11
5282,21800363,Dallas Mavericks,New Orleans Pelicans,106,132,238,26,New Orleans Pelicans,26,0.304,0.667,45,26,7,4,0.586,0.65,46,36,12,6
5283,21800364,San Antonio Spurs,Los Angeles Lakers,113,121,234,8,Los Angeles Lakers,8,0.259,1,49,18,8,2,0.359,0.697,42,21,6,3
5284,21800365,New York Knicks,Boston Celtics,100,128,228,28,Boston Celtics,28,0.343,0.8,47,21,4,5,0.342,0.85,46,32,8,6
5285,21800366,Phoenix Suns,Portland Trail Blazers,86,108,194,22,Portland Trail Blazers,22,0.185,0.786,41,20,11,2,0.333,0.63,56,24,10,6
5286,21800367,Houston Rockets,Utah Jazz,91,118,209,27,Utah Jazz,27,0.222,0.882,43,13,5,5,0.25,0.741,47,26,16,4
5287,21800368,Denver Nuggets,Charlotte Hornets,107,113,220,6,Charlotte Hornets,6,0.229,0.808,55,24,6,12,0.371,0.895,48,20,8,9
5288,21800369,Philadelphia 76ers,Detroit Pistons,117,111,228,6,Philadelphia 76ers,6,0.281,0.952,40,26,11,12,0.25,0.811,49,22,10,3
5289,21800370,Indiana Pacers,Orlando Magic,112,90,202,22,Indiana Pacers,22,0.346,0.833,53,26,8,8,0.242,0.769,47,20,3,7
5290,21800371,Toronto Raptors,Brooklyn Nets,105,106,211,1,Brooklyn Nets,1,0.314,0.828,41,25,9,7,0.314,0.692,60,22,8,2
5291,21800372,Sacramento Kings,Cleveland Cavaliers,129,110,239,19,Sacramento Kings,19,0.448,0.571,35,31,6,5,0.385,0.737,35,20,4,0
5292,21800373,Oklahoma City Thunder,Chicago Bulls,112,114,226,2,Chicago Bulls,2,0.357,0.667,51,25,12,6,0.48,0.696,39,25,15,6
5293,21800374,Memphis Grizzlies,New Orleans Pelicans,107,103,210,4,Memphis Grizzlies,4,0.421,0.75,42,30,10,7,0.241,0.833,42,25,5,5
5294,21800375,Los Angeles Lakers,San Antonio Spurs,120,133,253,13,San Antonio Spurs,13,0.306,0.81,43,24,8,1,0.419,0.848,48,27,4,7
5295,21800376,Miami Heat,Phoenix Suns,115,98,213,17,Miami Heat,17,0.405,0.889,40,32,10,5,0.412,0.75,42,27,7,4
5296,21800377,Golden State Warriors,Milwaukee Bucks,105,95,200,10,Golden State Warriors,10,0.413,0.857,43,32,7,6,0.179,0.696,54,18,10,3
5297,21800378,Houston Rockets,Dallas Mavericks,104,107,211,3,Dallas Mavericks,3,0.319,0.846,36,20,5,3,0.4,0.813,44,21,9,3
5298,21800379,Sacramento Kings,Indiana Pacers,97,107,204,10,Indiana Pacers,10,0.281,0.8,43,24,9,8,0.267,0.864,52,26,7,8
5299,21800380,Denver Nuggets,Atlanta Hawks,98,106,204,8,Atlanta Hawks,8,0.25,0.81,48,28,11,4,0.357,0.688,51,33,9,11
5300,21800381,Washington Wizards,Cleveland Cavaliers,101,116,217,15,Cleveland Cavaliers,15,0.368,0.688,33,26,3,3,0.484,0.7,49,26,5,5
5301,21800382,Brooklyn Nets,New York Knicks,112,104,216,8,Brooklyn Nets,8,0.5,0.6,45,27,5,5,0.308,0.6,40,22,8,2
5302,21800383,Boston Celtics,Chicago Bulls,133,77,210,56,Boston Celtics,56,0.512,0.733,54,34,10,4,0.25,0.643,37,16,3,2
5303,21800384,Los Angeles Lakers,Memphis Grizzlies,111,88,199,23,Los Angeles Lakers,23,0.4,0.75,57,27,11,6,0.2,0.778,36,17,13,7
5304,21800385,Minnesota Timberwolves,Portland Trail Blazers,105,113,218,8,Portland Trail Blazers,8,0.438,0.818,40,25,12,7,0.303,0.833,53,23,10,9
5305,21800386,Miami Heat,Los Angeles Clippers,121,98,219,23,Miami Heat,23,0.333,0.718,57,27,9,6,0.241,0.806,49,16,5,8
5306,21800387,New Orleans Pelicans,Detroit Pistons,116,108,224,8,New Orleans Pelicans,8,0.4,0.87,47,27,5,8,0.31,0.542,47,28,8,5
5307,21800388,Milwaukee Bucks,Toronto Raptors,104,99,203,5,Milwaukee Bucks,5,0.385,0.85,45,22,6,7,0.341,0.857,45,24,6,11
5308,21800389,Charlotte Hornets,New York Knicks,119,107,226,12,Charlotte Hornets,12,0.353,0.852,42,19,11,4,0.5,0.857,41,28,5,2
5309,21800390,Utah Jazz,San Antonio Spurs,97,110,207,13,San Antonio Spurs,13,0.31,0.737,38,23,8,4,0.357,0.917,46,26,7,7
5310,21800391,Washington Wizards,Indiana Pacers,101,109,210,8,Indiana Pacers,8,0.333,0.708,34,22,13,3,0.5,0.773,50,29,7,7
5311,21800392,Detroit Pistons,Philadelphia 76ers,102,116,218,14,Philadelphia 76ers,14,0.429,0.524,46,23,5,5,0.405,0.657,48,27,9,5
5312,21800393,New Orleans Pelicans,Boston Celtics,100,113,213,13,Boston Celtics,13,0.308,0.737,39,28,11,1,0.308,0.684,51,23,8,5
5313,21800394,Sacramento Kings,Chicago Bulls,108,89,197,19,Sacramento Kings,19,0.432,0.8,42,28,16,4,0.286,1,40,16,10,3
5314,21800395,Cleveland Cavaliers,Milwaukee Bucks,92,108,200,16,Milwaukee Bucks,16,0.333,0.667,46,24,5,2,0.417,0.818,58,22,4,4
5315,21800396,Utah Jazz,Oklahoma City Thunder,113,122,235,9,Oklahoma City Thunder,9,0.276,0.633,45,30,11,4,0.381,0.718,43,25,12,2
5316,21800397,Orlando Magic,Dallas Mavericks,76,101,177,25,Dallas Mavericks,25,0.286,0.8,42,18,8,2,0.286,0.84,52,28,7,4
5317,21800398,Memphis Grizzlies,Denver Nuggets,99,105,204,6,Denver Nuggets,6,0.333,0.941,34,22,7,4,0.321,0.783,40,22,11,6
5318,21800399,Los Angeles Clippers,Phoenix Suns,123,119,242,4,Los Angeles Clippers,4,0.333,0.788,42,27,8,4,0.36,0.8,40,31,14,8
5319,21800400,Minnesota Timberwolves,Golden State Warriors,108,116,224,8,Golden State Warriors,8,0.28,0.806,42,28,5,6,0.442,0.905,49,25,6,5
5320,21800401,Miami Heat,Los Angeles Lakers,105,108,213,3,Los Angeles Lakers,3,0.324,0.769,50,29,9,7,0.438,0.6,46,24,9,7
5321,21800402,Portland Trail Blazers,Houston Rockets,104,111,215,7,Houston Rockets,7,0.4,0.857,44,20,1,4,0.31,0.667,42,22,9,5
5322,21800403,Phoenix Suns,San Antonio Spurs,86,111,197,25,San Antonio Spurs,25,0.286,0.857,40,19,7,5,0.619,0.842,46,28,7,2
5323,21800404,Toronto Raptors,Los Angeles Clippers,123,99,222,24,Toronto Raptors,24,0.483,0.75,43,34,8,6,0.28,0.842,44,25,2,5
5324,21800405,Detroit Pistons,Charlotte Hornets,107,108,215,1,Charlotte Hornets,1,0.382,0.667,49,23,4,10,0.321,0.784,42,21,7,5
5325,21800406,New York Knicks,Cleveland Cavaliers,106,113,219,7,Cleveland Cavaliers,7,0.407,0.929,43,21,7,7,0.294,0.81,51,19,7,4
5326,21800407,Milwaukee Bucks,Indiana Pacers,97,113,210,16,Indiana Pacers,16,0.256,0.667,43,22,6,6,0.4,0.75,54,31,7,4
5327,21800408,Brooklyn Nets,Philadelphia 76ers,127,124,251,3,Brooklyn Nets,3,0.5,0.86,37,20,10,1,0.429,0.75,37,31,11,3
5328,21800409,Boston Celtics,Washington Wizards,130,125,255,5,Boston Celtics,5,0.289,1,50,20,6,2,0.364,0.724,41,25,7,4
5329,21800410,Portland Trail Blazers,Memphis Grizzlies,83,92,175,9,Memphis Grizzlies,9,0.273,0.813,44,15,11,9,0.333,0.667,51,19,9,10
5330,21800411,Oklahoma City Thunder,New Orleans Pelicans,114,118,232,4,New Orleans Pelicans,4,0.302,0.63,39,23,10,6,0.222,0.8,56,29,14,3
5331,21800412,Atlanta Hawks,Dallas Mavericks,107,114,221,7,Dallas Mavericks,7,0.333,0.714,44,21,7,2,0.353,0.744,36,22,13,5
5332,21800413,Miami Heat,Utah Jazz,84,111,195,27,Utah Jazz,27,0.364,0.583,30,16,10,2,0.5,0.714,52,29,6,4
5333,21800414,Minnesota Timberwolves,Sacramento Kings,130,141,271,11,Sacramento Kings,11,0.409,0.778,39,30,4,4,0.5,0.688,38,34,3,6
5334,21800415,Toronto Raptors,Golden State Warriors,113,93,206,20,Toronto Raptors,20,0.321,0.842,48,27,12,3,0.231,0.692,40,28,5,11
5335,21800416,Los Angeles Lakers,Houston Rockets,111,126,237,15,Houston Rockets,15,0.313,0.556,31,23,9,5,0.441,0.844,43,24,8,2
5336,21800417,Los Angeles Clippers,San Antonio Spurs,87,125,212,38,San Antonio Spurs,38,0.323,0.708,42,21,4,1,0.455,0.792,47,25,10,7
5337,21800418,Chicago Bulls,Orlando Magic,91,97,188,6,Orlando Magic,6,0.556,0.65,33,18,10,4,0.333,0.783,43,23,8,6
5338,21800419,Dallas Mavericks,Phoenix Suns,89,99,188,10,Phoenix Suns,10,0.152,0.667,53,14,7,4,0.37,0.833,40,20,15,5
5339,21800420,Atlanta Hawks,Boston Celtics,108,129,237,21,Boston Celtics,21,0.421,0.625,44,27,10,5,0.487,0.9,47,28,15,9
5340,21800421,New York Knicks,Charlotte Hornets,126,124,250,2,New York Knicks,2,0.353,0.645,46,27,11,8,0.417,0.8,51,38,7,5
5341,21800422,Washington Wizards,Brooklyn Nets,118,125,243,7,Brooklyn Nets,7,0.379,0.563,26,30,3,3,0.355,0.839,45,34,5,3
5342,21800423,Milwaukee Bucks,Cleveland Cavaliers,114,102,216,12,Milwaukee Bucks,12,0.293,0.786,53,26,9,6,0.361,0.905,50,24,7,2
5343,21800424,Indiana Pacers,Philadelphia 76ers,113,101,214,12,Indiana Pacers,12,0.4,0.875,47,33,7,2,0.25,0.741,49,17,5,5
5344,21800425,Miami Heat,Memphis Grizzlies,100,97,197,3,Miami Heat,3,0.385,0.722,50,30,3,8,0.276,0.76,34,21,9,5
5345,21800426,Oklahoma City Thunder,Denver Nuggets,98,109,207,11,Denver Nuggets,11,0.368,0.586,43,14,9,4,0.324,0.933,48,29,8,6
5346,21800427,Toronto Raptors,Portland Trail Blazers,122,128,250,6,Portland Trail Blazers,6,0.581,0.857,37,20,4,4,0.481,0.905,38,29,10,4
5347,21800428,Golden State Warriors,Sacramento Kings,130,125,255,5,Golden State Warriors,5,0.375,0.75,60,32,5,0,0.341,0.8,42,33,6,3
5348,21800429,Utah Jazz,Orlando Magic,89,96,185,7,Orlando Magic,7,0.241,0.929,42,17,13,4,0.458,0.85,48,18,7,10
5349,21800430,Los Angeles Lakers,Charlotte Hornets,128,100,228,28,Los Angeles Lakers,28,0.412,0.667,52,34,12,6,0.241,0.833,38,22,3,6
5350,21800431,Boston Celtics,Detroit Pistons,104,113,217,9,Detroit Pistons,9,0.273,0.739,44,19,11,4,0.333,0.714,48,25,10,7
5351,21800432,Houston Rockets,Memphis Grizzlies,105,97,202,8,Houston Rockets,8,0.351,0.88,36,23,5,2,0.217,0.706,35,20,8,6
5352,21800433,Chicago Bulls,San Antonio Spurs,98,93,191,5,Chicago Bulls,5,0.207,0.857,40,16,12,8,0.333,0.846,41,18,3,5
5353,21800434,Los Angeles Clippers,Oklahoma City Thunder,104,110,214,6,Oklahoma City Thunder,6,0.52,0.682,44,18,7,4,0.409,0.708,40,26,13,7
5354,21800435,Minnesota Timberwolves,Phoenix Suns,99,107,206,8,Phoenix Suns,8,0.2,0.737,41,26,10,4,0.321,0.8,51,30,6,7
5355,21800436,Atlanta Hawks,Brooklyn Nets,127,144,271,17,Brooklyn Nets,17,0.483,0.76,33,38,9,5,0.4,0.909,39,34,12,3
5356,21800437,Philadelphia 76ers,Cleveland Cavaliers,128,105,233,23,Philadelphia 76ers,23,0.407,0.75,48,32,5,9,0.4,0.647,33,28,8,0
5357,21800438,New York Knicks,Indiana Pacers,99,110,209,11,Indiana Pacers,11,0.313,0.682,44,21,7,1,0.353,0.783,45,28,9,4
5358,21800439,Los Angeles Lakers,Washington Wizards,110,128,238,18,Washington Wizards,18,0.306,0.611,43,24,10,6,0.419,0.7,51,30,14,5
5359,21800440,Sacramento Kings,Dallas Mavericks,120,113,233,7,Sacramento Kings,7,0.29,0.905,47,20,6,7,0.257,0.774,53,22,6,5
5360,21800441,Miami Heat,New Orleans Pelicans,102,96,198,6,Miami Heat,6,0.286,0.696,57,22,6,4,0.361,0.765,38,26,12,5
5361,21800442,Toronto Raptors,Denver Nuggets,86,95,181,9,Denver Nuggets,9,0.2,0.643,51,13,5,4,0.333,0.813,44,21,7,4
5362,21800443,Milwaukee Bucks,Detroit Pistons,107,104,211,3,Milwaukee Bucks,3,0.36,0.667,37,33,8,10,0.4,0.8,45,25,3,2
5363,21800444,Phoenix Suns,New York Knicks,128,110,238,18,Phoenix Suns,18,0.333,0.852,44,27,8,5,0.257,0.724,50,15,5,0
5364,21800445,Utah Jazz,Houston Rockets,97,102,199,5,Houston Rockets,5,0.286,0.742,52,23,9,4,0.324,0.839,39,16,13,7
5365,21800446,Sacramento Kings,Minnesota Timberwolves,105,132,237,27,Minnesota Timberwolves,27,0.368,0.652,38,20,5,4,0.37,0.867,58,37,10,7
5366,21800447,Chicago Bulls,Oklahoma City Thunder,96,121,217,25,Oklahoma City Thunder,25,0.364,0.75,41,20,10,7,0.381,0.818,49,24,14,2
5367,21800448,Philadelphia 76ers,San Antonio Spurs,96,123,219,27,San Antonio Spurs,27,0.297,0.714,41,29,3,5,0.391,0.941,45,28,5,9
5368,21800449,Memphis Grizzlies,Golden State Warriors,93,110,203,17,Golden State Warriors,17,0.28,0.778,41,24,6,4,0.387,0.889,42,23,10,5
5369,21800450,Portland Trail Blazers,Los Angeles Clippers,131,127,258,4,Portland Trail Blazers,4,0.5,0.871,33,26,5,4,0.37,0.846,37,27,5,1
5370,21800451,Cleveland Cavaliers,Indiana Pacers,92,91,183,1,Cleveland Cavaliers,1,0.194,0.769,51,19,7,5,0.182,0.619,52,21,7,9
5371,21800452,Washington Wizards,Atlanta Hawks,110,118,228,8,Atlanta Hawks,8,0.325,0.694,37,26,14,1,0.375,0.821,49,23,4,5
5372,21800453,Los Angeles Lakers,Brooklyn Nets,110,115,225,5,Brooklyn Nets,5,0.325,0.565,48,21,6,4,0.412,0.684,40,27,5,4
5373,21800454,Dallas Mavericks,Denver Nuggets,118,126,244,8,Denver Nuggets,8,0.405,0.767,33,26,8,1,0.414,0.778,47,33,7,3
5374,21800455,Cleveland Cavaliers,Charlotte Hornets,99,110,209,11,Charlotte Hornets,11,0.435,0.583,35,24,8,6,0.4,0.667,51,24,4,5
5375,21800456,San Antonio Spurs,Orlando Magic,129,90,219,39,San Antonio Spurs,39,0.632,0.81,45,29,5,4,0.387,0.588,33,19,5,3
5376,21800457,New York Knicks,Philadelphia 76ers,109,131,240,22,Philadelphia 76ers,22,0.323,0.806,35,22,2,2,0.5,0.88,51,31,6,4
5377,21800458,Phoenix Suns,Boston Celtics,111,103,214,8,Phoenix Suns,8,0.407,0.818,56,23,8,6,0.385,0.857,37,26,13,15
5378,21800459,Indiana Pacers,Toronto Raptors,96,99,195,3,Toronto Raptors,3,0.45,0.688,49,19,6,7,0.233,0.762,43,20,15,9
5379,21800460,Brooklyn Nets,Chicago Bulls,96,93,189,3,Brooklyn Nets,3,0.32,0.8,45,23,3,2,0.316,0.7,39,21,7,5
5380,21800461,Washington Wizards,Houston Rockets,118,136,254,18,Houston Rockets,18,0.333,0.783,31,28,8,2,0.473,0.762,41,30,8,2
5381,21800462,New Orleans Pelicans,Milwaukee Bucks,115,123,238,8,Milwaukee Bucks,8,0.452,0.667,41,28,6,7,0.394,0.8,48,26,11,3
5382,21800463,Detroit Pistons,Minnesota Timberwolves,129,123,252,6,Detroit Pistons,6,0.417,0.607,44,26,3,2,0.273,0.828,49,22,8,4
5383,21800464,Golden State Warriors,Utah Jazz,103,108,211,5,Utah Jazz,5,0.323,0.944,48,18,10,9,0.381,0.818,52,30,7,6
5384,21800465,Memphis Grizzlies,Portland Trail Blazers,92,99,191,7,Portland Trail Blazers,7,0.333,0.895,36,22,12,10,0.423,0.9,43,16,9,4
5385,21800466,Oklahoma City Thunder,Sacramento Kings,132,113,245,19,Oklahoma City Thunder,19,0.406,0.63,66,27,8,6,0.382,0.667,43,28,7,5
5386,21800467,Houston Rockets,Miami Heat,99,101,200,2,Miami Heat,2,0.333,0.767,41,20,6,3,0.231,0.588,61,22,6,4
5387,21800468,Dallas Mavericks,Los Angeles Clippers,121,125,246,4,Los Angeles Clippers,4,0.357,0.758,45,24,8,0,0.3,0.806,40,26,5,5
5388,21800469,Detroit Pistons,Charlotte Hornets,86,98,184,12,Charlotte Hornets,12,0.235,0.636,41,21,8,5,0.5,0.714,43,19,7,5
5389,21800470,Cleveland Cavaliers,Toronto Raptors,110,126,236,16,Toronto Raptors,16,0.375,0.767,40,20,5,5,0.29,0.808,44,21,9,5
5390,21800471,Indiana Pacers,Brooklyn Nets,114,106,220,8,Indiana Pacers,8,0.423,0.833,29,24,10,8,0.516,0.706,41,28,5,3
5391,21800472,Atlanta Hawks,New York Knicks,114,107,221,7,Atlanta Hawks,7,0.345,0.75,54,29,4,1,0.296,0.708,35,20,8,3
5392,21800473,Milwaukee Bucks,Boston Celtics,120,107,227,13,Milwaukee Bucks,13,0.4,0.786,55,26,3,6,0.294,0.75,36,22,13,3
5393,21800474,Orlando Magic,Chicago Bulls,80,90,170,10,Chicago Bulls,10,0.242,0.667,47,20,4,5,0.294,0.731,50,23,5,6
5394,21800475,Minnesota Timberwolves,San Antonio Spurs,98,124,222,26,San Antonio Spurs,26,0.286,0.839,39,19,11,5,0.576,0.722,50,36,7,3
5395,21800476,Utah Jazz,Portland Trail Blazers,120,90,210,30,Utah Jazz,30,0.516,0.588,42,35,7,6,0.313,0.556,42,17,8,6
5396,21800477,Memphis Grizzlies,Sacramento Kings,99,102,201,3,Sacramento Kings,3,0.5,0.9,44,24,7,8,0.366,0.724,42,25,10,5
5397,21800478,New Orleans Pelicans,Los Angeles Lakers,104,112,216,8,Los Angeles Lakers,8,0.296,0.5,53,27,8,6,0.25,0.72,48,28,7,4
5398,21800479,Denver Nuggets,Los Angeles Clippers,111,132,243,21,Los Angeles Clippers,21,0.29,0.8,37,21,10,5,0.5,0.941,56,28,7,5
5399,21800480,Phoenix Suns,Washington Wizards,146,149,295,3,Washington Wizards,3,0.314,0.758,50,30,14,7,0.361,0.889,53,40,6,5
5400,21800481,Toronto Raptors,Philadelphia 76ers,101,126,227,25,Philadelphia 76ers,25,0.25,0.895,41,17,5,2,0.333,0.743,53,33,10,7
5401,21800482,Milwaukee Bucks,Miami Heat,87,94,181,7,Miami Heat,7,0.209,0.727,48,20,6,9,0.313,0.696,57,22,9,3
5402,21800483,San Antonio Spurs,Houston Rockets,101,108,209,7,Houston Rockets,7,0.417,0.636,43,24,3,9,0.352,0.714,58,22,4,3
5403,21800484,Dallas Mavericks,Golden State Warriors,116,120,236,4,Golden State Warriors,4,0.359,0.643,46,28,9,3,0.349,0.938,54,34,7,7
5404,21800485,Oklahoma City Thunder,Utah Jazz,107,106,213,1,Oklahoma City Thunder,1,0.36,0.636,51,19,11,5,0.324,0.611,44,35,12,4
5405,21800486,Atlanta Hawks,Detroit Pistons,98,95,193,3,Atlanta Hawks,3,0.261,0.8,54,24,9,9,0.345,0.63,41,21,6,9
5406,21800487,Washington Wizards,Indiana Pacers,89,105,194,16,Indiana Pacers,16,0.257,0.923,37,21,8,1,0.3,0.833,57,24,12,6
5407,21800488,Charlotte Hornets,Boston Celtics,103,119,222,16,Boston Celtics,16,0.25,0.731,37,24,9,5,0.333,0.8,47,30,8,4
5408,21800489,Phoenix Suns,Brooklyn Nets,103,111,214,8,Brooklyn Nets,8,0.176,0.875,41,24,10,5,0.37,0.636,49,25,7,4
5409,21800490,Chicago Bulls,Cleveland Cavaliers,112,92,204,20,Chicago Bulls,20,0.5,0.882,43,26,7,3,0.304,0.643,31,11,5,2
5410,21800491,Miami Heat,Orlando Magic,115,91,206,24,Miami Heat,24,0.516,0.684,39,27,11,3,0.357,0.719,40,15,4,5
5411,21800492,New Orleans Pelicans,Sacramento Kings,117,122,239,5,Sacramento Kings,5,0.231,0.821,58,26,6,9,0.452,0.727,50,26,9,4
5412,21800493,Minnesota Timberwolves,Oklahoma City Thunder,114,112,226,2,Minnesota Timberwolves,2,0.519,0.667,40,25,9,5,0.36,0.773,45,17,4,10
5413,21800494,Los Angeles Clippers,Golden State Warriors,127,129,256,2,Golden State Warriors,2,0.783,0.793,42,23,1,1,0.35,0.861,46,22,9,7
5414,21800495,Dallas Mavericks,Portland Trail Blazers,118,121,239,3,Portland Trail Blazers,3,0.353,0.714,49,22,1,2,0.289,0.706,53,29,5,6
5415,21800496,Memphis Grizzlies,Los Angeles Lakers,107,99,206,8,Memphis Grizzlies,8,0.538,0.643,43,24,9,7,0.333,0.682,41,27,6,8
5416,21800497,Milwaukee Bucks,New York Knicks,109,95,204,14,Milwaukee Bucks,14,0.188,0.676,51,22,9,8,0.276,0.81,57,17,4,3
5417,21800498,Oklahoma City Thunder,Houston Rockets,109,113,222,4,Houston Rockets,4,0.3,0.667,52,23,12,11,0.318,0.647,54,18,9,4
5418,21800499,Philadelphia 76ers,Boston Celtics,114,121,235,7,Boston Celtics,7,0.375,0.793,56,25,6,4,0.341,0.85,55,21,8,4
5419,21800500,Los Angeles Lakers,Golden State Warriors,127,101,228,26,Los Angeles Lakers,26,0.394,0.741,49,27,5,3,0.25,0.762,37,28,5,1
5420,21800501,Portland Trail Blazers,Utah Jazz,96,117,213,21,Utah Jazz,21,0.391,0.654,42,20,7,3,0.448,0.522,49,20,7,10
5421,21800502,Washington Wizards,Detroit Pistons,95,106,201,11,Detroit Pistons,11,0.273,0.769,31,17,14,4,0.378,0.947,46,25,8,4
5422,21800503,Phoenix Suns,Orlando Magic,122,120,242,2,Phoenix Suns,2,0.542,0.765,45,22,9,9,0.389,0.818,42,20,11,2
5423,21800504,Indiana Pacers,Atlanta Hawks,129,121,250,8,Indiana Pacers,8,0.481,0.727,39,35,13,3,0.472,0.778,41,33,8,6
5424,21800505,Charlotte Hornets,Brooklyn Nets,132,134,266,2,Brooklyn Nets,2,0.484,0.767,53,26,8,3,0.404,0.722,57,31,8,7
5425,21800506,Toronto Raptors,Miami Heat,106,104,210,2,Toronto Raptors,2,0.433,0.826,43,19,8,2,0.414,0.5,35,28,10,6
5426,21800507,Minnesota Timberwolves,Chicago Bulls,119,94,213,25,Minnesota Timberwolves,25,0.344,0.842,52,26,4,1,0.261,0.625,45,22,6,5
5427,21800508,Cleveland Cavaliers,Memphis Grizzlies,87,95,182,8,Memphis Grizzlies,8,0.31,0.8,53,19,9,1,0.227,0.75,34,22,7,9
5428,21800509,New Orleans Pelicans,Dallas Mavericks,119,122,241,3,Dallas Mavericks,3,0.444,0.767,39,25,4,2,0.343,0.842,46,23,3,13
5429,21800510,Denver Nuggets,San Antonio Spurs,103,111,214,8,San Antonio Spurs,8,0.45,0.652,47,29,10,3,0.313,0.773,50,29,6,4
5430,21800511,Sacramento Kings,Los Angeles Clippers,118,127,245,9,Los Angeles Clippers,9,0.333,0.667,43,26,8,10,0.429,0.826,50,23,7,6
5431,21800512,Boston Celtics,Houston Rockets,113,127,240,14,Houston Rockets,14,0.387,0.806,37,28,9,3,0.4,0.771,55,17,4,4
5432,21800513,New York Knicks,Milwaukee Bucks,96,112,208,16,Milwaukee Bucks,16,0.419,0.688,43,21,8,6,0.344,0.81,57,20,4,11
5433,21800514,Los Angeles Lakers,Sacramento Kings,116,117,233,1,Sacramento Kings,1,0.4,0.696,46,25,7,5,0.345,0.81,48,25,10,5
5434,21800515,Philadelphia 76ers,Utah Jazz,114,97,211,17,Philadelphia 76ers,17,0.371,0.833,47,31,7,7,0.314,0.741,44,19,11,1
5435,21800516,Portland Trail Blazers,Golden State Warriors,110,109,219,1,Portland Trail Blazers,1,0.325,0.913,54,20,7,4,0.295,0.4,59,36,10,9
5436,21800517,Brooklyn Nets,Charlotte Hornets,87,100,187,13,Charlotte Hornets,13,0.148,0.85,48,15,4,10,0.333,0.7,49,19,4,8
5437,21800518,Detroit Pistons,Indiana Pacers,88,125,213,37,Indiana Pacers,37,0.25,0.917,44,25,7,6,0.263,0.7,43,33,11,5
5438,21800519,Toronto Raptors,Orlando Magic,87,116,203,29,Orlando Magic,29,0.353,0.792,41,18,4,10,0.346,0.864,60,29,3,8
5439,21800520,Chicago Bulls,Washington Wizards,101,92,193,9,Chicago Bulls,9,0.364,0.76,46,20,9,6,0.3,0.833,40,22,7,6
5440,21800521,Cleveland Cavaliers,Miami Heat,94,118,212,24,Miami Heat,24,0.351,0.864,42,21,6,2,0.323,0.75,45,29,8,5
5441,21800522,Atlanta Hawks,Minnesota Timberwolves,123,120,243,3,Atlanta Hawks,3,0.457,0.65,58,32,10,6,0.344,0.553,47,28,14,9
5442,21800523,Dallas Mavericks,New Orleans Pelicans,112,114,226,2,New Orleans Pelicans,2,0.469,0.697,39,19,7,6,0.174,0.815,49,22,7,4
5443,21800524,San Antonio Spurs,Denver Nuggets,99,102,201,3,Denver Nuggets,3,0.296,0.55,38,23,14,3,0.345,0.824,52,29,5,4
5444,21800525,Oklahoma City Thunder,Phoenix Suns,118,102,220,16,Oklahoma City Thunder,16,0.35,0.692,49,22,12,4,0.31,0.938,34,22,12,7
5445,21800526,Los Angeles Clippers,Los Angeles Lakers,118,107,225,11,Los Angeles Clippers,11,0.316,0.941,53,21,10,4,0.367,0.686,50,23,5,2
5446,21800527,Brooklyn Nets,Milwaukee Bucks,115,129,244,14,Milwaukee Bucks,14,0.429,0.686,40,28,6,3,0.412,0.875,39,30,6,5
5447,21800528,Houston Rockets,New Orleans Pelicans,108,104,212,4,Houston Rockets,4,0.348,0.786,39,21,9,7,0.321,0.765,45,25,7,5
5448,21800529,Cleveland Cavaliers,Atlanta Hawks,108,111,219,3,Atlanta Hawks,3,0.217,0.793,44,27,9,2,0.27,0.6,53,27,7,4
5449,21800530,Charlotte Hornets,Washington Wizards,126,130,256,4,Washington Wizards,4,0.419,0.792,41,22,9,4,0.351,0.875,42,35,8,6
5450,21800531,Boston Celtics,Memphis Grizzlies,112,103,215,9,Boston Celtics,9,0.444,0.889,36,29,10,4,0.269,0.828,36,24,11,2
5451,21800532,New York Knicks,Utah Jazz,97,129,226,32,Utah Jazz,32,0.469,0.818,35,17,10,1,0.444,0.786,60,30,8,6
5452,21800533,Denver Nuggets,Phoenix Suns,122,118,240,4,Denver Nuggets,4,0.514,0.769,40,31,10,3,0.379,0.643,37,29,15,5
5453,21800534,Golden State Warriors,Portland Trail Blazers,115,105,220,10,Golden State Warriors,10,0.48,0.821,42,27,9,4,0.29,0.818,46,18,6,4
5454,21800535,San Antonio Spurs,Los Angeles Clippers,122,111,233,11,San Antonio Spurs,11,0.261,0.903,49,27,10,4,0.45,0.789,40,22,9,2
5455,21800536,Detroit Pistons,Orlando Magic,107,109,216,2,Orlando Magic,2,0.258,0.913,51,21,6,2,0.292,0.917,45,21,7,4
5456,21800537,Minnesota Timberwolves,Miami Heat,113,104,217,9,Minnesota Timberwolves,9,0.333,0.806,49,24,11,10,0.333,0.786,52,19,8,6
5457,21800538,Chicago Bulls,Toronto Raptors,89,95,184,6,Toronto Raptors,6,0.35,0.889,44,16,7,2,0.273,0.9,52,17,5,8
5458,21800539,Oklahoma City Thunder,Dallas Mavericks,103,105,208,2,Dallas Mavericks,2,0.237,0.667,39,17,15,2,0.359,0.773,49,21,8,3
5459,21800540,Philadelphia 76ers,Portland Trail Blazers,95,129,224,34,Portland Trail Blazers,34,0.186,0.704,36,18,15,2,0.545,0.76,59,28,2,2
5460,21800541,Sacramento Kings,Los Angeles Lakers,114,121,235,7,Los Angeles Lakers,7,0.382,0.75,45,24,8,5,0.341,0.6,50,30,7,5
5461,21800542,Atlanta Hawks,Indiana Pacers,108,116,224,8,Indiana Pacers,8,0.406,0.684,53,24,8,5,0.458,0.724,39,29,13,6
5462,21800543,Orlando Magic,Charlotte Hornets,100,125,225,25,Charlotte Hornets,25,0.286,0.737,48,22,6,5,0.458,0.909,46,29,8,1
5463,21800544,Memphis Grizzlies,Houston Rockets,101,113,214,12,Houston Rockets,12,0.24,0.633,39,24,11,4,0.439,0.733,46,19,5,4
5464,21800545,Boston Celtics,San Antonio Spurs,111,120,231,9,San Antonio Spurs,9,0.324,0.7,40,30,5,8,0.538,0.889,43,27,6,4
5465,21800546,Minnesota Timberwolves,New Orleans Pelicans,114,123,237,9,New Orleans Pelicans,9,0.321,0.826,39,29,10,9,0.56,0.905,44,28,3,2
5466,21800547,Dallas Mavericks,Oklahoma City Thunder,102,122,224,20,Oklahoma City Thunder,20,0.368,0.765,49,21,7,3,0.25,0.686,46,22,13,3
5467,21800548,Golden State Warriors,Phoenix Suns,132,109,241,23,Golden State Warriors,23,0.5,0.813,44,31,7,8,0.346,0.867,38,20,7,3
5468,21800549,Utah Jazz,Toronto Raptors,116,122,238,6,Toronto Raptors,6,0.281,0.793,43,23,6,4,0.35,0.714,45,18,4,6
5469,21800550,Detroit Pistons,Milwaukee Bucks,98,121,219,23,Milwaukee Bucks,23,0.364,0.762,43,23,7,2,0.37,0.654,43,28,7,6
5470,21800551,New York Knicks,Denver Nuggets,108,115,223,7,Denver Nuggets,7,0.407,0.722,43,28,4,3,0.353,0.652,53,36,7,6
5471,21800552,Portland Trail Blazers,Sacramento Kings,113,108,221,5,Portland Trail Blazers,5,0.281,0.867,56,22,11,10,0.333,0.75,53,24,13,4
5472,21800553,Philadelphia 76ers,Los Angeles Clippers,119,113,232,6,Philadelphia 76ers,6,0.462,0.697,55,25,7,7,0.2,0.706,41,18,12,0
5473,21800554,Dallas Mavericks,Charlotte Hornets,122,84,206,38,Dallas Mavericks,38,0.4,0.889,57,31,9,4,0.188,0.737,46,23,4,3
5474,21800555,Miami Heat,Cleveland Cavaliers,117,92,209,25,Miami Heat,25,0.516,0.765,47,29,8,3,0.419,0.846,22,23,8,3
5475,21800556,Atlanta Hawks,Washington Wizards,98,114,212,16,Washington Wizards,16,0.323,0.615,50,26,5,6,0.379,0.739,48,29,10,2
5476,21800557,New Orleans Pelicans,Brooklyn Nets,121,126,247,5,Brooklyn Nets,5,0.435,0.704,41,19,7,5,0.516,0.762,43,27,7,5
5477,21800558,Minnesota Timberwolves,Boston Celtics,102,115,217,13,Boston Celtics,13,0.304,0.714,34,24,7,2,0.4,0.867,33,34,10,9
5478,21800559,Orlando Magic,Chicago Bulls,112,84,196,28,Orlando Magic,28,0.423,0.722,41,31,5,9,0.35,0.625,32,18,8,0
5479,21800560,Detroit Pistons,Memphis Grizzlies,101,94,195,7,Detroit Pistons,7,0.4,0.591,42,23,7,3,0.222,0.857,44,21,2,5
5480,21800561,Philadelphia 76ers,Phoenix Suns,132,127,259,5,Philadelphia 76ers,5,0.458,0.759,44,27,9,3,0.324,0.833,37,22,10,3
5481,21800562,Oklahoma City Thunder,Los Angeles Lakers,107,100,207,7,Oklahoma City Thunder,7,0.226,0.645,64,22,8,5,0.259,0.594,54,24,8,9
5482,21800563,Toronto Raptors,San Antonio Spurs,107,125,232,18,San Antonio Spurs,18,0.2,0.793,39,21,9,6,0.481,0.9,44,32,7,0
5483,21800564,Denver Nuggets,Sacramento Kings,117,113,230,4,Denver Nuggets,4,0.359,0.7,54,24,3,3,0.419,0.667,33,25,5,3
5484,21800565,Houston Rockets,Golden State Warriors,135,134,269,1,Houston Rockets,1,0.389,0.857,48,30,8,5,0.378,0.933,47,33,8,6
5485,21800566,Dallas Mavericks,Boston Celtics,93,114,207,21,Boston Celtics,21,0.25,0.737,49,16,9,2,0.467,0.818,53,35,12,4
5486,21800567,Utah Jazz,Cleveland Cavaliers,117,91,208,26,Utah Jazz,26,0.4,0.864,47,28,6,9,0.524,0.941,39,14,6,1
5487,21800568,Washington Wizards,Miami Heat,109,115,224,6,Miami Heat,6,0.278,0.789,41,24,8,2,0.31,0.72,48,28,7,6
5488,21800569,Indiana Pacers,Chicago Bulls,119,116,235,3,Indiana Pacers,3,0.321,0.706,40,25,7,3,0.429,0.769,40,30,10,2
5489,21800570,Brooklyn Nets,Memphis Grizzlies,109,100,209,9,Brooklyn Nets,9,0.382,0.923,45,25,6,2,0.208,0.733,40,23,9,5
5490,21800571,Orlando Magic,Minnesota Timberwolves,103,120,223,17,Minnesota Timberwolves,17,0.333,0.526,35,28,7,7,0.346,0.739,54,29,6,2
5491,21800572,Atlanta Hawks,Milwaukee Bucks,112,144,256,32,Milwaukee Bucks,32,0.341,0.686,31,26,11,3,0.35,0.714,54,36,11,8
5492,21800573,Los Angeles Clippers,Phoenix Suns,121,111,232,10,Los Angeles Clippers,10,0.417,0.781,43,31,12,7,0.474,0.741,25,24,13,9
5493,21800574,New York Knicks,Los Angeles Lakers,119,112,231,7,New York Knicks,7,0.297,0.829,56,20,12,4,0.297,0.75,55,23,4,7
5494,21800575,Oklahoma City Thunder,Portland Trail Blazers,111,109,220,2,Oklahoma City Thunder,2,0.32,0.885,49,18,9,6,0.29,0.857,50,30,6,5
5495,21800576,Charlotte Hornets,Denver Nuggets,110,123,233,13,Denver Nuggets,13,0.379,0.808,47,22,7,4,0.359,0.75,46,30,10,6
5496,21800577,Utah Jazz,Detroit Pistons,110,105,215,5,Utah Jazz,5,0.333,0.781,42,24,12,6,0.44,0.8,44,18,7,2
5497,21800578,Dallas Mavericks,Philadelphia 76ers,100,106,206,6,Philadelphia 76ers,6,0.29,0.652,49,27,4,3,0.231,0.667,49,31,7,5
5498,21800579,New Orleans Pelicans,Cleveland Cavaliers,133,98,231,35,New Orleans Pelicans,35,0.519,0.862,44,29,13,7,0.364,0.778,34,22,12,3
5499,21800580,Toronto Raptors,Milwaukee Bucks,123,116,239,7,Toronto Raptors,7,0.452,0.806,38,28,9,6,0.378,0.815,38,29,9,2
5500,21800581,Memphis Grizzlies,San Antonio Spurs,88,108,196,20,San Antonio Spurs,20,0.393,0.789,42,21,12,3,0.318,0.829,43,26,10,3
5501,21800582,Houston Rockets,Portland Trail Blazers,101,110,211,9,Portland Trail Blazers,9,0.342,0.833,40,13,6,5,0.321,0.75,47,27,7,2
5502,21800583,Golden State Warriors,Sacramento Kings,127,123,250,4,Golden State Warriors,4,0.447,0.857,47,29,5,8,0.556,0.786,43,34,12,0
5503,21800584,Brooklyn Nets,Chicago Bulls,117,100,217,17,Brooklyn Nets,17,0.348,0.773,38,29,6,3,0.389,0.733,44,20,6,4
5504,21800585,Los Angeles Lakers,Minnesota Timberwolves,86,108,194,22,Minnesota Timberwolves,22,0.227,0.607,48,20,6,4,0.344,0.714,50,24,10,9
5505,21800586,Orlando Magic,Los Angeles Clippers,96,106,202,10,Los Angeles Clippers,10,0.29,0.724,54,24,6,7,0.364,0.783,53,20,5,5
5506,21800587,Miami Heat,Atlanta Hawks,82,106,188,24,Atlanta Hawks,24,0.147,0.556,41,23,11,7,0.417,0.769,59,25,7,2
5507,21800588,Washington Wizards,Oklahoma City Thunder,116,98,214,18,Washington Wizards,18,0.27,0.818,55,25,8,8,0.4,0.632,41,22,8,3
5508,21800589,Indiana Pacers,Toronto Raptors,105,121,226,16,Toronto Raptors,16,0.235,0.75,44,24,8,4,0.515,0.941,41,30,9,4
5509,21800590,Charlotte Hornets,Phoenix Suns,119,113,232,6,Charlotte Hornets,6,0.28,0.706,46,22,9,1,0.4,0.895,36,23,8,4
5510,21800591,San Antonio Spurs,Detroit Pistons,119,107,226,12,San Antonio Spurs,12,0.35,0.813,38,24,5,5,0.281,0.824,37,22,5,2
5511,21800592,Brooklyn Nets,Boston Celtics,95,116,211,21,Boston Celtics,21,0.262,0.909,47,19,5,4,0.375,0.833,43,37,13,2
5512,21800593,Denver Nuggets,Houston Rockets,113,125,238,12,Houston Rockets,12,0.241,0.857,46,26,7,3,0.468,0.794,34,28,8,3
5513,21800594,Utah Jazz,Milwaukee Bucks,102,114,216,12,Milwaukee Bucks,12,0.378,0.696,46,20,6,6,0.36,0.813,46,27,10,6
5514,21800595,Memphis Grizzlies,New Orleans Pelicans,95,114,209,19,New Orleans Pelicans,19,0.333,0.833,36,28,5,7,0.353,0.69,40,27,13,4
5515,21800596,Los Angeles Lakers,Dallas Mavericks,107,97,204,10,Los Angeles Lakers,10,0.276,0.63,44,28,12,2,0.267,0.708,52,12,10,7
5516,21800597,New York Knicks,Portland Trail Blazers,101,111,212,10,Portland Trail Blazers,10,0.304,0.815,48,18,9,2,0.355,0.69,51,25,7,5
5517,21800598,Orlando Magic,Sacramento Kings,95,111,206,16,Sacramento Kings,16,0.351,0.75,46,15,8,1,0.294,0.55,57,24,11,4
5518,21800599,Indiana Pacers,Cleveland Cavaliers,123,115,238,8,Indiana Pacers,8,0.385,0.789,32,34,11,0,0.448,0.87,35,24,4,3
5519,21800600,Washington Wizards,Philadelphia 76ers,115,132,247,17,Philadelphia 76ers,17,0.438,0.81,34,26,14,3,0.515,0.68,49,39,10,2
5520,21800601,Denver Nuggets,Miami Heat,103,99,202,4,Denver Nuggets,4,0.333,0.706,50,32,2,2,0.258,0.6,38,24,9,8
5521,21800602,Atlanta Hawks,Toronto Raptors,101,104,205,3,Toronto Raptors,3,0.37,0.688,50,22,12,2,0.313,0.741,39,26,18,7
5522,21800603,Minnesota Timberwolves,Oklahoma City Thunder,119,117,236,2,Minnesota Timberwolves,2,0.355,0.8,42,25,9,4,0.4,0.731,43,22,4,5
5523,21800604,Sacramento Kings,Phoenix Suns,111,115,226,4,Phoenix Suns,4,0.517,0.69,43,26,11,5,0.4,0.789,37,31,18,7
5524,21800605,New York Knicks,Golden State Warriors,95,122,217,27,Golden State Warriors,27,0.25,0.905,39,13,11,1,0.311,0.833,49,36,9,10
5525,21800606,Charlotte Hornets,Los Angeles Clippers,109,128,237,19,Los Angeles Clippers,19,0.364,0.862,43,20,5,5,0.467,0.857,45,28,6,11
5526,21800607,Indiana Pacers,Boston Celtics,108,135,243,27,Boston Celtics,27,0.321,0.636,39,26,6,0,0.438,0.875,48,32,7,7
5527,21800608,Philadelphia 76ers,Washington Wizards,106,123,229,17,Washington Wizards,17,0.296,0.774,46,23,12,3,0.481,0.762,39,26,16,2
5528,21800609,Atlanta Hawks,Brooklyn Nets,100,116,216,16,Brooklyn Nets,16,0.171,0.88,52,17,8,6,0.333,0.769,54,21,10,9
5529,21800610,Milwaukee Bucks,Houston Rockets,116,109,225,7,Milwaukee Bucks,7,0.296,0.833,49,26,11,5,0.375,0.844,46,19,4,7
5530,21800611,San Antonio Spurs,Memphis Grizzlies,86,96,182,10,Memphis Grizzlies,10,0.407,0.652,53,14,4,2,0.242,0.7,52,22,6,8
5531,21800612,Cleveland Cavaliers,New Orleans Pelicans,124,140,264,16,New Orleans Pelicans,16,0.467,0.867,31,27,7,3,0.414,0.923,44,33,7,7
5532,21800613,Phoenix Suns,Dallas Mavericks,94,104,198,10,Dallas Mavericks,10,0.28,0.714,37,22,10,8,0.353,0.711,42,21,7,5
5533,21800614,Orlando Magic,Utah Jazz,93,106,199,13,Utah Jazz,13,0.394,0.7,41,17,6,4,0.364,0.857,44,24,5,3
5534,21800615,Chicago Bulls,Portland Trail Blazers,112,124,236,12,Portland Trail Blazers,12,0.409,0.895,37,22,5,3,0.423,0.905,43,28,6,7
5535,21800616,Detroit Pistons,Los Angeles Lakers,100,113,213,13,Los Angeles Lakers,13,0.318,0.571,33,23,8,2,0.348,0.722,47,30,5,6
5536,21800617,Boston Celtics,Miami Heat,99,115,214,16,Miami Heat,16,0.353,0.882,37,20,5,8,0.462,0.625,51,33,7,4
5537,21800618,Los Angeles Clippers,Denver Nuggets,100,121,221,21,Denver Nuggets,21,0.25,0.692,38,21,4,6,0.393,0.769,53,29,7,8
5538,21800619,Oklahoma City Thunder,San Antonio Spurs,147,154,301,7,San Antonio Spurs,7,0.429,0.667,49,33,8,5,0.842,0.897,43,38,8,10
5539,21800620,Detroit Pistons,Sacramento Kings,102,112,214,10,Sacramento Kings,10,0.289,0.875,37,22,13,3,0.409,0.75,47,29,7,8
5540,21800621,Atlanta Hawks,Philadelphia 76ers,123,121,244,2,Atlanta Hawks,2,0.48,0.778,44,27,7,4,0.333,0.741,30,31,13,4
5541,21800622,Milwaukee Bucks,Washington Wizards,106,113,219,7,Washington Wizards,7,0.325,0.765,43,26,8,6,0.545,0.75,43,28,10,3
5542,21800623,Indiana Pacers,New York Knicks,121,106,227,15,Indiana Pacers,15,0.462,1,47,30,8,1,0.359,0.875,37,22,8,5
5543,21800624,Brooklyn Nets,Toronto Raptors,105,122,227,17,Toronto Raptors,17,0.367,0.667,54,20,4,4,0.314,0.625,55,32,10,4
5544,21800625,Cleveland Cavaliers,Houston Rockets,113,141,254,28,Houston Rockets,28,0.273,0.923,39,24,12,4,0.385,0.906,45,28,8,9
5545,21800626,Dallas Mavericks,Minnesota Timberwolves,119,115,234,4,Dallas Mavericks,4,0.342,0.75,43,25,7,7,0.417,0.846,53,27,5,10
5546,21800627,Los Angeles Lakers,Utah Jazz,95,113,208,18,Utah Jazz,18,0.185,0.667,55,14,9,5,0.357,0.688,65,24,9,9
5547,21800628,Charlotte Hornets,Portland Trail Blazers,96,127,223,31,Portland Trail Blazers,31,0.433,0.688,43,23,3,2,0.375,0.889,47,31,10,16
5548,21800629,Chicago Bulls,Golden State Warriors,109,146,255,37,Golden State Warriors,37,0.45,0.882,29,16,9,1,0.462,0.846,49,38,6,8
5549,21800630,Detroit Pistons,Los Angeles Clippers,109,104,213,5,Detroit Pistons,5,0.432,0.864,48,20,12,5,0.5,0.793,38,25,7,5
5550,21800631,Memphis Grizzlies,Miami Heat,108,112,220,4,Miami Heat,4,0.31,0.778,38,18,9,6,0.484,0.708,38,25,7,4
5551,21800632,Boston Celtics,Orlando Magic,103,105,208,2,Orlando Magic,2,0.25,0.679,46,19,7,3,0.289,0.917,50,21,2,5
5552,21800633,New Orleans Pelicans,Minnesota Timberwolves,106,110,216,4,Minnesota Timberwolves,4,0.208,0.875,48,22,7,8,0.282,0.792,50,23,7,5
5553,21800634,San Antonio Spurs,Oklahoma City Thunder,112,122,234,10,Oklahoma City Thunder,10,0.323,0.7,52,21,5,7,0.478,0.862,47,27,10,5
5554,21800635,Denver Nuggets,Phoenix Suns,93,102,195,9,Phoenix Suns,9,0.323,0.682,50,25,7,6,0.308,0.72,49,29,11,9
5555,21800636,Charlotte Hornets,Sacramento Kings,97,104,201,7,Sacramento Kings,7,0.333,0.591,56,21,6,11,0.378,0.667,49,27,8,5
5556,21800637,Chicago Bulls,Utah Jazz,102,110,212,8,Utah Jazz,8,0.28,0.882,47,24,8,7,0.356,0.72,52,23,6,11
5557,21800638,Philadelphia 76ers,New York Knicks,108,105,213,3,Philadelphia 76ers,3,0.3,0.733,56,22,4,9,0.323,0.7,34,24,8,5
5558,21800639,Toronto Raptors,Washington Wizards,140,138,278,2,Toronto Raptors,2,0.361,0.806,59,24,16,8,0.432,0.611,51,36,11,7
5559,21800640,Milwaukee Bucks,Atlanta Hawks,133,114,247,19,Milwaukee Bucks,19,0.367,0.727,39,28,13,4,0.316,0.8,54,19,3,5
5560,21800641,Houston Rockets,Orlando Magic,109,116,225,7,Orlando Magic,7,0.238,0.852,38,20,7,1,0.375,0.893,45,25,6,2
5561,21800642,Golden State Warriors,Dallas Mavericks,119,114,233,5,Golden State Warriors,5,0.422,0.833,49,26,9,8,0.421,0.759,51,21,5,4
5562,21800643,Portland Trail Blazers,Denver Nuggets,113,116,229,3,Denver Nuggets,3,0.353,0.955,39,25,5,1,0.409,0.85,35,21,5,0
5563,21800644,Cleveland Cavaliers,Los Angeles Lakers,101,95,196,6,Cleveland Cavaliers,6,0.381,0.739,52,18,5,2,0.206,0.593,51,21,4,5
5564,21800645,Boston Celtics,Brooklyn Nets,102,109,211,7,Brooklyn Nets,7,0.306,0.739,41,21,10,8,0.342,0.88,55,18,5,7
5565,21800646,Memphis Grizzlies,Houston Rockets,94,112,206,18,Houston Rockets,18,0.455,0.545,43,31,5,5,0.375,0.909,36,17,12,3
5566,21800647,Charlotte Hornets,San Antonio Spurs,108,93,201,15,Charlotte Hornets,15,0.361,0.818,45,24,7,4,0.35,0.833,36,21,4,6
5567,21800648,Detroit Pistons,Utah Jazz,94,100,194,6,Utah Jazz,6,0.306,0.813,38,16,13,4,0.324,0.722,55,20,5,3
5568,21800649,Portland Trail Blazers,Sacramento Kings,107,115,222,8,Sacramento Kings,8,0.323,0.793,49,22,6,3,0.385,0.792,48,24,6,6
5569,21800650,New Orleans Pelicans,Los Angeles Clippers,121,117,238,4,New Orleans Pelicans,4,0.32,0.75,49,28,8,7,0.5,0.708,50,34,4,7
5570,21800651,Phoenix Suns,Indiana Pacers,97,131,228,34,Indiana Pacers,34,0.296,0.5,43,26,8,6,0.48,0.75,52,31,11,7
5571,21800652,Minnesota Timberwolves,Philadelphia 76ers,107,149,256,42,Philadelphia 76ers,42,0.348,0.829,34,18,10,2,0.488,0.857,54,40,6,11
5572,21800653,Oklahoma City Thunder,Atlanta Hawks,126,142,268,16,Atlanta Hawks,16,0.281,0.756,40,22,16,3,0.486,0.75,44,36,8,4
5573,21800654,Miami Heat,Milwaukee Bucks,86,124,210,38,Milwaukee Bucks,38,0.235,0.75,43,27,2,6,0.436,0.611,53,35,8,6
5574,21800655,Golden State Warriors,Denver Nuggets,142,111,253,31,Golden State Warriors,31,0.538,0.7,50,38,6,4,0.412,0.813,36,30,4,3
5575,21800656,Chicago Bulls,Los Angeles Lakers,100,107,207,7,Los Angeles Lakers,7,0.29,0.708,46,21,11,6,0.308,0.676,51,21,7,4
5576,21800657,Orlando Magic,Detroit Pistons,115,120,235,5,Detroit Pistons,5,0.359,0.538,37,29,6,3,0.4,0.8,47,26,4,4
5577,21800658,Toronto Raptors,Boston Celtics,108,117,225,9,Boston Celtics,9,0.241,0.905,42,20,9,2,0.467,0.846,49,32,7,6
5578,21800659,Brooklyn Nets,Houston Rockets,145,142,287,3,Brooklyn Nets,3,0.444,0.773,57,29,4,3,0.329,0.853,47,18,7,8
5579,21800660,Milwaukee Bucks,Memphis Grizzlies,111,101,212,10,Milwaukee Bucks,10,0.353,0.864,50,27,9,8,0.323,0.68,48,29,11,9
5580,21800661,San Antonio Spurs,Dallas Mavericks,105,101,206,4,San Antonio Spurs,4,0.433,0.833,36,26,9,6,0.357,0.75,42,22,6,3
5581,21800662,Cleveland Cavaliers,Portland Trail Blazers,112,129,241,17,Portland Trail Blazers,17,0.316,0.842,41,17,0,5,0.552,0.826,41,28,1,6
5582,21800663,New Orleans Pelicans,Golden State Warriors,140,147,287,7,Golden State Warriors,7,0.514,0.818,49,36,6,5,0.49,0.806,57,33,8,5
5583,21800664,Utah Jazz,Los Angeles Clippers,129,109,238,20,Utah Jazz,20,0.333,0.811,48,27,9,7,0.455,0.643,41,24,8,1
5584,21800665,New York Knicks,Washington Wizards,100,101,201,1,Washington Wizards,1,0.414,0.833,42,15,6,3,0.259,0.7,51,23,9,2
5585,21800666,Sacramento Kings,Charlotte Hornets,95,114,209,19,Charlotte Hornets,19,0.333,0.462,42,28,7,3,0.289,0.862,46,21,11,4
5586,21800667,Philadelphia 76ers,Indiana Pacers,120,96,216,24,Philadelphia 76ers,24,0.529,0.909,51,38,8,6,0.31,0.75,40,23,9,3
5587,21800668,Phoenix Suns,Toronto Raptors,109,111,220,2,Toronto Raptors,2,0.3,0.778,46,18,9,8,0.25,0.72,39,27,8,8
5588,21800669,Chicago Bulls,Denver Nuggets,105,135,240,30,Denver Nuggets,30,0.357,0.636,45,27,3,3,0.5,0.75,45,34,6,2
5589,21800670,Los Angeles Lakers,Oklahoma City Thunder,138,128,266,10,Los Angeles Lakers,10,0.475,0.905,63,37,11,5,0.407,0.667,44,31,10,4
5590,21800671,Memphis Grizzlies,Boston Celtics,116,122,238,6,Boston Celtics,6,0.457,0.9,39,33,11,5,0.447,0.773,52,29,5,9
5591,21800672,Miami Heat,Detroit Pistons,93,98,191,5,Detroit Pistons,5,0.345,0.263,45,25,3,6,0.394,0.833,42,23,7,2
5592,21800673,Brooklyn Nets,Orlando Magic,117,115,232,2,Brooklyn Nets,2,0.413,0.667,41,24,5,5,0.385,0.786,49,26,5,6
5593,21800674,San Antonio Spurs,Minnesota Timberwolves,116,113,229,3,San Antonio Spurs,3,0.458,0.793,41,24,3,4,0.269,0.842,44,21,5,3
5594,21800675,Cleveland Cavaliers,Utah Jazz,99,115,214,16,Utah Jazz,16,0.292,0.769,37,16,9,3,0.351,0.933,48,33,6,5
5595,21800676,Golden State Warriors,Los Angeles Clippers,112,94,206,18,Golden State Warriors,18,0.243,0.704,43,31,11,8,0.16,0.8,52,11,6,4
5596,21800677,New Orleans Pelicans,Portland Trail Blazers,112,128,240,16,Portland Trail Blazers,16,0.32,0.815,41,23,4,6,0.324,0.808,53,30,8,3
5597,21800678,Oklahoma City Thunder,Philadelphia 76ers,117,115,232,2,Oklahoma City Thunder,2,0.387,0.885,45,20,10,6,0.344,0.718,47,28,6,7
5598,21800679,Phoenix Suns,Charlotte Hornets,115,135,250,20,Charlotte Hornets,20,0.333,0.788,26,21,7,7,0.471,0.852,53,31,5,8
5599,21800680,Sacramento Kings,Detroit Pistons,103,101,204,2,Sacramento Kings,2,0.4,0.722,39,30,5,5,0.345,0.76,46,21,6,2
5600,21800681,Dallas Mavericks,Indiana Pacers,99,111,210,12,Indiana Pacers,12,0.243,0.8,44,21,5,4,0.333,0.792,45,23,6,4
5601,21800682,Milwaukee Bucks,Orlando Magic,118,108,226,10,Milwaukee Bucks,10,0.4,0.8,46,22,7,7,0.438,0.667,32,31,5,3
5602,21800683,Boston Celtics,Atlanta Hawks,113,105,218,8,Boston Celtics,8,0.375,0.92,43,19,10,8,0.293,0.929,49,28,8,6
5603,21800684,Memphis Grizzlies,Toronto Raptors,90,119,209,29,Toronto Raptors,29,0.345,0.8,42,21,7,3,0.472,0.875,37,31,19,8
5604,21800685,Miami Heat,Chicago Bulls,117,103,220,14,Miami Heat,14,0.406,0.609,46,27,5,6,0.444,0.808,43,19,9,1
5605,21800686,Los Angeles Lakers,Houston Rockets,134,138,272,4,Houston Rockets,4,0.27,0.8,56,27,6,4,0.368,0.806,39,23,9,4
5606,21800687,Cleveland Cavaliers,Denver Nuggets,102,124,226,22,Denver Nuggets,22,0.345,0.846,28,20,5,1,0.405,0.818,43,33,7,2
5607,21800688,Charlotte Hornets,Indiana Pacers,95,120,215,25,Indiana Pacers,25,0.343,0.68,44,20,5,6,0.519,1,51,34,10,7
5608,21800689,Phoenix Suns,Minnesota Timberwolves,114,116,230,2,Minnesota Timberwolves,2,0.308,0.688,38,22,9,5,0.25,0.8,45,22,8,4
5609,21800690,Los Angeles Clippers,San Antonio Spurs,103,95,198,8,Los Angeles Clippers,8,0.524,0.583,41,23,11,2,0.421,0.529,51,21,6,8
5610,21800691,Oklahoma City Thunder,New York Knicks,127,109,236,18,Oklahoma City Thunder,18,0.517,0.815,49,26,7,2,0.304,0.75,36,25,8,3
5611,21800692,Chicago Bulls,Cleveland Cavaliers,104,88,192,16,Chicago Bulls,16,0.5,0.773,50,24,8,2,0.222,0.69,38,16,8,4
5612,21800693,Detroit Pistons,Washington Wizards,87,101,188,14,Washington Wizards,14,0.324,0.778,40,22,5,3,0.348,0.778,45,24,7,6
5613,21800694,Dallas Mavericks,Milwaukee Bucks,106,116,222,10,Milwaukee Bucks,10,0.35,0.588,48,24,7,11,0.375,0.909,51,21,9,7
5614,21800695,Orlando Magic,Atlanta Hawks,122,103,225,19,Orlando Magic,19,0.379,0.905,45,29,8,8,0.3,0.696,44,23,5,3
5615,21800696,Sacramento Kings,Brooklyn Nets,94,123,217,29,Brooklyn Nets,29,0.4,0.545,37,26,8,4,0.371,0.833,56,25,9,4
5616,21800697,New Orleans Pelicans,Memphis Grizzlies,105,85,190,20,New Orleans Pelicans,20,0.346,0.692,50,19,8,7,0.257,0.588,35,21,10,1
5617,21800698,Miami Heat,Boston Celtics,99,107,206,8,Boston Celtics,8,0.314,0.889,38,25,11,5,0.4,0.9,36,26,13,7
5618,21800699,Houston Rockets,Philadelphia 76ers,93,121,214,28,Philadelphia 76ers,28,0.262,0.769,38,14,9,6,0.348,0.818,55,21,9,14
5619,21800700,Portland Trail Blazers,Utah Jazz,109,104,213,5,Portland Trail Blazers,5,0.444,0.733,44,30,6,9,0.212,0.806,48,21,5,8
5620,21800701,Golden State Warriors,Los Angeles Lakers,130,111,241,19,Golden State Warriors,19,0.432,0.737,50,41,8,6,0.25,0.579,42,20,1,4
5621,21800702,Sacramento Kings,Toronto Raptors,105,120,225,15,Toronto Raptors,15,0.333,0.727,43,29,8,7,0.4,0.686,46,25,7,5
5622,21800703,Portland Trail Blazers,Oklahoma City Thunder,114,123,237,9,Oklahoma City Thunder,9,0.278,0.818,52,21,7,3,0.478,0.788,37,26,16,4
5623,21800704,Los Angeles Clippers,Dallas Mavericks,98,106,204,8,Dallas Mavericks,8,0.278,0.759,41,19,4,4,0.294,0.69,48,21,5,6
5624,21800705,Minnesota Timberwolves,Phoenix Suns,118,91,209,27,Minnesota Timberwolves,27,0.357,0.684,64,30,7,1,0.206,0.556,34,23,6,9
5625,21800706,Toronto Raptors,Indiana Pacers,106,110,216,4,Indiana Pacers,4,0.308,0.783,45,28,2,5,0.346,0.84,48,27,6,7
5626,21800707,Cleveland Cavaliers,Boston Celtics,103,123,226,20,Boston Celtics,20,0.433,0.7,44,20,4,4,0.48,0.913,43,25,12,5
5627,21800708,Orlando Magic,Brooklyn Nets,110,114,224,4,Brooklyn Nets,4,0.324,0.821,42,22,7,11,0.313,0.783,45,20,7,2
5628,21800709,Los Angeles Clippers,Miami Heat,111,99,210,12,Los Angeles Clippers,12,0.318,0.667,41,23,5,3,0.286,0.591,40,23,3,3
5629,21800710,Houston Rockets,New York Knicks,114,110,224,4,Houston Rockets,4,0.25,0.763,44,10,15,10,0.367,0.833,48,15,5,7
5630,21800711,San Antonio Spurs,Philadelphia 76ers,120,122,242,2,Philadelphia 76ers,2,0.481,0.867,36,24,8,6,0.472,0.786,42,35,9,5
5631,21800712,Atlanta Hawks,Chicago Bulls,121,101,222,20,Atlanta Hawks,20,0.375,0.762,51,31,11,2,0.308,0.852,37,20,7,6
5632,21800713,Charlotte Hornets,Memphis Grizzlies,118,107,225,11,Charlotte Hornets,11,0.4,0.774,37,23,8,2,0.29,0.917,38,25,8,3
5633,21800714,Detroit Pistons,New Orleans Pelicans,98,94,192,4,Detroit Pistons,4,0.333,0.684,49,24,5,3,0.273,0.444,49,20,3,9
5634,21800715,Denver Nuggets,Utah Jazz,108,114,222,6,Utah Jazz,6,0.296,0.8,50,20,7,9,0.413,0.704,40,28,7,7
5635,21800716,Golden State Warriors,Washington Wizards,126,118,244,8,Golden State Warriors,8,0.35,0.905,50,34,5,6,0.357,0.714,36,29,7,2
5636,21800717,New Orleans Pelicans,Oklahoma City Thunder,116,122,238,6,Oklahoma City Thunder,6,0.278,0.667,42,34,7,6,0.438,0.5,57,33,8,2
5637,21800718,Portland Trail Blazers,Phoenix Suns,120,106,226,14,Portland Trail Blazers,14,0.462,1,53,25,8,8,0.342,0.778,39,19,9,4
5638,21800719,Minnesota Timberwolves,Los Angeles Lakers,120,105,225,15,Minnesota Timberwolves,15,0.303,0.88,55,24,8,3,0.286,0.643,39,28,5,5
5639,21800720,Washington Wizards,Orlando Magic,95,91,186,4,Washington Wizards,4,0.556,0.833,38,26,9,1,0.212,0.667,52,24,3,4
5640,21800721,New York Knicks,Brooklyn Nets,99,109,208,10,Brooklyn Nets,10,0.258,0.654,33,17,12,11,0.273,0.681,60,19,5,2
5641,21800722,Miami Heat,Cleveland Cavaliers,100,94,194,6,Miami Heat,6,0.391,0.68,47,19,6,4,0.333,0.769,42,23,8,2
5642,21800723,Los Angeles Clippers,Chicago Bulls,106,101,207,5,Los Angeles Clippers,5,0.381,0.759,50,27,3,4,0.286,0.917,49,20,11,5
5643,21800724,Toronto Raptors,Houston Rockets,119,121,240,2,Houston Rockets,2,0.389,0.944,47,27,4,1,0.217,0.879,40,17,11,5
5644,21800725,Sacramento Kings,Memphis Grizzlies,99,96,195,3,Sacramento Kings,3,0.364,0.765,49,23,11,5,0.3,0.815,44,22,13,5
5645,21800726,Detroit Pistons,Dallas Mavericks,101,106,207,5,Dallas Mavericks,5,0.316,0.76,46,22,6,0,0.389,0.6,43,24,8,6
5646,21800727,Charlotte Hornets,Milwaukee Bucks,99,108,207,9,Milwaukee Bucks,9,0.256,0.68,53,20,4,2,0.194,0.87,46,17,9,6
5647,21800728,Phoenix Suns,Denver Nuggets,95,132,227,37,Denver Nuggets,37,0.233,0.923,35,20,4,7,0.417,0.793,57,26,9,1
5648,21800729,Minnesota Timberwolves,Utah Jazz,102,106,208,4,Utah Jazz,4,0.308,0.857,50,20,5,5,0.325,0.76,47,25,9,8
5649,21800730,San Antonio Spurs,New Orleans Pelicans,126,114,240,12,San Antonio Spurs,12,0.458,0.84,51,30,5,3,0.259,0.708,41,26,6,6
5650,21800731,Indiana Pacers,Memphis Grizzlies,103,106,209,3,Memphis Grizzlies,3,0.333,0.833,40,20,7,5,0.321,0.679,36,29,8,5
5651,21800732,Golden State Warriors,Boston Celtics,115,111,226,4,Golden State Warriors,4,0.364,0.853,53,25,8,7,0.375,0.933,49,23,6,4
5652,21800733,Philadelphia 76ers,Denver Nuggets,110,126,236,16,Denver Nuggets,16,0.389,0.741,41,29,7,2,0.333,0.759,51,27,4,4
5653,21800734,Atlanta Hawks,Portland Trail Blazers,111,120,231,9,Portland Trail Blazers,9,0.364,0.75,36,24,9,7,0.367,0.9,47,26,8,7
5654,21800735,Cleveland Cavaliers,Chicago Bulls,104,101,205,3,Cleveland Cavaliers,3,0.382,0.867,52,26,5,3,0.346,0.824,47,22,5,8
5655,21800736,Sacramento Kings,Los Angeles Clippers,108,122,230,14,Los Angeles Clippers,14,0.222,0.867,44,18,12,6,0.379,0.931,52,35,6,1
5656,21800737,Orlando Magic,Houston Rockets,98,103,201,5,Houston Rockets,5,0.286,0.588,56,23,10,4,0.333,0.714,39,20,8,7
5657,21800738,Milwaukee Bucks,Oklahoma City Thunder,112,118,230,6,Oklahoma City Thunder,6,0.405,0.679,49,22,6,5,0.5,0.56,52,29,5,10
5658,21800739,Toronto Raptors,Dallas Mavericks,123,120,243,3,Toronto Raptors,3,0.5,0.842,44,24,6,5,0.306,0.676,43,25,5,2
5659,21800740,Utah Jazz,Minnesota Timberwolves,125,111,236,14,Utah Jazz,14,0.385,0.72,36,30,8,5,0.472,0.87,35,22,7,4
5660,21800741,Miami Heat,New York Knicks,106,97,203,9,Miami Heat,9,0.364,0.889,47,26,6,5,0.269,0.75,38,22,13,3
5661,21800742,Washington Wizards,San Antonio Spurs,119,132,251,13,San Antonio Spurs,13,0.391,0.724,32,32,11,0,0.471,0.857,49,31,6,4
5662,21800743,Phoenix Suns,Los Angeles Lakers,102,116,218,14,Los Angeles Lakers,14,0.269,0.844,40,19,8,9,0.435,0.667,41,28,8,10
5663,21800744,New York Knicks,Charlotte Hornets,92,101,193,9,Charlotte Hornets,9,0.304,0.654,46,19,6,6,0.324,0.75,51,25,4,10
5664,21800745,Golden State Warriors,Indiana Pacers,132,100,232,32,Golden State Warriors,32,0.419,0.813,48,39,9,7,0.4,0.8,38,29,4,5
5665,21800746,Brooklyn Nets,Boston Celtics,104,112,216,8,Boston Celtics,8,0.382,0.813,48,20,10,5,0.325,0.9,52,29,11,16
5666,21800747,Denver Nuggets,Memphis Grizzlies,95,92,187,3,Denver Nuggets,3,0.222,0.929,37,17,10,2,0.281,0.684,42,26,5,7
5667,21800748,Atlanta Hawks,Los Angeles Clippers,123,118,241,5,Atlanta Hawks,5,0.294,0.862,44,28,7,6,0.37,0.929,38,27,10,4
5668,21800749,Washington Wizards,Cleveland Cavaliers,113,116,229,3,Cleveland Cavaliers,3,0.333,0.739,36,31,8,1,0.441,0.458,48,30,3,2
5669,21800750,Milwaukee Bucks,Detroit Pistons,115,105,220,10,Milwaukee Bucks,10,0.406,0.8,39,32,9,6,0.324,0.75,39,29,8,3
5670,21800751,Oklahoma City Thunder,Orlando Magic,126,117,243,9,Oklahoma City Thunder,9,0.429,0.731,43,25,7,8,0.341,0.833,53,26,4,5
5671,21800752,Chicago Bulls,Brooklyn Nets,117,122,239,5,Brooklyn Nets,5,0.321,0.737,50,17,6,8,0.286,0.7,43,25,11,2
5672,21800753,New Orleans Pelicans,Houston Rockets,121,116,237,5,New Orleans Pelicans,5,0.29,0.8,55,27,8,9,0.339,0.708,45,22,11,5
5673,21800754,Phoenix Suns,San Antonio Spurs,124,126,250,2,San Antonio Spurs,2,0.448,0.789,38,26,8,5,0.441,0.85,36,29,9,4
5674,21800755,Philadelphia 76ers,Los Angeles Lakers,121,105,226,16,Philadelphia 76ers,16,0.417,0.786,44,33,15,6,0.304,0.75,49,26,7,4
5675,21800756,Charlotte Hornets,Boston Celtics,94,126,220,32,Boston Celtics,32,0.325,0.429,31,20,7,5,0.414,0.875,53,34,10,7
5676,21800757,Chicago Bulls,Miami Heat,105,89,194,16,Chicago Bulls,16,0.421,0.81,40,26,6,3,0.286,0.692,47,22,6,2
5677,21800758,Dallas Mavericks,New York Knicks,114,90,204,24,Dallas Mavericks,24,0.395,0.818,49,31,4,1,0.231,0.714,34,16,10,5
5678,21800759,Indiana Pacers,Washington Wizards,89,107,196,18,Washington Wizards,18,0.29,0.778,39,27,6,3,0.429,0.619,41,27,8,4
5679,21800760,Memphis Grizzlies,Minnesota Timberwolves,97,99,196,2,Minnesota Timberwolves,2,0.261,0.864,51,21,3,7,0.229,0.773,41,25,12,3
5680,21800761,Denver Nuggets,New Orleans Pelicans,105,99,204,6,Denver Nuggets,6,0.3,0.632,43,31,10,7,0.417,0.769,48,27,4,4
5681,21800762,Atlanta Hawks,Sacramento Kings,113,135,248,22,Sacramento Kings,22,0.348,0.84,36,24,7,3,0.314,0.762,53,36,7,2
5682,21800763,Utah Jazz,Portland Trail Blazers,105,132,237,27,Portland Trail Blazers,27,0.324,0.857,36,24,9,4,0.5,0.87,46,28,7,5
5683,21800764,Dallas Mavericks,Detroit Pistons,89,93,182,4,Detroit Pistons,4,0.28,0.714,44,18,2,5,0.273,0.783,52,21,5,5
5684,21800765,Indiana Pacers,Orlando Magic,100,107,207,7,Orlando Magic,7,0.211,0.875,42,26,8,2,0.44,0.909,48,25,4,5
5685,21800766,Milwaukee Bucks,Toronto Raptors,105,92,197,13,Milwaukee Bucks,13,0.368,0.765,50,21,13,6,0.259,0.846,39,16,9,4
5686,21800767,Brooklyn Nets,San Antonio Spurs,114,117,231,3,San Antonio Spurs,3,0.324,0.655,46,30,5,7,0.364,0.862,50,23,6,3
5687,21800768,Philadelphia 76ers,Golden State Warriors,113,104,217,9,Philadelphia 76ers,9,0.324,0.792,49,30,11,5,0.289,0.688,37,30,13,7
5688,21800769,Los Angeles Lakers,Los Angeles Clippers,123,120,243,3,Los Angeles Lakers,3,0.423,0.8,56,28,7,4,0.326,0.538,51,26,11,8
5689,21800770,Memphis Grizzlies,Charlotte Hornets,92,100,192,8,Charlotte Hornets,8,0.31,0.765,40,23,8,3,0.414,0.857,40,15,6,7
5690,21800771,Boston Celtics,New York Knicks,113,99,212,14,Boston Celtics,14,0.351,0.8,43,25,11,7,0.29,1,48,21,2,2
5691,21800772,Oklahoma City Thunder,Miami Heat,118,102,220,16,Oklahoma City Thunder,16,0.533,0.737,50,23,10,4,0.306,0.643,47,28,7,2
5692,21800773,Atlanta Hawks,Utah Jazz,112,128,240,16,Utah Jazz,16,0.304,0.833,40,23,11,4,0.343,0.8,51,31,4,6
5693,21800774,Houston Rockets,Denver Nuggets,122,136,258,14,Denver Nuggets,14,0.364,0.762,30,23,6,3,0.452,0.87,36,37,7,4
5694,21800775,Los Angeles Clippers,Detroit Pistons,111,101,212,10,Los Angeles Clippers,10,0.5,0.618,47,22,5,4,0.405,0.7,38,21,6,4
5695,21800776,Chicago Bulls,Charlotte Hornets,118,125,243,7,Charlotte Hornets,7,0.375,1,39,20,4,2,0.438,0.862,36,25,6,2
5696,21800777,Brooklyn Nets,Orlando Magic,89,102,191,13,Orlando Magic,13,0.263,0.813,50,23,6,2,0.37,0.833,49,25,11,8
5697,21800778,Milwaukee Bucks,Washington Wizards,131,115,246,16,Milwaukee Bucks,16,0.436,1,46,30,10,4,0.303,0.731,46,28,6,6
5698,21800779,New Orleans Pelicans,San Antonio Spurs,108,113,221,5,San Antonio Spurs,5,0.286,1,42,26,6,4,0.391,0.889,50,29,5,2
5699,21800780,Dallas Mavericks,Cleveland Cavaliers,111,98,209,13,Dallas Mavericks,13,0.41,0.789,50,20,2,4,0.174,0.788,44,20,7,2
5700,21800781,Indiana Pacers,Miami Heat,95,88,183,7,Indiana Pacers,7,0.292,0.706,43,26,15,4,0.3,0.731,43,21,8,4
5701,21800782,Los Angeles Lakers,Golden State Warriors,101,115,216,14,Golden State Warriors,14,0.259,0.588,49,23,5,4,0.324,0.947,44,31,4,9
5702,21800783,Denver Nuggets,Minnesota Timberwolves,107,106,213,1,Denver Nuggets,1,0.394,0.714,48,29,3,7,0.324,0.688,41,27,6,4
5703,21800784,Atlanta Hawks,Phoenix Suns,118,112,230,6,Atlanta Hawks,6,0.438,0.692,53,21,6,5,0.375,0.556,37,31,15,5
5704,21800785,Philadelphia 76ers,Sacramento Kings,108,115,223,7,Sacramento Kings,7,0.212,0.76,46,19,9,5,0.367,0.833,50,22,9,2
5705,21800786,Houston Rockets,Utah Jazz,125,98,223,27,Houston Rockets,27,0.385,0.811,48,17,15,8,0.268,0.694,51,19,8,9
5706,21800787,Memphis Grizzlies,New York Knicks,96,84,180,12,Memphis Grizzlies,12,0.346,0.722,49,25,8,4,0.3,0.727,45,20,4,6
5707,21800788,Oklahoma City Thunder,Boston Celtics,129,134,263,5,Boston Celtics,5,0.4,0.735,42,25,12,5,0.382,0.765,38,36,8,6
5708,21800789,Los Angeles Clippers,Toronto Raptors,103,121,224,18,Toronto Raptors,18,0.167,0.862,36,15,7,7,0.273,0.839,56,21,10,5
5709,21800790,Denver Nuggets,Detroit Pistons,103,129,232,26,Detroit Pistons,26,0.321,0.545,32,28,10,3,0.432,0.85,53,32,8,8
5710,21800791,Atlanta Hawks,Washington Wizards,137,129,266,8,Atlanta Hawks,8,0.5,0.862,50,29,7,2,0.316,0.724,40,34,5,8
5711,21800792,Milwaukee Bucks,Brooklyn Nets,113,94,207,19,Milwaukee Bucks,19,0.256,0.68,59,29,9,7,0.119,0.821,56,23,5,9
5712,21800793,Indiana Pacers,New Orleans Pelicans,109,107,216,2,Indiana Pacers,2,0.357,0.708,43,25,5,3,0.237,0.833,55,26,6,4
5713,21800794,Houston Rockets,Phoenix Suns,118,110,228,8,Houston Rockets,8,0.317,0.76,43,19,13,2,0.28,0.722,38,29,9,1
5714,21800795,San Antonio Spurs,Sacramento Kings,112,127,239,15,Sacramento Kings,15,0.281,0.905,46,18,6,3,0.406,0.609,48,26,5,5
5715,21800796,Los Angeles Clippers,Charlotte Hornets,117,115,232,2,Los Angeles Clippers,2,0.75,0.882,48,25,1,6,0.357,0.846,44,19,8,9
5716,21800797,Boston Celtics,Cleveland Cavaliers,103,96,199,7,Boston Celtics,7,0.346,1,42,29,10,10,0.273,0.875,47,21,6,0
5717,21800798,Los Angeles Lakers,Indiana Pacers,94,136,230,42,Indiana Pacers,42,0.19,0.769,34,25,5,3,0.559,0.625,40,37,11,7
5718,21800799,Detroit Pistons,New York Knicks,105,92,197,13,Detroit Pistons,13,0.353,0.792,41,22,4,7,0.273,0.733,44,17,5,4
5719,21800800,Toronto Raptors,Philadelphia 76ers,119,107,226,12,Toronto Raptors,12,0.355,0.813,42,27,12,0,0.292,0.927,34,20,8,3
5720,21800801,Minnesota Timberwolves,Memphis Grizzlies,106,108,214,2,Memphis Grizzlies,2,0.31,0.95,55,26,4,4,0.441,0.724,39,18,11,6
5721,21800802,Orlando Magic,Oklahoma City Thunder,122,132,254,10,Oklahoma City Thunder,10,0.297,0.794,40,27,14,4,0.433,0.73,49,25,11,2
5722,21800803,Miami Heat,Portland Trail Blazers,118,108,226,10,Miami Heat,10,0.318,0.84,46,18,11,7,0.385,0.75,33,30,6,2
5723,21800804,Denver Nuggets,Brooklyn Nets,130,135,265,5,Brooklyn Nets,5,0.371,0.81,48,32,7,8,0.559,0.727,40,36,9,5
5724,21800805,New Orleans Pelicans,Chicago Bulls,125,120,245,5,New Orleans Pelicans,5,0.429,0.667,46,26,1,6,0.444,0.737,36,27,8,6
5725,21800806,Washington Wizards,Milwaukee Bucks,129,148,277,19,Milwaukee Bucks,19,0.459,0.842,40,34,6,5,0.633,0.654,34,33,15,3
5726,21800807,Charlotte Hornets,Dallas Mavericks,93,99,192,6,Dallas Mavericks,6,0.243,0.706,47,17,9,9,0.306,0.706,57,25,8,5
5727,21800808,Phoenix Suns,Utah Jazz,88,116,204,28,Utah Jazz,28,0.176,0.789,36,23,8,2,0.393,0.656,43,29,13,5
5728,21800809,Houston Rockets,Sacramento Kings,127,101,228,26,Houston Rockets,26,0.392,0.944,42,17,13,7,0.333,0.6,54,21,5,6
5729,21800810,San Antonio Spurs,Golden State Warriors,102,141,243,39,Golden State Warriors,39,0.375,0.952,30,24,6,5,0.471,0.714,52,42,14,5
5730,21800811,Los Angeles Clippers,Indiana Pacers,92,116,208,24,Indiana Pacers,24,0.353,0.632,36,23,14,6,0.409,0.818,42,26,15,12
5731,21800812,Minnesota Timberwolves,Orlando Magic,112,122,234,10,Orlando Magic,10,0.385,0.833,43,23,8,4,0.423,0.913,41,23,5,7
5732,21800813,Toronto Raptors,Atlanta Hawks,119,101,220,18,Toronto Raptors,18,0.325,0.788,50,29,6,2,0.457,0.52,42,25,5,3
5733,21800814,Los Angeles Lakers,Boston Celtics,129,128,257,1,Los Angeles Lakers,1,0.537,0.389,43,35,5,6,0.421,1,48,35,7,5
5734,21800815,Memphis Grizzlies,Oklahoma City Thunder,95,117,212,22,Oklahoma City Thunder,22,0.292,0.87,45,19,9,4,0.386,0.636,44,29,17,2
5735,21800816,San Antonio Spurs,Portland Trail Blazers,118,127,245,9,Portland Trail Blazers,9,0.571,0.714,43,19,3,3,0.355,1,33,26,11,4
5736,21800817,New York Knicks,Detroit Pistons,103,120,223,17,Detroit Pistons,17,0.318,0.634,39,22,6,5,0.433,0.793,46,24,3,6
5737,21800818,Denver Nuggets,Philadelphia 76ers,110,117,227,7,Philadelphia 76ers,7,0.231,0.923,40,35,5,3,0.455,0.906,42,23,7,5
5738,21800819,Cleveland Cavaliers,Washington Wizards,106,119,225,13,Washington Wizards,13,0.316,0.88,52,21,6,3,0.343,0.938,48,35,10,4
5739,21800820,Chicago Bulls,Brooklyn Nets,125,106,231,19,Chicago Bulls,19,0.5,0.792,50,27,5,5,0.317,0.938,33,26,9,1
5740,21800821,Milwaukee Bucks,Dallas Mavericks,122,107,229,15,Milwaukee Bucks,15,0.278,0.833,51,25,4,5,0.415,0.65,37,23,6,5
5741,21800822,Golden State Warriors,Phoenix Suns,117,107,224,10,Golden State Warriors,10,0.345,0.714,49,30,5,9,0.194,0.767,48,23,12,1
5742,21800823,Minnesota Timberwolves,New Orleans Pelicans,117,122,239,5,New Orleans Pelicans,5,0.429,0.727,49,22,6,8,0.3,0.964,45,27,11,7
5743,21800824,Miami Heat,Sacramento Kings,96,102,198,6,Sacramento Kings,6,0.333,0.474,49,26,6,8,0.346,0.76,46,18,11,5
5744,21800825,San Antonio Spurs,Utah Jazz,105,125,230,20,Utah Jazz,20,0.318,0.9,36,24,7,3,0.39,0.75,52,29,7,3
5745,21800826,Cleveland Cavaliers,Indiana Pacers,90,105,195,15,Indiana Pacers,15,0.444,0.444,30,23,3,2,0.346,0.6,43,31,8,5
5746,21800827,Charlotte Hornets,Atlanta Hawks,129,120,249,9,Charlotte Hornets,9,0.452,0.778,37,30,12,7,0.424,0.737,36,26,10,3
5747,21800828,Toronto Raptors,New York Knicks,104,99,203,5,Toronto Raptors,5,0.4,0.828,47,27,8,5,0.4,0.579,57,22,9,4
5748,21800829,Los Angeles Clippers,Boston Celtics,123,112,235,11,Los Angeles Clippers,11,0.4,0.775,49,28,6,6,0.346,0.806,45,21,9,3
5749,21800830,Washington Wizards,Chicago Bulls,134,125,259,9,Washington Wizards,9,0.444,0.857,39,38,6,6,0.261,0.75,45,28,7,5
5750,21800831,New Orleans Pelicans,Memphis Grizzlies,90,99,189,9,Memphis Grizzlies,9,0.182,0.593,52,25,6,5,0.276,0.833,45,27,6,2
5751,21800832,Oklahoma City Thunder,Houston Rockets,117,112,229,5,Oklahoma City Thunder,5,0.382,0.8,53,20,7,5,0.356,0.733,39,18,10,7
5752,21800833,Orlando Magic,Milwaukee Bucks,103,83,186,20,Orlando Magic,20,0.37,0.833,57,28,5,8,0.171,0.833,51,18,5,8
5753,21800834,Portland Trail Blazers,Dallas Mavericks,101,102,203,1,Dallas Mavericks,1,0.31,0.571,48,24,7,4,0.324,0.783,39,20,6,3
5754,21800835,Los Angeles Lakers,Philadelphia 76ers,120,143,263,23,Philadelphia 76ers,23,0.37,0.737,43,31,3,4,0.5,0.864,42,33,10,3
5755,21800836,Phoenix Suns,Sacramento Kings,104,117,221,13,Sacramento Kings,13,0.222,0.733,54,22,5,4,0.29,0.727,49,26,12,11
5756,21800837,Orlando Magic,Atlanta Hawks,124,108,232,16,Orlando Magic,16,0.351,0.893,49,29,4,9,0.406,0.84,33,27,5,6
5757,21800838,Miami Heat,Golden State Warriors,118,120,238,2,Golden State Warriors,2,0.419,0.5,52,32,6,4,0.361,0.731,36,28,8,5
5758,21800839,New York Knicks,Cleveland Cavaliers,104,107,211,3,Cleveland Cavaliers,3,0.269,0.65,46,21,8,9,0.318,0.895,56,20,6,2
5759,21800840,Washington Wizards,Detroit Pistons,112,121,233,9,Detroit Pistons,9,0.359,0.737,37,31,7,5,0.417,0.857,48,25,6,2
5760,21800841,Charlotte Hornets,Indiana Pacers,90,99,189,9,Indiana Pacers,9,0.175,0.758,51,15,7,2,0.32,0.882,39,25,3,3
5761,21800842,Brooklyn Nets,Toronto Raptors,125,127,252,2,Toronto Raptors,2,0.488,0.722,31,33,6,3,0.29,0.9,40,32,12,3
5762,21800843,Milwaukee Bucks,Chicago Bulls,112,99,211,13,Milwaukee Bucks,13,0.316,0.828,49,24,6,7,0.321,0.889,45,24,8,2
5763,21800844,Dallas Mavericks,Houston Rockets,104,120,224,16,Houston Rockets,16,0.361,0.778,33,21,5,1,0.383,0.867,38,28,13,5
5764,21800845,Los Angeles Clippers,Minnesota Timberwolves,120,130,250,10,Minnesota Timberwolves,10,0.414,0.872,37,24,8,2,0.333,0.833,44,28,14,1
5765,21800846,Portland Trail Blazers,Oklahoma City Thunder,111,120,231,9,Oklahoma City Thunder,9,0.379,0.737,46,18,8,7,0.457,0.759,45,23,9,7
5766,21800847,Miami Heat,Denver Nuggets,87,103,190,16,Denver Nuggets,16,0.273,0.625,47,23,10,5,0.432,0.846,45,27,7,6
5767,21800848,Los Angeles Lakers,Atlanta Hawks,113,117,230,4,Atlanta Hawks,4,0.35,0.68,44,25,10,6,0.381,0.808,47,29,8,6
5768,21800849,Boston Celtics,Philadelphia 76ers,112,109,221,3,Boston Celtics,3,0.448,0.81,41,24,9,3,0.333,0.71,47,21,4,3
5769,21800850,San Antonio Spurs,Memphis Grizzlies,108,107,215,1,San Antonio Spurs,1,0.619,0.793,43,23,6,5,0.333,0.688,48,25,5,6
5770,21800851,Orlando Magic,New Orleans Pelicans,118,88,206,30,Orlando Magic,30,0.406,0.955,58,32,9,8,0.345,0.75,42,21,5,8
5771,21800852,Utah Jazz,Golden State Warriors,108,115,223,7,Golden State Warriors,7,0.385,0.762,49,23,3,4,0.317,0.667,40,29,12,7
5772,21800853,Brooklyn Nets,Cleveland Cavaliers,148,139,287,9,Brooklyn Nets,9,0.4,0.765,60,31,4,13,0.429,0.722,57,35,7,4
5773,21800854,Milwaukee Bucks,Indiana Pacers,106,97,203,9,Milwaukee Bucks,9,0.29,0.724,52,22,7,3,0.37,0.867,43,22,6,4
5774,21800855,Detroit Pistons,Boston Celtics,110,118,228,8,Boston Celtics,8,0.325,0.735,41,19,7,1,0.41,0.8,47,32,8,2
5775,21800856,Philadelphia 76ers,New York Knicks,126,111,237,15,Philadelphia 76ers,15,0.348,0.791,47,33,8,7,0.31,0.815,43,27,8,4
5776,21800857,Washington Wizards,Toronto Raptors,120,129,249,9,Toronto Raptors,9,0.35,0.821,43,27,6,3,0.421,0.833,52,32,8,8
5777,21800858,Memphis Grizzlies,Chicago Bulls,110,122,232,12,Chicago Bulls,12,0.355,0.765,32,33,9,5,0.4,0.828,46,28,2,3
5778,21800859,Miami Heat,Dallas Mavericks,112,101,213,11,Miami Heat,11,0.4,0.75,47,24,8,3,0.288,0.818,38,24,10,0
5779,21800860,Sacramento Kings,Denver Nuggets,118,120,238,2,Denver Nuggets,2,0.344,0.821,44,30,12,1,0.258,0.88,53,26,7,1
5780,21800861,Houston Rockets,Minnesota Timberwolves,111,121,232,10,Minnesota Timberwolves,10,0.358,0.923,37,23,5,2,0.5,0.765,47,31,4,5
5781,21800862,Golden State Warriors,Portland Trail Blazers,107,129,236,22,Portland Trail Blazers,22,0.342,0.889,49,26,1,9,0.432,0.794,48,24,3,4
5782,21800863,Phoenix Suns,Los Angeles Clippers,107,134,241,27,Los Angeles Clippers,27,0.267,0.76,36,24,6,4,0.5,0.767,43,33,12,9
5783,21800864,Charlotte Hornets,Orlando Magic,89,127,216,38,Orlando Magic,38,0.129,0.731,45,18,6,4,0.436,0.778,50,32,6,6
5784,21800865,New York Knicks,Atlanta Hawks,106,91,197,15,New York Knicks,15,0.387,0.692,52,21,9,9,0.263,0.789,41,19,8,4
5785,21800866,Oklahoma City Thunder,New Orleans Pelicans,122,131,253,9,New Orleans Pelicans,9,0.227,0.923,48,27,8,6,0.462,0.792,51,35,7,7
5786,21800867,Phoenix Suns,Cleveland Cavaliers,98,111,209,13,Cleveland Cavaliers,13,0.313,0.72,38,26,12,6,0.361,0.7,51,34,11,4
5787,21800868,Miami Heat,Philadelphia 76ers,102,106,208,4,Philadelphia 76ers,4,0.273,0.5,40,27,11,4,0.269,0.714,51,23,5,4
5788,21800869,Portland Trail Blazers,Brooklyn Nets,113,99,212,14,Portland Trail Blazers,14,0.219,0.875,60,19,7,9,0.194,0.769,49,26,4,2
5789,21800870,Boston Celtics,Milwaukee Bucks,97,98,195,1,Milwaukee Bucks,1,0.35,0.833,50,19,11,9,0.359,0.714,55,21,5,4
5790,21800871,Sacramento Kings,Golden State Warriors,123,125,248,2,Golden State Warriors,2,0.303,0.794,52,23,10,3,0.413,0.833,49,32,5,11
5791,21800872,Houston Rockets,Los Angeles Lakers,106,111,217,5,Los Angeles Lakers,5,0.293,0.933,39,18,8,5,0.267,0.818,49,22,4,4
5792,21800873,Washington Wizards,Charlotte Hornets,110,123,233,13,Charlotte Hornets,13,0.256,0.889,43,24,6,6,0.394,0.818,53,26,7,6
5793,21800874,New Orleans Pelicans,Indiana Pacers,111,126,237,15,Indiana Pacers,15,0.296,0.567,51,25,5,5,0.438,0.686,48,28,10,5
5794,21800875,Chicago Bulls,Orlando Magic,110,109,219,1,Chicago Bulls,1,0.414,0.947,39,18,8,4,0.412,0.542,46,25,4,6
5795,21800876,San Antonio Spurs,Toronto Raptors,117,120,237,3,Toronto Raptors,3,0.324,0.864,48,27,7,6,0.467,0.813,47,24,8,3
5796,21800877,Detroit Pistons,Atlanta Hawks,125,122,247,3,Detroit Pistons,3,0.375,0.643,44,20,11,4,0.476,0.842,47,21,6,4
5797,21800878,Minnesota Timberwolves,New York Knicks,115,104,219,11,Minnesota Timberwolves,11,0.458,0.688,42,22,13,8,0.379,0.792,47,15,9,8
5798,21800879,Los Angeles Clippers,Memphis Grizzlies,112,106,218,6,Los Angeles Clippers,6,0.24,0.857,49,21,8,4,0.281,0.861,39,20,10,6
5799,21800880,Denver Nuggets,Dallas Mavericks,114,104,218,10,Denver Nuggets,10,0.378,0.64,63,32,11,2,0.244,0.788,42,19,7,2
5800,21800881,Utah Jazz,Oklahoma City Thunder,147,148,295,1,Oklahoma City Thunder,1,0.45,0.806,61,33,8,10,0.409,0.8,43,29,16,5
5801,21800882,Portland Trail Blazers,Philadelphia 76ers,130,115,245,15,Portland Trail Blazers,15,0.217,0.931,53,29,8,6,0.375,0.786,33,28,5,5
5802,21800883,Phoenix Suns,Atlanta Hawks,112,120,232,8,Atlanta Hawks,8,0.351,0.85,41,25,9,4,0.364,0.842,50,22,8,9
5803,21800884,Brooklyn Nets,Charlotte Hornets,117,115,232,2,Brooklyn Nets,2,0.395,0.769,42,23,5,6,0.343,0.833,42,15,4,5
5804,21800885,Memphis Grizzlies,Cleveland Cavaliers,107,112,219,5,Cleveland Cavaliers,5,0.2,0.786,43,18,7,6,0.381,0.783,52,25,6,3
5805,21800886,Indiana Pacers,Washington Wizards,119,112,231,7,Indiana Pacers,7,0.44,0.636,41,29,13,0,0.371,0.714,32,27,15,5
5806,21800887,Los Angeles Lakers,New Orleans Pelicans,115,128,243,13,New Orleans Pelicans,13,0.345,0.654,39,33,10,3,0.375,0.813,41,31,14,4
5807,21800888,Detroit Pistons,Miami Heat,119,96,215,23,Detroit Pistons,23,0.424,0.808,41,21,6,5,0.25,0.704,33,18,6,6
5808,21800889,Boston Celtics,Chicago Bulls,116,126,242,10,Chicago Bulls,10,0.345,0.762,32,26,6,7,0.4,0.952,49,26,4,2
5809,21800890,Sacramento Kings,Oklahoma City Thunder,119,116,235,3,Sacramento Kings,3,0.368,0.706,47,24,7,7,0.304,0.786,59,17,2,6
5810,21800891,Minnesota Timberwolves,Milwaukee Bucks,128,140,268,12,Milwaukee Bucks,12,0.462,0.8,41,29,7,2,0.442,0.955,49,28,6,8
5811,21800892,Houston Rockets,Golden State Warriors,118,112,230,6,Houston Rockets,6,0.372,0.917,49,26,13,7,0.389,0.7,45,26,9,10
5812,21800893,Dallas Mavericks,Utah Jazz,109,125,234,16,Utah Jazz,16,0.361,0.778,42,25,2,3,0.368,0.879,53,28,2,9
5813,21800894,Orlando Magic,Toronto Raptors,113,98,211,15,Orlando Magic,15,0.389,0.75,52,29,6,8,0.393,0.786,42,30,6,2
5814,21800895,Los Angeles Clippers,Denver Nuggets,96,123,219,27,Denver Nuggets,27,0.143,0.892,38,20,9,7,0.353,0.657,56,30,11,6
5815,21800896,San Antonio Spurs,New York Knicks,118,130,248,12,New York Knicks,12,0.25,0.903,50,18,3,4,0.432,0.737,49,25,3,7
5816,21800897,Golden State Warriors,Charlotte Hornets,121,110,231,11,Golden State Warriors,11,0.341,0.846,49,35,9,8,0.212,0.885,38,23,13,6
5817,21800898,Portland Trail Blazers,Cleveland Cavaliers,123,110,233,13,Portland Trail Blazers,13,0.621,0.773,45,26,5,6,0.382,0.885,40,22,4,1
5818,21800899,Indiana Pacers,Detroit Pistons,109,113,222,4,Detroit Pistons,4,0.385,0.905,42,23,8,8,0.439,0.654,47,28,8,4
5819,21800900,San Antonio Spurs,Brooklyn Nets,85,101,186,16,Brooklyn Nets,16,0.167,0.917,47,14,6,6,0.38,0.75,51,24,5,5
5820,21800901,Phoenix Suns,Miami Heat,124,121,245,3,Phoenix Suns,3,0.406,0.84,39,30,9,1,0.31,0.8,44,31,10,4
5821,21800902,Milwaukee Bucks,Chicago Bulls,117,106,223,11,Milwaukee Bucks,11,0.347,0.696,45,26,3,6,0.346,0.682,41,31,3,3
5822,21800903,Atlanta Hawks,Houston Rockets,111,119,230,8,Houston Rockets,8,0.447,0.696,41,21,6,6,0.294,0.867,37,24,11,4
5823,21800904,Los Angeles Lakers,Memphis Grizzlies,105,110,215,5,Memphis Grizzlies,5,0.37,0.75,46,25,8,5,0.25,0.826,57,20,7,5
5824,21800905,Sacramento Kings,Minnesota Timberwolves,105,112,217,7,Minnesota Timberwolves,7,0.346,0.759,44,20,13,2,0.258,0.714,49,23,10,6
5825,21800906,Philadelphia 76ers,New Orleans Pelicans,111,110,221,1,Philadelphia 76ers,1,0.323,0.684,58,23,9,8,0.179,0.708,54,29,15,8
5826,21800907,Dallas Mavericks,Los Angeles Clippers,112,121,233,9,Los Angeles Clippers,9,0.389,0.889,45,28,3,9,0.378,0.778,40,33,11,4
5827,21800908,Orlando Magic,New York Knicks,103,108,211,5,New York Knicks,5,0.344,0.7,47,26,6,7,0.292,0.781,51,17,11,7
5828,21800909,Boston Celtics,Toronto Raptors,95,118,213,23,Toronto Raptors,23,0.2,0.821,47,24,6,4,0.472,0.643,45,33,7,5
5829,21800910,Oklahoma City Thunder,Denver Nuggets,112,121,233,9,Denver Nuggets,9,0.263,0.64,46,31,10,5,0.464,0.743,47,28,9,4
5830,21800911,Houston Rockets,Charlotte Hornets,118,113,231,5,Houston Rockets,5,0.333,0.875,37,23,11,3,0.364,0.852,48,25,9,5
5831,21800912,Minnesota Timberwolves,Atlanta Hawks,123,131,254,8,Atlanta Hawks,8,0.316,0.697,47,29,8,7,0.414,0.844,65,32,1,6
5832,21800913,Portland Trail Blazers,Boston Celtics,97,92,189,5,Portland Trail Blazers,5,0.182,0.75,48,14,11,2,0.179,0.7,41,20,5,4
5833,21800914,Washington Wizards,Brooklyn Nets,125,116,241,9,Washington Wizards,9,0.297,0.839,57,34,10,4,0.229,0.769,41,20,7,3
5834,21800915,Golden State Warriors,Miami Heat,125,126,251,1,Miami Heat,1,0.354,0.714,37,21,7,3,0.439,0.8,48,20,4,6
5835,21800916,Chicago Bulls,Memphis Grizzlies,109,107,216,2,Chicago Bulls,2,0.333,0.92,42,20,12,9,0.333,0.889,46,25,7,5
5836,21800917,Detroit Pistons,San Antonio Spurs,93,105,198,12,San Antonio Spurs,12,0.395,0.857,41,19,6,3,0.529,0.706,55,24,3,7
5837,21800918,Indiana Pacers,Dallas Mavericks,101,110,211,9,Dallas Mavericks,9,0.357,0.81,38,19,10,3,0.432,0.609,42,27,11,1
5838,21800919,Los Angeles Clippers,Utah Jazz,105,111,216,6,Utah Jazz,6,0.192,0.867,47,16,11,6,0.324,0.75,56,22,9,12
5839,21800920,Milwaukee Bucks,Sacramento Kings,141,140,281,1,Milwaukee Bucks,1,0.378,0.762,57,36,3,14,0.364,0.733,58,30,6,6
5840,21800921,New Orleans Pelicans,Los Angeles Lakers,119,125,244,6,Los Angeles Lakers,6,0.2,0.741,52,31,6,3,0.32,0.613,39,37,7,8
5841,21800922,Minnesota Timberwolves,Indiana Pacers,115,122,237,7,Indiana Pacers,7,0.308,0.676,56,16,5,7,0.593,0.839,35,35,8,11
5842,21800923,Golden State Warriors,Orlando Magic,96,103,199,7,Orlando Magic,7,0.225,0.9,47,16,5,3,0.355,0.8,53,24,2,9
5843,21800924,Cleveland Cavaliers,New York Knicks,125,118,243,7,Cleveland Cavaliers,7,0.412,0.806,40,24,5,3,0.344,0.652,40,26,4,3
5844,21800925,Miami Heat,Houston Rockets,118,121,239,3,Houston Rockets,3,0.536,0.792,34,28,9,2,0.413,0.929,36,22,6,5
5845,21800926,Utah Jazz,Denver Nuggets,111,104,215,7,Utah Jazz,7,0.372,0.636,44,25,6,6,0.28,0.708,55,25,6,5
5846,21800927,Philadelphia 76ers,Oklahoma City Thunder,108,104,212,4,Philadelphia 76ers,4,0.4,0.632,44,33,9,5,0.296,0.714,44,28,5,3
5847,21800928,Chicago Bulls,Atlanta Hawks,168,161,329,7,Chicago Bulls,7,0.438,0.729,62,30,10,5,0.367,0.68,59,33,11,8
5848,21800929,Charlotte Hornets,Brooklyn Nets,123,112,235,11,Charlotte Hornets,11,0.429,0.824,40,24,6,4,0.313,0.778,37,27,2,5
5849,21800930,Portland Trail Blazers,Toronto Raptors,117,119,236,2,Toronto Raptors,2,0.424,0.826,42,24,9,4,0.357,0.905,32,29,9,6
5850,21800931,Washington Wizards,Boston Celtics,96,107,203,11,Boston Celtics,11,0.263,0.737,53,20,7,6,0.286,0.765,46,26,12,3
5851,21800932,New Orleans Pelicans,Phoenix Suns,130,116,246,14,New Orleans Pelicans,14,0.593,0.7,50,34,13,4,0.353,0.857,39,25,17,2
5852,21800933,Los Angeles Clippers,Sacramento Kings,116,109,225,7,Los Angeles Clippers,7,0.387,0.727,58,19,4,6,0.286,0.84,46,27,6,8
5853,21800934,Milwaukee Bucks,Los Angeles Lakers,131,120,251,11,Milwaukee Bucks,11,0.35,0.875,51,30,4,6,0.325,0.833,40,29,4,4
5854,21800935,Detroit Pistons,Cleveland Cavaliers,129,93,222,36,Detroit Pistons,36,0.541,0.882,51,27,5,8,0.382,0.813,33,15,7,1
5855,21800936,Orlando Magic,Indiana Pacers,117,112,229,5,Orlando Magic,5,0.357,0.789,41,28,7,5,0.259,0.875,36,31,5,6
5856,21800937,Brooklyn Nets,Miami Heat,88,117,205,29,Miami Heat,29,0.214,0.773,36,20,6,6,0.412,0.682,57,36,5,9
5857,21800938,Golden State Warriors,Philadelphia 76ers,120,117,237,3,Golden State Warriors,3,0.424,0.706,39,23,14,7,0.452,0.862,46,26,6,3
5858,21800939,Memphis Grizzlies,Dallas Mavericks,111,81,192,30,Memphis Grizzlies,30,0.412,0.792,50,30,4,6,0.175,0.667,43,17,9,5
5859,21800940,Oklahoma City Thunder,San Antonio Spurs,102,116,218,14,San Antonio Spurs,14,0.241,0.625,45,17,7,2,0.421,0.72,49,15,8,6
5860,21800941,New Orleans Pelicans,Denver Nuggets,120,112,232,8,New Orleans Pelicans,8,0.4,0.692,47,28,10,4,0.281,0.862,44,25,13,7
5861,21800942,Los Angeles Lakers,Phoenix Suns,109,118,227,9,Phoenix Suns,9,0.32,0.652,40,27,3,3,0.231,0.85,41,21,7,8
5862,21800943,Milwaukee Bucks,Utah Jazz,111,115,226,4,Utah Jazz,4,0.385,0.733,53,20,6,10,0.414,0.577,53,22,13,7
5863,21800944,Portland Trail Blazers,Charlotte Hornets,118,108,226,10,Portland Trail Blazers,10,0.344,0.913,48,26,9,3,0.424,0.87,35,25,7,5
5864,21800945,Houston Rockets,Boston Celtics,115,104,219,11,Houston Rockets,11,0.412,0.621,42,22,8,4,0.286,0.759,44,23,7,0
5865,21800946,Atlanta Hawks,Chicago Bulls,123,118,241,5,Atlanta Hawks,5,0.5,0.643,46,30,10,5,0.296,0.762,42,25,6,5
5866,21800947,New York Knicks,Los Angeles Clippers,107,128,235,21,Los Angeles Clippers,21,0.379,0.765,46,23,9,9,0.543,0.765,53,33,5,4
5867,21800948,Orlando Magic,Cleveland Cavaliers,93,107,200,14,Cleveland Cavaliers,14,0.231,0.818,41,23,5,4,0.326,0.913,44,20,7,2
5868,21800949,Toronto Raptors,Detroit Pistons,107,112,219,5,Detroit Pistons,5,0.359,0.792,50,22,8,3,0.364,0.69,46,25,10,3
5869,21800950,Minnesota Timberwolves,Washington Wizards,121,135,256,14,Washington Wizards,14,0.148,0.684,46,25,3,4,0.333,0.813,46,30,6,4
5870,21800951,Memphis Grizzlies,Oklahoma City Thunder,95,99,194,4,Oklahoma City Thunder,4,0.318,0.947,44,22,9,9,0.3,0.727,53,19,10,5
5871,21800952,Dallas Mavericks,Brooklyn Nets,88,127,215,39,Brooklyn Nets,39,0.267,0.636,36,20,4,3,0.415,0.737,48,29,8,1
5872,21800953,Atlanta Hawks,Miami Heat,113,114,227,1,Miami Heat,1,0.37,0.8,42,25,9,2,0.391,0.708,40,23,9,7
5873,21800954,Denver Nuggets,San Antonio Spurs,103,104,207,1,San Antonio Spurs,1,0.425,1,43,27,5,3,0.32,0.737,43,27,8,7
5874,21800955,Milwaukee Bucks,Phoenix Suns,105,114,219,9,Phoenix Suns,9,0.286,0.742,57,17,8,2,0.318,0.806,56,22,10,10
5875,21800956,New Orleans Pelicans,Utah Jazz,115,112,227,3,New Orleans Pelicans,3,0.45,0.778,44,24,12,5,0.368,0.857,47,35,3,6
5876,21800957,New York Knicks,Sacramento Kings,108,115,223,7,Sacramento Kings,7,0.414,0.643,48,17,8,5,0.379,0.788,43,28,11,3
5877,21800958,Los Angeles Clippers,Los Angeles Lakers,113,105,218,8,Los Angeles Clippers,8,0.379,0.833,50,25,7,3,0.263,0.792,40,22,2,6
5878,21800959,Chicago Bulls,Indiana Pacers,96,105,201,9,Indiana Pacers,9,0.16,0.833,49,16,7,7,0.44,0.75,50,19,6,9
5879,21800960,Orlando Magic,Philadelphia 76ers,106,114,220,8,Philadelphia 76ers,8,0.406,0.75,44,21,4,2,0.393,0.905,50,28,10,4
5880,21800961,Houston Rockets,Toronto Raptors,107,95,202,12,Houston Rockets,12,0.441,0.889,43,22,11,6,0.281,0.75,47,16,1,5
5881,21800962,Portland Trail Blazers,Memphis Grizzlies,111,120,231,9,Memphis Grizzlies,9,0.31,0.857,36,25,7,4,0.481,0.75,34,22,11,5
5882,21800963,Oklahoma City Thunder,Minnesota Timberwolves,120,131,251,11,Minnesota Timberwolves,11,0.391,0.581,45,20,4,8,0.5,0.743,52,28,6,2
5883,21800964,Boston Celtics,Golden State Warriors,128,95,223,33,Boston Celtics,33,0.412,0.941,46,38,12,5,0.229,0.826,45,26,5,2
5884,21800965,Miami Heat,Charlotte Hornets,91,84,175,7,Miami Heat,7,0.346,0.545,51,19,10,7,0.389,0.667,40,22,7,4
5885,21800966,Minnesota Timberwolves,Detroit Pistons,114,131,245,17,Detroit Pistons,17,0.444,0.952,37,25,3,5,0.424,0.773,42,29,5,3
5886,21800967,Dallas Mavericks,Washington Wizards,123,132,255,9,Washington Wizards,9,0.366,0.643,39,27,7,2,0.364,0.8,49,30,3,2
5887,21800968,San Antonio Spurs,Atlanta Hawks,111,104,215,7,San Antonio Spurs,7,0.303,0.722,49,27,4,9,0.302,0.792,47,21,8,2
5888,21800969,Cleveland Cavaliers,Brooklyn Nets,107,113,220,6,Brooklyn Nets,6,0.421,0.724,47,23,7,3,0.364,0.577,50,21,5,7
5889,21800970,Philadelphia 76ers,Chicago Bulls,107,108,215,1,Chicago Bulls,1,0.333,0.792,46,22,10,5,0.261,0.741,47,21,7,3
5890,21800971,Utah Jazz,New Orleans Pelicans,114,104,218,10,Utah Jazz,10,0.267,0.636,45,31,9,8,0.375,0.65,41,17,6,4
5891,21800972,New York Knicks,Phoenix Suns,96,107,203,11,Phoenix Suns,11,0.4,0.8,46,17,6,7,0.414,0.773,31,21,11,9
5892,21800973,Boston Celtics,Sacramento Kings,111,109,220,2,Boston Celtics,2,0.394,0.857,35,26,11,1,0.448,0.727,40,23,8,4
5893,21800974,Denver Nuggets,Los Angeles Lakers,115,99,214,16,Denver Nuggets,16,0.31,0.706,55,33,6,3,0.226,0.522,41,26,5,4
5894,21800975,Indiana Pacers,Milwaukee Bucks,98,117,215,19,Milwaukee Bucks,19,0.378,0.7,40,26,10,7,0.4,0.81,52,21,7,10
5895,21800976,Oklahoma City Thunder,Portland Trail Blazers,129,121,250,8,Oklahoma City Thunder,8,0.296,0.781,58,14,7,5,0.22,0.809,51,14,7,8
5896,21800977,Washington Wizards,Charlotte Hornets,111,112,223,1,Charlotte Hornets,1,0.333,0.846,46,28,8,5,0.341,0.9,52,24,7,8
5897,21800978,Dallas Mavericks,Orlando Magic,106,111,217,5,Orlando Magic,5,0.294,0.75,42,22,6,3,0.483,0.722,48,26,9,5
5898,21800979,Cleveland Cavaliers,Miami Heat,110,126,236,16,Miami Heat,16,0.442,0.813,28,28,6,1,0.48,0.727,45,31,5,5
5899,21800980,Detroit Pistons,Chicago Bulls,112,104,216,8,Detroit Pistons,8,0.333,0.619,41,23,5,9,0.294,0.652,35,20,9,4
5900,21800981,Philadelphia 76ers,Houston Rockets,91,107,198,16,Houston Rockets,16,0.115,0.783,59,20,9,4,0.317,0.667,43,22,13,0
5901,21800982,Utah Jazz,Memphis Grizzlies,104,114,218,10,Memphis Grizzlies,10,0.375,0.667,41,21,8,10,0.409,0.867,43,31,5,5
5902,21800983,Toronto Raptors,New Orleans Pelicans,127,104,231,23,Toronto Raptors,23,0.351,0.889,51,31,10,12,0.256,0.615,51,28,11,0
5903,21800984,Denver Nuggets,Golden State Warriors,105,122,227,17,Golden State Warriors,17,0.364,0.771,46,21,9,3,0.514,0.667,43,32,11,10
5904,21800985,Oklahoma City Thunder,Los Angeles Clippers,110,118,228,8,Los Angeles Clippers,8,0.25,0.654,52,20,3,7,0.36,0.674,53,20,7,4
5905,21800986,Sacramento Kings,New York Knicks,102,94,196,8,Sacramento Kings,8,0.333,0.818,53,16,5,3,0.286,0.667,58,16,3,5
5906,21800987,Brooklyn Nets,Atlanta Hawks,114,112,226,2,Brooklyn Nets,2,0.341,0.611,54,21,7,3,0.195,0.813,57,22,7,2
5907,21800988,Washington Wizards,Minnesota Timberwolves,130,135,265,5,Minnesota Timberwolves,5,0.364,0.75,50,31,8,5,0.333,0.875,55,25,9,3
5908,21800989,Boston Celtics,Los Angeles Lakers,120,107,227,13,Boston Celtics,13,0.368,0.714,43,32,6,5,0.185,0.778,43,28,4,4
5909,21800990,Charlotte Hornets,Milwaukee Bucks,114,131,245,17,Milwaukee Bucks,17,0.385,0.786,35,25,4,2,0.386,0.867,55,27,9,2
5910,21800991,Phoenix Suns,Portland Trail Blazers,120,127,247,7,Portland Trail Blazers,7,0.333,0.862,43,27,7,5,0.448,0.778,52,19,5,7
5911,21800992,Chicago Bulls,Detroit Pistons,108,131,239,23,Detroit Pistons,23,0.5,0.654,37,18,4,5,0.543,0.636,44,34,5,1
5912,21800993,Toronto Raptors,Miami Heat,125,104,229,21,Toronto Raptors,21,0.525,0.769,44,32,8,8,0.296,0.571,36,27,13,0
5913,21800994,Indiana Pacers,Philadelphia 76ers,89,106,195,17,Philadelphia 76ers,17,0.313,0.595,44,18,8,4,0.304,0.767,52,24,10,3
5914,21800995,New Orleans Pelicans,Atlanta Hawks,116,128,244,12,Atlanta Hawks,12,0.439,1,42,29,6,9,0.459,0.833,56,30,4,5
5915,21800996,Orlando Magic,Memphis Grizzlies,97,105,202,8,Memphis Grizzlies,8,0.316,0.852,53,23,6,4,0.29,0.903,45,23,6,6
5916,21800997,Houston Rockets,Dallas Mavericks,94,93,187,1,Houston Rockets,1,0.308,0.636,41,18,6,4,0.281,0.815,51,24,6,9
5917,21800998,New York Knicks,Minnesota Timberwolves,92,103,195,11,Minnesota Timberwolves,11,0.4,0.571,43,20,5,8,0.3,0.769,40,22,13,10
5918,21800999,Milwaukee Bucks,San Antonio Spurs,114,121,235,7,San Antonio Spurs,7,0.389,0.72,45,22,3,2,0.414,0.733,46,24,6,3
5919,21801000,Phoenix Suns,Golden State Warriors,115,111,226,4,Phoenix Suns,4,0.4,0.778,48,26,10,4,0.233,0.773,49,34,10,6
5920,21801001,Toronto Raptors,Cleveland Cavaliers,101,126,227,25,Cleveland Cavaliers,25,0.282,0.588,43,20,8,3,0.439,0.952,51,27,8,1
5921,21801002,Sacramento Kings,Washington Wizards,115,121,236,6,Washington Wizards,6,0.333,0.75,47,28,8,3,0.378,0.818,47,29,12,1
5922,21801003,Detroit Pistons,Brooklyn Nets,75,103,178,28,Brooklyn Nets,28,0.235,0.813,49,16,7,3,0.355,0.636,53,21,9,4
5923,21801004,Charlotte Hornets,Houston Rockets,106,118,224,12,Houston Rockets,12,0.39,0.933,39,23,4,4,0.395,0.926,55,25,7,4
5924,21801005,Oklahoma City Thunder,Utah Jazz,98,89,187,9,Oklahoma City Thunder,9,0.318,0.704,48,18,8,5,0.302,0.706,48,22,12,6
5925,21801006,Boston Celtics,Los Angeles Clippers,115,140,255,25,Los Angeles Clippers,25,0.389,0.684,29,26,11,4,0.464,0.84,47,29,4,1
5926,21801007,New York Knicks,Indiana Pacers,98,103,201,5,Indiana Pacers,5,0.464,0.833,48,22,4,5,0.286,0.724,42,26,11,3
5927,21801008,Cleveland Cavaliers,Philadelphia 76ers,99,106,205,7,Philadelphia 76ers,7,0.342,0.75,37,14,8,2,0.348,0.824,60,25,4,7
5928,21801009,Los Angeles Lakers,Chicago Bulls,123,107,230,16,Los Angeles Lakers,16,0.394,0.8,41,23,11,5,0.407,1,44,23,6,0
5929,21801010,Milwaukee Bucks,New Orleans Pelicans,130,113,243,17,Milwaukee Bucks,17,0.278,0.857,52,27,5,4,0.213,0.688,50,27,3,4
5930,21801011,San Antonio Spurs,Dallas Mavericks,112,105,217,7,San Antonio Spurs,7,0.364,1,38,26,11,3,0.359,0.577,38,22,1,2
5931,21801012,Minnesota Timberwolves,Denver Nuggets,107,133,240,26,Denver Nuggets,26,0.367,1,35,24,10,6,0.6,0.867,36,40,6,6
5932,21801013,Portland Trail Blazers,Los Angeles Clippers,125,104,229,21,Portland Trail Blazers,21,0.387,0.731,50,27,8,3,0.6,0.704,51,21,7,3
5933,21801014,Detroit Pistons,Miami Heat,74,108,182,34,Miami Heat,34,0.216,0.667,37,20,7,7,0.393,0.792,51,22,10,5
5934,21801015,Orlando Magic,Washington Wizards,90,100,190,10,Washington Wizards,10,0.364,0.889,48,26,3,3,0.296,0.667,46,20,5,2
5935,21801016,Memphis Grizzlies,Atlanta Hawks,111,132,243,21,Atlanta Hawks,21,0.35,0.808,35,28,8,6,0.378,0.786,51,35,9,9
5936,21801017,Brooklyn Nets,Oklahoma City Thunder,96,108,204,12,Oklahoma City Thunder,12,0.371,0.684,43,19,7,5,0.393,0.789,51,21,9,6
5937,21801018,Golden State Warriors,Houston Rockets,106,104,210,2,Golden State Warriors,2,0.375,1,44,28,7,2,0.268,0.826,31,18,7,3
5938,21801019,Utah Jazz,Phoenix Suns,114,97,211,17,Utah Jazz,17,0.364,0.72,52,30,8,4,0.368,0.783,35,21,8,3
5939,21801020,Oklahoma City Thunder,Indiana Pacers,106,108,214,2,Indiana Pacers,2,0.467,0.8,44,24,11,5,0.318,0.844,39,24,11,3
5940,21801021,Cleveland Cavaliers,Orlando Magic,91,120,211,29,Orlando Magic,29,0.226,0.933,43,13,4,4,0.452,0.762,50,31,11,3
5941,21801022,Sacramento Kings,Boston Celtics,120,126,246,6,Boston Celtics,6,0.324,0.565,47,31,9,2,0.321,0.731,52,32,7,2
5942,21801023,Los Angeles Lakers,Toronto Raptors,98,111,209,13,Toronto Raptors,13,0.226,0.625,46,24,11,3,0.39,0.793,52,21,15,6
5943,21801024,Minnesota Timberwolves,Utah Jazz,100,120,220,20,Utah Jazz,20,0.208,0.733,38,27,6,2,0.342,0.704,49,30,7,8
5944,21801025,Dallas Mavericks,Denver Nuggets,99,100,199,1,Denver Nuggets,1,0.324,0.765,40,22,8,1,0.276,0.824,44,27,6,7
5945,21801026,Los Angeles Lakers,Detroit Pistons,97,111,208,14,Detroit Pistons,14,0.24,0.731,47,24,9,4,0.436,0.625,50,26,5,4
5946,21801027,Sacramento Kings,Philadelphia 76ers,114,123,237,9,Philadelphia 76ers,9,0.333,0.792,40,23,4,2,0.292,0.889,49,28,7,6
5947,21801028,Charlotte Hornets,Washington Wizards,116,110,226,6,Charlotte Hornets,6,0.452,0.833,46,18,11,7,0.382,0.789,45,25,8,5
5948,21801029,Milwaukee Bucks,Miami Heat,113,98,211,15,Milwaukee Bucks,15,0.364,0.708,52,29,8,9,0.364,0.56,45,21,7,5
5949,21801030,Phoenix Suns,Houston Rockets,102,108,210,6,Houston Rockets,6,0.269,0.76,49,22,9,4,0.275,0.758,42,18,13,6
5950,21801031,Portland Trail Blazers,New Orleans Pelicans,122,110,232,12,Portland Trail Blazers,12,0.37,0.813,54,26,7,8,0.267,0.48,45,31,7,6
5951,21801032,New York Knicks,San Antonio Spurs,83,109,192,26,San Antonio Spurs,26,0.4,0.556,41,21,6,4,0.333,0.8,45,31,8,6
5952,21801033,Chicago Bulls,Los Angeles Clippers,121,128,249,7,Los Angeles Clippers,7,0.524,0.788,44,24,3,6,0.5,0.857,43,28,9,5
5953,21801034,Atlanta Hawks,Boston Celtics,120,129,249,9,Boston Celtics,9,0.375,0.792,50,27,11,5,0.361,0.757,46,30,10,7
5954,21801035,Memphis Grizzlies,Washington Wizards,128,135,263,7,Washington Wizards,7,0.364,0.769,40,35,5,3,0.486,0.837,45,26,6,7
5955,21801036,Phoenix Suns,New Orleans Pelicans,138,136,274,2,Phoenix Suns,2,0.31,0.75,48,31,10,7,0.5,0.659,57,34,11,4
5956,21801037,Cleveland Cavaliers,Dallas Mavericks,116,121,237,5,Dallas Mavericks,5,0.395,0.955,33,20,1,0,0.471,0.813,40,32,3,5
5957,21801038,Golden State Warriors,Oklahoma City Thunder,110,88,198,22,Golden State Warriors,22,0.429,0.773,53,25,10,6,0.317,0.565,52,18,4,5
5958,21801039,Portland Trail Blazers,San Antonio Spurs,103,108,211,5,San Antonio Spurs,5,0.25,0.857,51,23,4,2,0.471,0.867,44,17,4,10
5959,21801040,Indiana Pacers,Denver Nuggets,100,102,202,2,Denver Nuggets,2,0.25,0.703,41,20,6,2,0.289,0.65,39,27,6,5
5960,21801041,Brooklyn Nets,Utah Jazz,98,114,212,16,Utah Jazz,16,0.333,0.909,44,20,9,5,0.361,0.742,65,24,3,7
5961,21801042,Los Angeles Lakers,New York Knicks,123,124,247,1,New York Knicks,1,0.259,0.786,35,26,12,5,0.462,0.828,45,24,4,5
5962,21801043,Philadelphia 76ers,Milwaukee Bucks,130,125,255,5,Philadelphia 76ers,5,0.469,0.7,54,26,8,2,0.32,0.821,45,25,9,6
5963,21801044,Toronto Raptors,Detroit Pistons,107,110,217,3,Detroit Pistons,3,0.5,0.786,38,25,2,2,0.296,0.889,44,23,8,3
5964,21801045,Charlotte Hornets,Miami Heat,75,93,168,18,Miami Heat,18,0.194,0.889,44,11,6,5,0.394,0.632,55,25,6,7
5965,21801046,Atlanta Hawks,Orlando Magic,91,101,192,10,Orlando Magic,10,0.229,0.7,50,20,8,3,0.243,0.788,55,21,12,3
5966,21801047,Chicago Bulls,Sacramento Kings,102,129,231,27,Sacramento Kings,27,0.385,0.667,39,20,6,6,0.348,0.813,48,28,12,7
5967,21801048,Minnesota Timberwolves,Houston Rockets,102,117,219,15,Houston Rockets,15,0.313,0.696,52,22,5,4,0.42,0.714,44,29,9,3
5968,21801049,Brooklyn Nets,Los Angeles Clippers,116,119,235,3,Los Angeles Clippers,3,0.368,0.72,51,26,6,7,0.387,0.821,54,26,8,6
5969,21801050,Detroit Pistons,Cleveland Cavaliers,119,126,245,7,Cleveland Cavaliers,7,0.409,0.81,47,24,6,4,0.5,0.852,36,22,6,3
5970,21801051,Utah Jazz,Washington Wizards,116,95,211,21,Utah Jazz,21,0.378,0.667,41,35,10,8,0.296,0.864,34,20,9,2
5971,21801052,Denver Nuggets,Boston Celtics,114,105,219,9,Denver Nuggets,9,0.359,0.8,51,29,6,5,0.308,0.789,37,24,12,5
5972,21801053,New York Knicks,Toronto Raptors,92,128,220,36,Toronto Raptors,36,0.229,0.875,36,16,8,4,0.425,0.591,50,36,5,6
5973,21801054,Miami Heat,Oklahoma City Thunder,116,107,223,9,Miami Heat,9,0.31,0.938,44,30,13,4,0.27,0.778,49,21,4,8
5974,21801055,Golden State Warriors,San Antonio Spurs,105,111,216,6,San Antonio Spurs,6,0.333,0.833,43,27,7,6,0.385,0.864,46,20,7,5
5975,21801056,New Orleans Pelicans,Dallas Mavericks,129,125,254,4,New Orleans Pelicans,4,0.308,0.864,55,34,7,6,0.257,0.828,50,27,9,6
5976,21801057,Chicago Bulls,Phoenix Suns,116,101,217,15,Chicago Bulls,15,0.25,0.833,49,21,9,4,0.269,0.615,38,24,5,5
5977,21801058,Indiana Pacers,Portland Trail Blazers,98,106,204,8,Portland Trail Blazers,8,0.417,0.818,39,25,12,3,0.406,0.905,38,24,8,9
5978,21801059,Philadelphia 76ers,Charlotte Hornets,118,114,232,4,Philadelphia 76ers,4,0.344,0.75,44,29,5,4,0.257,0.75,46,16,3,2
5979,21801060,Houston Rockets,Atlanta Hawks,121,105,226,16,Houston Rockets,16,0.404,0.733,37,28,13,2,0.375,0.8,45,30,6,1
5980,21801061,Los Angeles Lakers,Milwaukee Bucks,101,115,216,14,Milwaukee Bucks,14,0.372,0.826,42,20,9,5,0.319,0.667,54,25,9,4
5981,21801062,Golden State Warriors,Minnesota Timberwolves,117,107,224,10,Golden State Warriors,10,0.452,0.714,46,39,6,7,0.25,0.813,52,25,7,0
5982,21801063,Brooklyn Nets,Sacramento Kings,123,121,244,2,Brooklyn Nets,2,0.343,0.739,41,28,16,4,0.36,0.7,46,25,13,1
5983,21801064,Indiana Pacers,Los Angeles Clippers,109,115,224,6,Los Angeles Clippers,6,0.333,0.706,46,30,8,6,0.294,0.704,39,28,14,2
5984,21801065,Milwaukee Bucks,Cleveland Cavaliers,102,107,209,5,Cleveland Cavaliers,5,0.406,0.81,51,24,9,7,0.282,0.75,54,18,4,6
5985,21801066,New Orleans Pelicans,Orlando Magic,96,119,215,23,Orlando Magic,23,0.294,0.769,49,24,9,2,0.395,0.857,65,28,8,10
5986,21801067,Boston Celtics,Philadelphia 76ers,115,118,233,3,Philadelphia 76ers,3,0.375,0.813,46,22,1,3,0.333,0.907,54,23,5,5
5987,21801068,Utah Jazz,New York Knicks,137,116,253,21,Utah Jazz,21,0.476,0.84,40,38,7,3,0.419,0.619,40,23,6,6
5988,21801069,Washington Wizards,Chicago Bulls,120,126,246,6,Chicago Bulls,6,0.333,0.783,50,25,10,9,0.522,0.824,48,29,10,2
5989,21801070,Houston Rockets,Memphis Grizzlies,125,126,251,1,Memphis Grizzlies,1,0.438,1,39,19,10,4,0.351,0.795,51,20,8,0
5990,21801071,Miami Heat,San Antonio Spurs,110,105,215,5,Miami Heat,5,0.457,0.778,48,23,6,5,0.412,0.714,46,30,2,3
5991,21801072,Toronto Raptors,Oklahoma City Thunder,123,114,237,9,Toronto Raptors,9,0.389,0.905,52,30,11,5,0.302,0.517,48,22,6,2
5992,21801073,Dallas Mavericks,Portland Trail Blazers,118,126,244,8,Portland Trail Blazers,8,0.333,0.88,35,20,8,6,0.444,0.8,48,23,6,4
5993,21801074,Minnesota Timberwolves,Charlotte Hornets,106,113,219,7,Charlotte Hornets,7,0.357,0.621,49,23,6,7,0.31,0.75,55,26,5,6
5994,21801075,Denver Nuggets,Washington Wizards,113,108,221,5,Denver Nuggets,5,0.467,0.636,40,30,9,4,0.286,0.952,38,25,4,2
5995,21801076,Utah Jazz,Atlanta Hawks,114,117,231,3,Atlanta Hawks,3,0.313,0.692,49,25,12,3,0.475,0.696,43,26,8,5
5996,21801077,Detroit Pistons,Phoenix Suns,118,98,216,20,Detroit Pistons,20,0.405,0.735,46,23,11,6,0.269,0.808,35,22,6,4
5997,21801078,Dallas Mavericks,Sacramento Kings,100,116,216,16,Sacramento Kings,16,0.3,0.696,43,23,5,6,0.371,0.75,58,24,7,9
5998,21801079,Indiana Pacers,Golden State Warriors,89,112,201,23,Golden State Warriors,23,0.261,0.765,47,17,7,3,0.361,0.688,50,32,6,8
5999,21801080,Memphis Grizzlies,Orlando Magic,119,123,242,4,Orlando Magic,4,0.395,0.476,52,28,5,6,0.359,0.778,44,30,6,5
6000,21801081,Los Angeles Clippers,Cleveland Cavaliers,110,108,218,2,Los Angeles Clippers,2,0.231,0.87,43,24,6,6,0.387,0.769,41,14,7,2
6001,21801082,Denver Nuggets,New York Knicks,111,93,204,18,Denver Nuggets,18,0.395,0.842,62,24,5,5,0.281,0.762,45,20,3,5
6002,21801083,Oklahoma City Thunder,Toronto Raptors,116,109,225,7,Oklahoma City Thunder,7,0.465,0.857,39,30,9,6,0.52,0.857,46,20,7,7
6003,21801084,San Antonio Spurs,Houston Rockets,105,111,216,6,Houston Rockets,6,0.292,0.941,48,27,6,7,0.378,0.781,48,12,5,4
6004,21801085,Miami Heat,Milwaukee Bucks,87,116,203,29,Milwaukee Bucks,29,0.297,0.522,40,20,7,6,0.5,0.65,52,33,5,5
6005,21801086,Brooklyn Nets,Los Angeles Lakers,111,106,217,5,Brooklyn Nets,5,0.381,0.75,47,21,8,4,0.25,0.719,59,21,8,9
6006,21801087,Boston Celtics,Charlotte Hornets,117,124,241,7,Charlotte Hornets,7,0.442,0.667,42,31,6,8,0.474,0.786,53,26,7,5
6007,21801088,Philadelphia 76ers,Atlanta Hawks,127,129,256,2,Atlanta Hawks,2,0.435,0.846,52,21,7,4,0.319,0.762,49,28,8,7
6008,21801089,Miami Heat,Washington Wizards,113,108,221,5,Miami Heat,5,0.308,0.684,44,29,5,10,0.3,0.739,53,25,5,2
6009,21801090,Utah Jazz,Chicago Bulls,114,83,197,31,Utah Jazz,31,0.344,0.733,58,27,7,8,0.125,0.75,45,16,6,3
6010,21801091,Minnesota Timberwolves,Memphis Grizzlies,112,99,211,13,Minnesota Timberwolves,13,0.462,0.952,49,25,7,10,0.303,0.773,47,22,8,4
6011,21801092,Dallas Mavericks,Golden State Warriors,126,91,217,35,Dallas Mavericks,35,0.429,0.773,49,33,7,2,0.133,0.714,36,22,6,2
6012,21801093,Detroit Pistons,Portland Trail Blazers,112,117,229,5,Portland Trail Blazers,5,0.412,1,29,24,9,3,0.423,0.741,42,22,4,4
6013,21801094,Phoenix Suns,Sacramento Kings,103,112,215,9,Sacramento Kings,9,0.265,0.846,43,25,10,4,0.447,0.773,51,25,7,3
6014,21801095,Los Angeles Clippers,New York Knicks,124,113,237,11,Los Angeles Clippers,11,0.429,0.892,42,24,7,4,0.273,0.88,44,22,5,7
6015,21801096,Cleveland Cavaliers,Milwaukee Bucks,105,127,232,22,Milwaukee Bucks,22,0.268,0.706,45,23,6,1,0.366,0.762,45,26,8,7
6016,21801097,Denver Nuggets,Indiana Pacers,88,124,212,36,Indiana Pacers,36,0.241,0.938,41,21,5,7,0.444,0.824,49,34,9,5
6017,21801098,Charlotte Hornets,Toronto Raptors,115,114,229,1,Charlotte Hornets,1,0.439,0.882,39,32,12,3,0.423,1,35,29,6,11
6018,21801099,Houston Rockets,New Orleans Pelicans,113,90,203,23,Houston Rockets,23,0.429,0.889,50,24,10,5,0.25,0.7,44,26,9,3
6019,21801100,San Antonio Spurs,Boston Celtics,115,96,211,19,San Antonio Spurs,19,0.333,0.875,51,32,1,4,0.2,0.813,45,23,4,2
6020,21801101,Detroit Pistons,Golden State Warriors,114,121,235,7,Golden State Warriors,7,0.387,0.96,29,25,6,0,0.52,0.842,37,31,3,5
6021,21801102,Sacramento Kings,Los Angeles Lakers,106,111,217,5,Los Angeles Lakers,5,0.424,0.609,50,27,13,4,0.325,0.833,56,29,4,8
6022,21801103,Philadelphia 76ers,Orlando Magic,98,119,217,21,Orlando Magic,21,0.261,0.769,39,20,4,2,0.379,0.783,44,28,9,2
6023,21801104,Oklahoma City Thunder,Memphis Grizzlies,103,115,218,12,Memphis Grizzlies,12,0.333,0.75,41,17,8,4,0.333,0.774,57,31,8,3
6024,21801105,Phoenix Suns,Utah Jazz,92,125,217,33,Utah Jazz,33,0.304,0.821,36,12,8,3,0.476,0.826,43,31,11,4
6025,21801106,Brooklyn Nets,Portland Trail Blazers,144,148,292,4,Portland Trail Blazers,4,0.357,0.705,59,25,3,4,0.311,0.778,55,35,9,5
6026,21801107,San Antonio Spurs,Charlotte Hornets,116,125,241,9,Charlotte Hornets,9,0.333,0.714,60,24,4,5,0.31,0.714,45,30,9,5
6027,21801108,Boston Celtics,Cleveland Cavaliers,116,106,222,10,Boston Celtics,10,0.4,0.737,46,23,8,3,0.321,0.76,36,24,4,1
6028,21801109,Orlando Magic,Miami Heat,104,99,203,5,Orlando Magic,5,0.333,0.696,55,27,5,5,0.303,0.81,39,25,10,1
6029,21801110,Chicago Bulls,Toronto Raptors,103,112,215,9,Toronto Raptors,9,0.348,0.85,45,20,12,2,0.429,1,39,28,13,7
6030,21801111,Houston Rockets,Milwaukee Bucks,94,108,202,14,Milwaukee Bucks,14,0.308,0.857,46,17,7,5,0.412,0.769,60,24,10,6
6031,21801112,Los Angeles Clippers,Minnesota Timberwolves,122,111,233,11,Los Angeles Clippers,11,0.5,1,51,30,8,4,0.333,0.606,43,22,13,1
6032,21801113,Atlanta Hawks,New Orleans Pelicans,130,120,250,10,Atlanta Hawks,10,0.373,0.885,41,30,13,4,0.353,0.75,45,28,10,6
6033,21801114,Sacramento Kings,Dallas Mavericks,125,121,246,4,Sacramento Kings,4,0.435,0.844,37,27,4,1,0.333,0.875,38,27,1,6
6034,21801115,Detroit Pistons,Denver Nuggets,92,95,187,3,Denver Nuggets,3,0.262,0.692,56,19,5,2,0.259,0.7,56,22,3,2
6035,21801116,Washington Wizards,Los Angeles Lakers,106,124,230,18,Los Angeles Lakers,18,0.188,0.815,39,21,5,4,0.333,0.739,52,37,9,5
6036,21801117,Portland Trail Blazers,Chicago Bulls,118,98,216,20,Portland Trail Blazers,20,0.344,0.84,45,30,4,3,0.217,0.789,44,22,4,0
6037,21801118,Golden State Warriors,Memphis Grizzlies,118,103,221,15,Golden State Warriors,15,0.484,0.867,46,30,9,7,0.323,0.714,51,22,11,5
6038,21801119,Indiana Pacers,Oklahoma City Thunder,99,107,206,8,Oklahoma City Thunder,8,0.419,0.545,45,26,4,6,0.361,0.632,44,29,7,7
6039,21801120,Washington Wizards,Phoenix Suns,124,121,245,3,Washington Wizards,3,0.36,0.674,52,18,10,3,0.378,0.808,48,22,9,7
6040,21801121,Los Angeles Lakers,Utah Jazz,100,115,215,15,Utah Jazz,15,0.333,0.708,40,21,9,5,0.313,0.639,54,33,4,5
6041,21801122,Orlando Magic,Detroit Pistons,98,115,213,17,Detroit Pistons,17,0.258,0.8,43,21,5,4,0.486,0.5,43,25,8,9
6042,21801123,Brooklyn Nets,Philadelphia 76ers,110,123,233,13,Philadelphia 76ers,13,0.344,0.655,45,25,4,3,0.48,0.75,45,27,10,3
6043,21801124,Dallas Mavericks,Miami Heat,99,105,204,6,Miami Heat,6,0.34,0.647,50,26,4,2,0.233,0.741,55,24,7,4
6044,21801125,Toronto Raptors,New York Knicks,117,92,209,25,Toronto Raptors,25,0.426,0.773,44,32,8,6,0.231,0.75,54,16,3,5
6045,21801126,Denver Nuggets,Houston Rockets,85,112,197,27,Houston Rockets,27,0.167,0.95,38,22,7,3,0.375,0.85,46,22,8,3
6046,21801127,Los Angeles Clippers,Milwaukee Bucks,118,128,246,10,Milwaukee Bucks,10,0.515,0.773,46,26,7,3,0.432,0.815,47,25,5,5
6047,21801128,Sacramento Kings,New Orleans Pelicans,118,121,239,3,New Orleans Pelicans,3,0.435,0.875,44,28,6,10,0.321,1,45,27,6,6
6048,21801129,Cleveland Cavaliers,San Antonio Spurs,110,116,226,6,San Antonio Spurs,6,0.414,0.8,49,18,6,1,0.424,0.706,33,27,8,6
6049,21801130,Indiana Pacers,Boston Celtics,112,114,226,2,Boston Celtics,2,0.444,0.696,41,27,9,2,0.481,0.765,43,27,8,5
6050,21801131,Portland Trail Blazers,Atlanta Hawks,118,98,216,20,Portland Trail Blazers,20,0.281,0.864,55,19,4,4,0.237,0.929,41,20,5,7
6051,21801132,Golden State Warriors,Minnesota Timberwolves,130,131,261,1,Minnesota Timberwolves,1,0.45,0.714,45,27,11,3,0.368,0.794,59,25,7,3
6052,21801133,Denver Nuggets,Oklahoma City Thunder,115,105,220,10,Denver Nuggets,10,0.424,0.833,39,30,6,1,0.296,0.688,35,19,5,5
6053,21801134,Washington Wizards,Utah Jazz,124,128,252,4,Utah Jazz,4,0.405,0.591,42,32,11,3,0.438,1,44,26,7,7
6054,21801135,Charlotte Hornets,Los Angeles Lakers,115,129,244,14,Los Angeles Lakers,14,0.385,0.941,37,26,8,2,0.474,0.75,44,34,8,2
6055,21801136,Cleveland Cavaliers,Los Angeles Clippers,108,132,240,24,Los Angeles Clippers,24,0.13,0.821,36,18,11,0,0.455,0.688,44,33,5,5
6056,21801137,Boston Celtics,Brooklyn Nets,96,110,206,14,Brooklyn Nets,14,0.4,0.783,39,19,8,7,0.316,0.786,40,22,7,2
6057,21801138,Sacramento Kings,Houston Rockets,108,119,227,11,Houston Rockets,11,0.517,0.6,49,28,3,4,0.327,0.889,38,19,6,2
6058,21801139,Portland Trail Blazers,Detroit Pistons,90,99,189,9,Detroit Pistons,9,0.19,0.909,59,18,7,5,0.2,0.769,45,20,8,6
6059,21801140,Orlando Magic,Indiana Pacers,121,116,237,5,Orlando Magic,5,0.395,0.857,37,37,9,3,0.375,0.647,44,26,4,3
6060,21801141,Miami Heat,New York Knicks,100,92,192,8,Miami Heat,8,0.281,0.765,51,26,11,3,0.237,0.84,42,20,10,7
6061,21801142,Toronto Raptors,Chicago Bulls,124,101,225,23,Toronto Raptors,23,0.474,0.778,47,35,10,4,0.3,0.625,53,21,7,6
6062,21801143,Philadelphia 76ers,Minnesota Timberwolves,118,109,227,9,Philadelphia 76ers,9,0.484,0.714,55,32,5,4,0.423,0.8,36,23,6,6
6063,21801144,Memphis Grizzlies,Phoenix Suns,120,115,235,5,Memphis Grizzlies,5,0.32,0.75,44,24,15,6,0.429,0.739,40,27,8,7
6064,21801145,Milwaukee Bucks,Atlanta Hawks,135,136,271,1,Atlanta Hawks,1,0.309,0.957,71,30,6,3,0.361,0.588,58,36,10,10
6065,21801146,Dallas Mavericks,Oklahoma City Thunder,106,103,209,3,Dallas Mavericks,3,0.364,0.696,52,18,3,2,0.256,0.727,49,19,6,6
6066,21801147,Los Angeles Lakers,New Orleans Pelicans,130,102,232,28,Los Angeles Lakers,28,0.395,0.864,46,30,16,5,0.258,0.857,45,19,5,1
6067,21801148,Washington Wizards,Denver Nuggets,95,90,185,5,Washington Wizards,5,0.25,0.75,54,24,9,6,0.194,0.65,57,18,6,5
6068,21801149,Sacramento Kings,San Antonio Spurs,113,106,219,7,Sacramento Kings,7,0.44,0.857,42,20,9,1,0.296,0.714,42,24,7,3
6069,21801150,Charlotte Hornets,Golden State Warriors,90,137,227,47,Golden State Warriors,47,0.25,0.88,28,24,8,4,0.636,0.833,50,41,7,10
6070,21801151,Memphis Grizzlies,Los Angeles Clippers,96,113,209,17,Los Angeles Clippers,17,0.242,0.828,34,22,13,6,0.259,0.895,47,23,9,5
6071,21801152,Detroit Pistons,Indiana Pacers,102,111,213,9,Indiana Pacers,9,0.364,0.737,41,21,7,5,0.455,0.773,42,27,9,8
6072,21801153,Miami Heat,Boston Celtics,105,110,215,5,Boston Celtics,5,0.27,0.833,48,27,9,6,0.425,0.875,49,25,8,2
6073,21801154,Milwaukee Bucks,Brooklyn Nets,131,121,252,10,Milwaukee Bucks,10,0.324,0.867,40,28,15,7,0.364,0.794,55,19,6,5
6074,21801155,Chicago Bulls,New York Knicks,105,113,218,8,New York Knicks,8,0.235,0.739,44,20,9,2,0.474,0.84,44,24,2,9
6075,21801156,Orlando Magic,Toronto Raptors,109,121,230,12,Toronto Raptors,12,0.364,0.733,46,32,7,8,0.514,0.818,39,31,9,8
6076,21801157,Portland Trail Blazers,Minnesota Timberwolves,132,122,254,10,Portland Trail Blazers,10,0.5,0.708,50,31,6,9,0.379,0.895,37,29,8,3
6077,21801158,Philadelphia 76ers,Dallas Mavericks,102,122,224,20,Dallas Mavericks,20,0.182,0.75,55,20,2,9,0.375,0.667,54,29,5,3
6078,21801159,Charlotte Hornets,Utah Jazz,102,111,213,9,Utah Jazz,9,0.233,0.793,44,15,12,2,0.429,0.769,47,30,7,3
6079,21801160,Cleveland Cavaliers,Phoenix Suns,113,122,235,9,Phoenix Suns,9,0.364,0.682,48,17,5,3,0.351,0.85,40,28,1,11
6080,21801161,Los Angeles Lakers,Oklahoma City Thunder,103,119,222,16,Oklahoma City Thunder,16,0.41,0.7,39,26,7,2,0.295,0.6,50,33,15,7
6081,21801162,Atlanta Hawks,San Antonio Spurs,111,117,228,6,San Antonio Spurs,6,0.353,0.65,43,26,13,2,0.467,0.864,45,23,6,6
6082,21801163,Houston Rockets,Sacramento Kings,130,105,235,25,Houston Rockets,25,0.426,0.706,43,30,8,3,0.304,0.7,51,19,3,4
6083,21801164,Denver Nuggets,Golden State Warriors,102,116,218,14,Golden State Warriors,14,0.233,0.793,40,23,19,4,0.382,0.375,55,36,11,11
6084,21801165,Indiana Pacers,Detroit Pistons,108,89,197,19,Indiana Pacers,19,0.286,0.727,44,31,9,4,0.268,0.667,46,21,6,5
6085,21801166,New York Knicks,Orlando Magic,100,114,214,14,Orlando Magic,14,0.222,0.857,39,21,10,5,0.344,0.65,55,29,5,7
6086,21801167,Chicago Bulls,Washington Wizards,115,114,229,1,Chicago Bulls,1,0.263,0.824,49,22,7,5,0.185,0.731,39,24,8,9
6087,21801168,Philadelphia 76ers,Atlanta Hawks,122,130,252,8,Atlanta Hawks,8,0.323,0.579,57,27,8,4,0.333,0.786,44,29,7,7
6088,21801169,Toronto Raptors,Brooklyn Nets,115,105,220,10,Toronto Raptors,10,0.395,0.857,52,29,9,1,0.313,0.619,53,23,3,2
6089,21801170,Boston Celtics,Miami Heat,112,102,214,10,Boston Celtics,10,0.375,0.871,42,25,8,7,0.333,0.6,47,25,6,5
6090,21801171,Charlotte Hornets,New Orleans Pelicans,115,109,224,6,Charlotte Hornets,6,0.353,0.844,48,19,13,5,0.366,0.824,48,25,7,4
6091,21801172,Minnesota Timberwolves,Dallas Mavericks,110,108,218,2,Minnesota Timberwolves,2,0.37,0.8,38,26,6,3,0.179,0.789,49,26,2,5
6092,21801173,San Antonio Spurs,Denver Nuggets,85,113,198,28,Denver Nuggets,28,0.185,0.72,38,15,9,7,0.364,0.583,47,41,6,3
6093,21801174,Utah Jazz,Phoenix Suns,118,97,215,21,Utah Jazz,21,0.5,0.778,45,30,2,9,0.238,0.615,31,21,7,3
6094,21801175,Memphis Grizzlies,Portland Trail Blazers,89,116,205,27,Portland Trail Blazers,27,0.333,0.842,32,20,10,9,0.323,0.625,54,28,9,3
6095,21801176,Houston Rockets,Los Angeles Clippers,135,103,238,32,Houston Rockets,32,0.474,0.793,48,22,6,7,0.308,0.613,38,27,11,2
6096,21801177,Milwaukee Bucks,Philadelphia 76ers,128,122,250,6,Milwaukee Bucks,6,0.353,0.744,50,26,5,6,0.5,0.778,43,36,4,8
6097,21801178,Cleveland Cavaliers,Sacramento Kings,104,117,221,13,Sacramento Kings,13,0.44,0.556,50,20,3,1,0.368,0.7,36,28,12,3
6098,21801179,Golden State Warriors,Los Angeles Lakers,108,90,198,18,Golden State Warriors,18,0.391,0.8,51,30,11,5,0.216,0.571,62,25,10,7
6099,21801180,Toronto Raptors,Charlotte Hornets,111,113,224,2,Charlotte Hornets,2,0.346,0.8,43,27,2,5,0.333,0.857,40,28,6,2
6100,21801181,Atlanta Hawks,Orlando Magic,113,149,262,36,Orlando Magic,36,0.256,0.677,38,21,16,4,0.486,0.76,54,35,11,4
6101,21801182,San Antonio Spurs,Washington Wizards,129,112,241,17,San Antonio Spurs,17,0.4,0.85,42,34,3,4,0.281,0.864,34,22,2,4
6102,21801183,Boston Celtics,Indiana Pacers,117,97,214,20,Boston Celtics,20,0.259,0.875,49,27,7,6,0.435,0.579,45,24,5,3
6103,21801184,New York Knicks,Houston Rockets,96,120,216,24,Houston Rockets,24,0.222,0.593,53,22,3,6,0.373,0.706,48,26,8,2
6104,21801185,Miami Heat,Minnesota Timberwolves,109,111,220,2,Minnesota Timberwolves,2,0.294,0.75,38,24,10,6,0.333,0.81,43,25,10,2
6105,21801186,Detroit Pistons,Oklahoma City Thunder,110,123,233,13,Oklahoma City Thunder,13,0.366,0.806,32,20,10,8,0.414,0.682,59,30,10,4
6106,21801187,Memphis Grizzlies,Dallas Mavericks,122,112,234,10,Memphis Grizzlies,10,0.39,0.875,50,30,7,2,0.362,0.619,42,28,4,4
6107,21801188,Sacramento Kings,Utah Jazz,98,119,217,21,Utah Jazz,21,0.238,0.68,47,17,7,1,0.455,0.64,46,30,9,6
6108,21801189,New Orleans Pelicans,Phoenix Suns,126,133,259,7,Phoenix Suns,7,0.348,0.741,53,28,4,4,0.389,0.81,46,27,12,11
6109,21801190,Portland Trail Blazers,Denver Nuggets,110,119,229,9,Denver Nuggets,9,0.345,0.8,40,24,6,2,0.259,0.897,39,27,10,4
6110,21801191,Cleveland Cavaliers,Golden State Warriors,114,120,234,6,Golden State Warriors,6,0.233,0.913,48,21,9,1,0.541,1,38,29,2,8
6111,21801192,Los Angeles Lakers,Los Angeles Clippers,122,117,239,5,Los Angeles Lakers,5,0.438,0.815,55,28,8,10,0.345,0.871,45,29,7,8
6112,21801193,Brooklyn Nets,Milwaukee Bucks,133,128,261,5,Brooklyn Nets,5,0.422,0.783,43,25,7,0,0.471,0.667,43,28,7,4
6113,21801194,Philadelphia 76ers,Chicago Bulls,116,96,212,20,Philadelphia 76ers,20,0.333,0.577,54,25,5,5,0.32,0.8,38,22,4,3
6114,21801195,Miami Heat,Toronto Raptors,109,117,226,8,Toronto Raptors,8,0.382,0.737,55,27,5,2,0.39,0.852,47,26,7,5
6115,21801196,San Antonio Spurs,Cleveland Cavaliers,112,90,202,22,San Antonio Spurs,22,0.409,0.773,49,27,10,5,0.276,0.741,35,16,14,1
6116,21801197,Oklahoma City Thunder,Minnesota Timberwolves,132,126,258,6,Oklahoma City Thunder,6,0.412,0.846,46,27,6,4,0.435,0.828,32,29,9,5
6117,21801198,Charlotte Hornets,Detroit Pistons,104,91,195,13,Charlotte Hornets,13,0.323,0.783,44,23,5,3,0.244,0.867,55,20,3,7
6118,21801199,Brooklyn Nets,Indiana Pacers,108,96,204,12,Brooklyn Nets,12,0.306,0.773,52,23,7,4,0.37,0.571,33,27,6,3
6119,21801200,Phoenix Suns,Houston Rockets,113,149,262,36,Houston Rockets,36,0.324,0.762,42,26,8,0,0.474,0.762,52,34,12,5
6120,21801201,Dallas Mavericks,Memphis Grizzlies,129,127,256,2,Dallas Mavericks,2,0.293,0.794,51,31,4,5,0.432,0.857,53,32,4,4
6121,21801202,Atlanta Hawks,Milwaukee Bucks,107,115,222,8,Milwaukee Bucks,8,0.378,0.526,48,25,2,3,0.22,0.765,61,19,8,10
6122,21801203,Orlando Magic,Boston Celtics,116,108,224,8,Orlando Magic,8,0.364,1,45,29,9,7,0.387,0.857,39,28,9,4
6123,21801204,Washington Wizards,New York Knicks,110,113,223,3,New York Knicks,3,0.294,0.778,50,24,12,4,0.5,0.737,43,24,5,9
6124,21801205,Los Angeles Clippers,Golden State Warriors,104,131,235,27,Golden State Warriors,27,0.526,0.621,39,26,7,4,0.324,0.867,48,34,16,8
6125,21801206,Denver Nuggets,Portland Trail Blazers,108,115,223,7,Portland Trail Blazers,7,0.394,0.55,42,24,9,4,0.321,0.828,58,22,5,5
6126,21801207,New Orleans Pelicans,Sacramento Kings,133,129,262,4,New Orleans Pelicans,4,0.452,0.833,55,28,4,11,0.4,0.765,47,27,10,4
6127,21801208,Utah Jazz,Los Angeles Lakers,109,113,222,4,Los Angeles Lakers,4,0.31,0.714,35,25,11,4,0.28,0.667,49,28,5,5
6128,21801209,Charlotte Hornets,Cleveland Cavaliers,124,97,221,27,Charlotte Hornets,27,0.5,0.706,37,35,8,7,0.367,0.75,41,24,3,2
6129,21801210,Memphis Grizzlies,Detroit Pistons,93,100,193,7,Detroit Pistons,7,0.417,0.81,43,19,4,6,0.294,0.714,40,16,13,4
6130,21801211,Boston Celtics,Washington Wizards,116,110,226,6,Boston Celtics,6,0.341,0.478,50,27,10,3,0.359,0.778,58,28,2,3
6131,21801212,Philadelphia 76ers,Miami Heat,99,122,221,23,Miami Heat,23,0.2,0.875,46,22,11,0,0.481,0.739,44,29,6,10
6132,21801213,New York Knicks,Chicago Bulls,96,86,182,10,New York Knicks,10,0.35,0.615,61,17,0,10,0.318,0.655,50,14,7,4
6133,21801214,Toronto Raptors,Minnesota Timberwolves,120,100,220,20,Toronto Raptors,20,0.432,0.706,54,24,10,5,0.31,0.786,35,26,10,9
6134,21801215,Golden State Warriors,New Orleans Pelicans,112,103,215,9,Golden State Warriors,9,0.4,0.667,58,25,8,3,0.273,0.6,42,29,9,1
6135,21801216,Phoenix Suns,Dallas Mavericks,109,120,229,11,Dallas Mavericks,11,0.371,0.714,38,21,13,6,0.4,0.815,64,28,6,6
6136,21801217,Denver Nuggets,Utah Jazz,108,118,226,10,Utah Jazz,10,0.48,0.636,31,24,9,3,0.37,0.765,48,24,5,5
6137,21801218,Houston Rockets,Oklahoma City Thunder,111,112,223,1,Oklahoma City Thunder,1,0.34,0.85,42,18,7,7,0.39,0.8,56,20,5,2
6138,21801219,Portland Trail Blazers,Los Angeles Lakers,104,101,205,3,Portland Trail Blazers,3,0.297,0.864,45,18,8,10,0.345,0.647,51,29,6,6
6139,21801220,Indiana Pacers,Atlanta Hawks,135,134,269,1,Indiana Pacers,1,0.4,0.846,43,22,12,7,0.415,0.816,61,29,5,7
6140,21801221,Miami Heat,Brooklyn Nets,94,113,207,19,Brooklyn Nets,19,0.195,0.667,54,22,9,4,0.362,0.857,68,29,7,3
6141,21801222,Orlando Magic,Charlotte Hornets,122,114,236,8,Orlando Magic,8,0.367,0.75,39,24,5,2,0.276,0.889,32,21,3,4
6142,21801223,Detroit Pistons,New York Knicks,115,89,204,26,Detroit Pistons,26,0.424,0.95,56,25,5,2,0.3,0.72,33,23,7,5
6143,21801224,Chicago Bulls,Philadelphia 76ers,109,125,234,16,Philadelphia 76ers,16,0.375,0.667,39,21,4,3,0.462,0.6,47,30,4,10
6144,21801225,Golden State Warriors,Memphis Grizzlies,117,132,249,15,Memphis Grizzlies,15,0.433,0.857,39,32,3,5,0.457,0.833,49,25,9,0
6145,21801226,Oklahoma City Thunder,Milwaukee Bucks,127,116,243,11,Oklahoma City Thunder,11,0.426,0.615,53,40,7,3,0.326,0.714,53,27,7,1
6146,21801227,Dallas Mavericks,San Antonio Spurs,94,105,199,11,San Antonio Spurs,11,0.297,0.75,42,27,5,4,0.333,0.833,53,22,6,2
6147,21801228,Minnesota Timberwolves,Denver Nuggets,95,99,194,4,Denver Nuggets,4,0.406,0.667,41,24,6,0,0.303,0.647,53,23,6,4
6148,21801229,Utah Jazz,Los Angeles Clippers,137,143,280,6,Los Angeles Clippers,6,0.4,0.879,57,31,8,11,0.429,0.767,52,34,7,5
6149,21801230,Sacramento Kings,Portland Trail Blazers,131,136,267,5,Portland Trail Blazers,5,0.419,0.813,35,25,5,1,0.583,0.727,44,19,5,2
6150,21900001,New Orleans Pelicans,Toronto Raptors,122,130,252,8,Toronto Raptors,8,0.422,0.85,53,30,4,9,0.35,0.842,57,23,7,3
6151,21900002,Los Angeles Lakers,Los Angeles Clippers,102,112,214,10,Los Angeles Clippers,10,0.394,0.714,41,20,4,7,0.355,0.708,45,24,8,5
6152,21900003,Chicago Bulls,Charlotte Hornets,125,126,251,1,Charlotte Hornets,1,0.3,0.818,49,25,11,4,0.523,0.813,41,28,3,4
6153,21900004,Detroit Pistons,Indiana Pacers,119,110,229,9,Detroit Pistons,9,0.458,0.788,45,26,5,6,0.381,0.833,36,26,8,6
6154,21900005,Cleveland Cavaliers,Orlando Magic,85,94,179,9,Orlando Magic,9,0.265,0.667,54,20,8,2,0.3,0.579,46,24,12,4
6155,21900006,Minnesota Timberwolves,Brooklyn Nets,127,126,253,1,Minnesota Timberwolves,1,0.302,0.786,52,23,9,4,0.441,0.577,48,19,8,9
6156,21900007,Memphis Grizzlies,Miami Heat,101,120,221,19,Miami Heat,19,0.156,0.667,40,22,9,7,0.389,0.846,51,18,9,8
6157,21900008,Boston Celtics,Philadelphia 76ers,93,107,200,14,Philadelphia 76ers,14,0.269,0.588,41,18,4,2,0.241,0.722,62,24,6,7
6158,21900009,Washington Wizards,Dallas Mavericks,100,108,208,8,Dallas Mavericks,8,0.268,0.833,47,26,6,3,0.306,0.818,46,17,6,5
6159,21900010,New York Knicks,San Antonio Spurs,111,120,231,9,San Antonio Spurs,9,0.333,0.722,39,24,16,1,0.333,0.806,51,22,6,5
6160,21900011,Oklahoma City Thunder,Utah Jazz,95,100,195,5,Utah Jazz,5,0.37,0.677,48,15,5,4,0.25,0.7,49,15,4,5
6161,21900012,Sacramento Kings,Phoenix Suns,95,124,219,29,Phoenix Suns,29,0.345,0.654,47,17,5,5,0.333,0.833,44,31,13,9
6162,21900013,Denver Nuggets,Portland Trail Blazers,108,100,208,8,Denver Nuggets,8,0.563,0.815,45,24,11,4,0.25,0.913,48,13,9,4
6163,21900014,Atlanta Hawks,Detroit Pistons,117,100,217,17,Atlanta Hawks,17,0.355,0.857,42,27,9,2,0.27,0.909,39,20,6,5
6164,21900015,Milwaukee Bucks,Houston Rockets,117,111,228,6,Milwaukee Bucks,6,0.348,0.5,53,31,7,10,0.333,0.744,57,25,6,6
6165,21900016,Los Angeles Clippers,Golden State Warriors,141,122,263,19,Los Angeles Clippers,19,0.563,0.767,39,33,7,5,0.357,0.967,42,27,7,0
6166,21900017,Toronto Raptors,Boston Celtics,106,112,218,6,Boston Celtics,6,0.5,0.824,46,22,2,6,0.342,0.938,56,21,10,8
6167,21900018,Minnesota Timberwolves,Charlotte Hornets,121,99,220,22,Minnesota Timberwolves,22,0.316,0.742,52,30,11,6,0.414,0.5,42,26,6,5
6168,21900019,New York Knicks,Brooklyn Nets,109,113,222,4,Brooklyn Nets,4,0.68,0.571,39,17,14,4,0.432,0.676,46,21,11,2
6169,21900020,Chicago Bulls,Memphis Grizzlies,110,102,212,8,Chicago Bulls,8,0.286,0.75,45,18,14,7,0.345,0.7,56,24,8,6
6170,21900021,Dallas Mavericks,New Orleans Pelicans,123,116,239,7,Dallas Mavericks,7,0.35,0.731,49,23,8,7,0.366,0.733,48,30,6,3
6171,21900022,Washington Wizards,Oklahoma City Thunder,97,85,182,12,Washington Wizards,12,0.268,0.8,47,21,9,6,0.217,0.636,49,14,7,6
6172,21900023,Phoenix Suns,Denver Nuggets,107,108,215,1,Denver Nuggets,1,0.286,0.969,54,25,5,1,0.259,0.806,45,21,7,12
6173,21900024,Portland Trail Blazers,Sacramento Kings,122,112,234,10,Portland Trail Blazers,10,0.367,0.864,40,23,8,5,0.405,0.852,43,17,10,2
6174,21900025,Utah Jazz,Los Angeles Lakers,86,95,181,9,Los Angeles Lakers,9,0.32,0.952,40,19,8,2,0.308,0.792,42,19,14,9
6175,21900026,Miami Heat,Milwaukee Bucks,131,126,257,5,Miami Heat,5,0.364,0.639,54,33,7,3,0.315,0.771,47,22,8,4
6176,21900027,Philadelphia 76ers,Detroit Pistons,117,111,228,6,Philadelphia 76ers,6,0.382,0.667,38,30,14,3,0.421,0.583,35,20,11,7
6177,21900028,Orlando Magic,Atlanta Hawks,99,103,202,4,Atlanta Hawks,4,0.161,0.923,46,15,8,7,0.3,0.533,52,22,5,9
6178,21900029,Boston Celtics,New York Knicks,118,95,213,23,Boston Celtics,23,0.366,0.655,46,24,14,9,0.259,0.765,55,15,7,4
6179,21900030,Indiana Pacers,Cleveland Cavaliers,99,110,209,11,Cleveland Cavaliers,11,0.357,0.846,36,23,7,3,0.355,0.655,44,23,9,7
6180,21900031,Toronto Raptors,Chicago Bulls,108,84,192,24,Toronto Raptors,24,0.357,0.944,59,27,9,12,0.257,0.68,45,18,9,2
6181,21900032,New Orleans Pelicans,Houston Rockets,123,126,249,3,Houston Rockets,3,0.36,0.813,42,27,9,2,0.289,0.9,45,27,7,4
6182,21900033,Washington Wizards,San Antonio Spurs,122,124,246,2,San Antonio Spurs,2,0.471,0.706,41,30,3,8,0.357,0.824,53,29,6,7
6183,21900034,Sacramento Kings,Utah Jazz,81,113,194,32,Utah Jazz,32,0.269,0.824,31,16,5,3,0.486,0.583,43,28,6,1
6184,21900035,Los Angeles Clippers,Phoenix Suns,122,130,252,8,Phoenix Suns,8,0.344,0.795,41,20,8,4,0.395,0.794,49,32,9,3
6185,21900036,Golden State Warriors,Oklahoma City Thunder,92,120,212,28,Oklahoma City Thunder,28,0.152,0.871,39,17,13,2,0.469,0.773,50,24,8,5
6186,21900037,Brooklyn Nets,Memphis Grizzlies,133,134,267,1,Memphis Grizzlies,1,0.333,0.811,53,28,6,5,0.424,0.8,49,33,9,10
6187,21900038,Portland Trail Blazers,Dallas Mavericks,121,119,240,2,Portland Trail Blazers,2,0.409,0.846,48,13,6,4,0.26,0.78,46,27,7,3
6188,21900039,Miami Heat,Minnesota Timberwolves,109,116,225,7,Minnesota Timberwolves,7,0.417,0.667,41,25,7,9,0.289,0.758,46,24,12,1
6189,21900040,Charlotte Hornets,Los Angeles Lakers,101,120,221,19,Los Angeles Lakers,19,0.286,0.913,45,19,7,4,0.355,0.786,47,30,7,8
6190,21900041,Indiana Pacers,Detroit Pistons,94,96,190,2,Detroit Pistons,2,0.286,0.769,45,24,11,4,0.542,0.9,48,21,2,3
6191,21900042,Chicago Bulls,New York Knicks,98,105,203,7,New York Knicks,7,0.257,0.81,38,19,6,5,0.31,0.625,63,19,3,6
6192,21900043,Philadelphia 76ers,Atlanta Hawks,105,103,208,2,Philadelphia 76ers,2,0.268,0.8,49,22,12,11,0.333,0.688,45,23,12,3
6193,21900044,Orlando Magic,Toronto Raptors,95,104,199,9,Toronto Raptors,9,0.308,0.833,47,22,9,6,0.256,0.933,52,19,9,2
6194,21900045,Oklahoma City Thunder,Houston Rockets,112,116,228,4,Houston Rockets,4,0.371,0.708,52,22,7,3,0.227,0.848,40,21,6,6
6195,21900046,Cleveland Cavaliers,Milwaukee Bucks,112,129,241,17,Milwaukee Bucks,17,0.308,0.833,48,19,2,3,0.447,0.667,50,29,9,7
6196,21900047,Golden State Warriors,New Orleans Pelicans,134,123,257,11,Golden State Warriors,11,0.4,0.75,61,37,8,2,0.319,0.545,41,36,13,7
6197,21900048,Portland Trail Blazers,San Antonio Spurs,110,113,223,3,San Antonio Spurs,3,0.303,0.815,49,19,4,8,0.318,0.75,50,25,5,9
6198,21900049,Utah Jazz,Phoenix Suns,96,95,191,1,Utah Jazz,1,0.323,0.821,49,19,8,5,0.382,0.696,40,23,7,3
6199,21900050,Denver Nuggets,Sacramento Kings,101,94,195,7,Denver Nuggets,7,0.278,0.905,54,19,8,5,0.324,0.625,48,25,6,8
6200,21900051,Charlotte Hornets,Los Angeles Clippers,96,111,207,15,Los Angeles Clippers,15,0.359,0.714,38,24,5,3,0.364,0.905,44,23,11,8
6201,21900052,Atlanta Hawks,Miami Heat,97,112,209,15,Miami Heat,15,0.282,0.667,33,28,14,7,0.419,0.733,49,19,11,6
6202,21900053,Dallas Mavericks,Denver Nuggets,109,106,215,3,Dallas Mavericks,3,0.351,0.583,42,29,6,5,0.344,0.692,50,24,6,1
6203,21900054,Memphis Grizzlies,Los Angeles Lakers,91,120,211,29,Los Angeles Lakers,29,0.206,0.957,46,20,10,3,0.269,0.846,54,25,9,8
6204,21900055,Chicago Bulls,Cleveland Cavaliers,111,117,228,6,Cleveland Cavaliers,6,0.359,0.826,32,25,6,5,0.417,0.806,47,25,3,7
6205,21900056,New York Knicks,Orlando Magic,83,95,178,12,Orlando Magic,12,0.226,0.7,44,19,1,10,0.375,0.75,52,24,5,6
6206,21900057,Minnesota Timberwolves,Philadelphia 76ers,95,117,212,22,Philadelphia 76ers,22,0.286,0.75,34,12,13,6,0.36,0.786,56,24,14,6
6207,21900058,Milwaukee Bucks,Boston Celtics,105,116,221,11,Boston Celtics,11,0.311,0.625,45,21,3,4,0.415,0.81,45,25,4,4
6208,21900059,Indiana Pacers,Brooklyn Nets,118,108,226,10,Indiana Pacers,10,0.423,0.85,41,25,9,2,0.323,0.615,54,21,6,5
6209,21900060,Detroit Pistons,Toronto Raptors,113,125,238,12,Toronto Raptors,12,0.467,0.739,42,30,5,1,0.481,0.833,34,30,12,2
6210,21900061,Houston Rockets,Washington Wizards,159,158,317,1,Houston Rockets,1,0.426,0.788,44,34,10,5,0.556,0.828,40,31,6,4
6211,21900062,Portland Trail Blazers,Oklahoma City Thunder,102,99,201,3,Portland Trail Blazers,3,0.486,0.708,49,19,9,8,0.148,0.784,55,15,8,2
6212,21900063,Los Angeles Clippers,Utah Jazz,96,110,206,14,Utah Jazz,14,0.348,0.833,36,19,3,4,0.458,0.688,36,23,12,5
6213,21900064,Charlotte Hornets,Sacramento Kings,118,111,229,7,Charlotte Hornets,7,0.5,0.714,46,30,8,3,0.304,0.75,39,26,11,5
6214,21900065,Phoenix Suns,Golden State Warriors,121,110,231,11,Phoenix Suns,11,0.417,0.857,45,33,12,4,0.286,0.833,43,24,8,6
6215,21900066,Miami Heat,Atlanta Hawks,106,97,203,9,Miami Heat,9,0.378,0.632,41,29,12,9,0.206,0.692,50,20,5,5
6216,21900067,Denver Nuggets,New Orleans Pelicans,107,122,229,15,New Orleans Pelicans,15,0.269,0.875,35,24,5,3,0.455,0.781,37,30,7,4
6217,21900068,San Antonio Spurs,Los Angeles Clippers,97,103,200,6,Los Angeles Clippers,6,0.333,0.667,49,15,6,5,0.192,0.741,47,16,9,1
6218,21900069,Houston Rockets,Brooklyn Nets,116,123,239,7,Brooklyn Nets,7,0.25,0.815,40,21,13,4,0.594,0.714,55,26,8,7
6219,21900070,Cleveland Cavaliers,Indiana Pacers,95,102,197,7,Indiana Pacers,7,0.344,0.8,45,20,9,1,0.185,0.905,58,20,8,10
6220,21900071,Milwaukee Bucks,Orlando Magic,123,91,214,32,Milwaukee Bucks,32,0.362,0.667,58,24,11,4,0.324,0.647,40,21,8,3
6221,21900072,New York Knicks,Boston Celtics,102,104,206,2,Boston Celtics,2,0.368,0.667,51,22,9,4,0.324,0.931,44,21,7,4
6222,21900073,Detroit Pistons,Chicago Bulls,106,112,218,6,Chicago Bulls,6,0.207,0.75,47,21,11,8,0.4,0.783,42,29,6,1
6223,21900074,Los Angeles Lakers,Dallas Mavericks,119,110,229,9,Los Angeles Lakers,9,0.281,0.762,41,24,11,7,0.389,0.696,61,23,5,1
6224,21900075,Utah Jazz,Sacramento Kings,101,102,203,1,Sacramento Kings,1,0.393,0.741,36,18,12,5,0.276,0.706,38,15,8,3
6225,21900076,San Antonio Spurs,Golden State Warriors,127,110,237,17,San Antonio Spurs,17,0.371,0.867,52,23,4,2,0.464,0.905,39,25,4,2
6226,21900077,New Orleans Pelicans,Oklahoma City Thunder,104,115,219,11,Oklahoma City Thunder,11,0.344,0.591,56,25,7,5,0.405,0.783,44,20,8,11
6227,21900078,Brooklyn Nets,Detroit Pistons,109,113,222,4,Detroit Pistons,4,0.313,0.765,48,24,4,4,0.296,0.793,41,21,8,7
6228,21900079,Denver Nuggets,Orlando Magic,91,87,178,4,Denver Nuggets,4,0.321,0.718,41,15,8,3,0.207,0.636,47,22,8,7
6229,21900080,Minnesota Timberwolves,Washington Wizards,131,109,240,22,Minnesota Timberwolves,22,0.436,0.706,47,33,9,10,0.343,0.852,39,21,11,4
6230,21900081,Phoenix Suns,Memphis Grizzlies,114,105,219,9,Phoenix Suns,9,0.412,0.75,32,26,9,2,0.321,0.632,46,26,9,8
6231,21900082,Toronto Raptors,Milwaukee Bucks,105,115,220,10,Milwaukee Bucks,10,0.417,0.88,42,24,5,6,0.342,0.8,51,30,4,7
6232,21900083,Charlotte Hornets,Golden State Warriors,93,87,180,6,Charlotte Hornets,6,0.172,0.696,48,18,6,1,0.321,0.769,40,23,5,5
6233,21900084,Philadelphia 76ers,Portland Trail Blazers,129,128,257,1,Philadelphia 76ers,1,0.333,0.833,46,36,11,8,0.559,0.76,36,21,7,4
6234,21900085,Chicago Bulls,Indiana Pacers,95,108,203,13,Indiana Pacers,13,0.31,0.56,42,27,8,2,0.308,0.741,49,28,6,10
6235,21900086,Houston Rockets,Miami Heat,100,129,229,29,Miami Heat,29,0.292,0.774,38,19,6,5,0.439,0.773,46,38,14,7
6236,21900087,Sacramento Kings,New York Knicks,113,92,205,21,Sacramento Kings,21,0.385,0.64,50,25,7,5,0.258,0.645,38,18,6,5
6237,21900088,Los Angeles Lakers,San Antonio Spurs,103,96,199,7,Los Angeles Lakers,7,0.25,0.684,46,21,8,10,0.24,0.828,47,23,11,4
6238,21900089,Dallas Mavericks,Cleveland Cavaliers,131,111,242,20,Dallas Mavericks,20,0.488,0.846,51,34,5,6,0.375,0.682,41,24,9,4
6239,21900090,Utah Jazz,Los Angeles Clippers,94,105,199,11,Los Angeles Clippers,11,0.323,0.71,37,16,4,6,0.219,0.765,54,15,7,6
6240,21900091,Detroit Pistons,Washington Wizards,99,115,214,16,Washington Wizards,16,0.481,0.783,42,21,4,9,0.276,0.84,41,27,9,7
6241,21900092,New Orleans Pelicans,Brooklyn Nets,125,135,260,10,Brooklyn Nets,10,0.406,0.762,39,18,16,5,0.39,0.75,45,32,13,3
6242,21900093,Houston Rockets,Memphis Grizzlies,107,100,207,7,Houston Rockets,7,0.34,0.69,51,20,6,5,0.12,0.81,51,19,13,7
6243,21900094,Milwaukee Bucks,Minnesota Timberwolves,134,106,240,28,Milwaukee Bucks,28,0.359,0.667,57,24,8,6,0.302,0.864,47,20,12,4
6244,21900095,Philadelphia 76ers,Phoenix Suns,109,114,223,5,Phoenix Suns,5,0.448,0.6,38,21,11,2,0.393,0.778,40,24,6,5
6245,21900096,Portland Trail Blazers,Golden State Warriors,118,127,245,9,Golden State Warriors,9,0.325,0.786,44,16,5,6,0.385,0.917,47,28,4,4
6246,21900097,Indiana Pacers,Charlotte Hornets,120,122,242,2,Charlotte Hornets,2,0.4,0.857,43,27,5,7,0.323,0.667,37,22,7,4
6247,21900098,Boston Celtics,Cleveland Cavaliers,119,113,232,6,Boston Celtics,6,0.4,0.733,45,24,5,12,0.394,0.909,43,22,3,6
6248,21900099,San Antonio Spurs,Atlanta Hawks,100,108,208,8,Atlanta Hawks,8,0.242,0.696,41,18,9,8,0.367,0.688,48,22,9,5
6249,21900100,Los Angeles Lakers,Chicago Bulls,118,112,230,6,Los Angeles Lakers,6,0.333,0.708,49,26,10,10,0.438,0.522,42,22,11,4
6250,21900101,Orlando Magic,Oklahoma City Thunder,94,102,196,8,Oklahoma City Thunder,8,0.136,0.871,53,15,5,8,0.364,0.8,38,21,9,5
6251,21900102,Miami Heat,Denver Nuggets,89,109,198,20,Denver Nuggets,20,0.31,0.64,44,23,12,5,0.391,0.625,47,35,10,3
6252,21900103,New York Knicks,Detroit Pistons,102,122,224,20,Detroit Pistons,20,0.44,0.619,30,24,9,4,0.5,0.792,43,37,7,1
6253,21900104,Washington Wizards,Indiana Pacers,106,121,227,15,Indiana Pacers,15,0.325,1,48,24,3,3,0.4,0.808,48,35,8,3
6254,21900105,Chicago Bulls,Atlanta Hawks,113,93,206,20,Chicago Bulls,20,0.394,0.667,43,26,11,9,0.2,0.771,41,18,7,3
6255,21900106,Sacramento Kings,Toronto Raptors,120,124,244,4,Toronto Raptors,4,0.455,0.762,43,23,8,7,0.483,0.828,37,28,10,4
6256,21900107,Golden State Warriors,Houston Rockets,112,129,241,17,Houston Rockets,17,0.394,0.821,51,22,7,1,0.467,0.632,50,31,7,9
6257,21900108,Minnesota Timberwolves,Memphis Grizzlies,121,137,258,16,Memphis Grizzlies,16,0.356,0.731,36,29,9,7,0.522,0.833,49,34,4,3
6258,21900109,Orlando Magic,Dallas Mavericks,106,107,213,1,Dallas Mavericks,1,0.25,0.786,44,25,14,10,0.355,0.8,43,20,4,1
6259,21900110,Philadelphia 76ers,Utah Jazz,104,106,210,2,Utah Jazz,2,0.32,0.882,42,20,9,3,0.364,0.667,50,21,9,4
6260,21900111,Milwaukee Bucks,Los Angeles Clippers,129,124,253,5,Milwaukee Bucks,5,0.367,0.794,54,18,7,11,0.419,0.806,54,21,4,3
6261,21900112,Boston Celtics,Charlotte Hornets,108,87,195,21,Boston Celtics,21,0.303,0.783,52,29,13,5,0.194,0.714,49,21,7,9
6262,21900113,Oklahoma City Thunder,San Antonio Spurs,112,121,233,9,San Antonio Spurs,9,0.476,0.75,31,26,7,2,0.45,0.909,47,32,5,3
6263,21900114,Miami Heat,Phoenix Suns,124,108,232,16,Miami Heat,16,0.536,0.792,41,22,9,5,0.344,0.742,40,22,4,3
6264,21900115,Portland Trail Blazers,Los Angeles Clippers,101,107,208,6,Los Angeles Clippers,6,0.282,0.75,51,18,7,4,0.174,0.833,57,20,6,12
6265,21900116,Detroit Pistons,Indiana Pacers,106,112,218,6,Indiana Pacers,6,0.394,0.833,40,27,6,4,0.267,0.88,44,23,6,8
6266,21900117,Memphis Grizzlies,Orlando Magic,86,118,204,32,Orlando Magic,32,0.379,0.846,36,23,3,5,0.25,0.852,57,24,10,10
6267,21900118,Cleveland Cavaliers,Washington Wizards,113,100,213,13,Cleveland Cavaliers,13,0.222,0.862,48,18,10,5,0.226,0.5,47,26,5,5
6268,21900119,Sacramento Kings,Atlanta Hawks,121,109,230,12,Sacramento Kings,12,0.581,0.864,36,27,7,7,0.321,0.571,34,23,8,6
6269,21900120,Golden State Warriors,Minnesota Timberwolves,119,125,244,6,Minnesota Timberwolves,6,0.286,0.958,49,18,12,9,0.25,0.69,59,20,10,10
6270,21900121,Toronto Raptors,New Orleans Pelicans,122,104,226,18,Toronto Raptors,18,0.442,0.875,53,27,9,3,0.244,0.667,53,21,7,6
6271,21900122,New York Knicks,Dallas Mavericks,106,102,208,4,New York Knicks,4,0.5,0.581,56,19,9,3,0.318,0.824,47,18,4,6
6272,21900123,Philadelphia 76ers,Denver Nuggets,97,100,197,3,Denver Nuggets,3,0.5,0.471,49,28,8,8,0.409,0.765,41,28,10,11
6273,21900124,Milwaukee Bucks,Utah Jazz,100,103,203,3,Utah Jazz,3,0.278,0.733,54,14,8,4,0.417,0.69,56,15,3,1
6274,21900125,Brooklyn Nets,Portland Trail Blazers,119,115,234,4,Brooklyn Nets,4,0.432,0.7,51,18,6,9,0.367,0.96,48,11,3,9
6275,21900126,Miami Heat,Los Angeles Lakers,80,95,175,15,Los Angeles Lakers,15,0.171,0.75,37,18,9,2,0.25,0.875,48,30,6,5
6276,21900127,Boston Celtics,San Antonio Spurs,135,115,250,20,Boston Celtics,20,0.378,0.893,43,28,11,11,0.467,0.767,57,24,1,8
6277,21900128,New Orleans Pelicans,Charlotte Hornets,115,110,225,5,New Orleans Pelicans,5,0.424,0.7,45,25,13,6,0.343,0.765,42,27,10,2
6278,21900129,Houston Rockets,Chicago Bulls,117,94,211,23,Houston Rockets,23,0.432,0.714,55,18,12,7,0.125,0.889,46,21,14,5
6279,21900130,Dallas Mavericks,Memphis Grizzlies,138,122,260,16,Dallas Mavericks,16,0.429,0.8,47,27,8,5,0.333,0.714,39,31,10,6
6280,21900131,Golden State Warriors,Oklahoma City Thunder,108,114,222,6,Oklahoma City Thunder,6,0.318,1,34,22,9,6,0.467,0.824,42,30,7,5
6281,21900132,Denver Nuggets,Minnesota Timberwolves,100,98,198,2,Denver Nuggets,2,0.393,0.647,57,26,6,4,0.133,0.727,53,22,9,10
6282,21900133,Indiana Pacers,Orlando Magic,109,102,211,7,Indiana Pacers,7,0.45,0.8,43,31,6,3,0.417,0.833,37,27,5,11
6283,21900134,Charlotte Hornets,Philadelphia 76ers,106,114,220,8,Philadelphia 76ers,8,0.424,0.727,31,22,9,1,0.357,0.75,49,29,9,5
6284,21900135,Milwaukee Bucks,Oklahoma City Thunder,121,119,240,2,Milwaukee Bucks,2,0.393,0.889,48,27,9,4,0.405,0.706,35,31,11,4
6285,21900136,Cleveland Cavaliers,New York Knicks,108,87,195,21,Cleveland Cavaliers,21,0.286,0.903,45,20,11,2,0.29,0.64,52,19,11,8
6286,21900137,Brooklyn Nets,Phoenix Suns,112,138,250,26,Phoenix Suns,26,0.235,0.941,43,27,4,2,0.452,0.789,42,37,8,7
6287,21900138,Atlanta Hawks,Portland Trail Blazers,113,124,237,11,Portland Trail Blazers,11,0.268,0.72,48,21,11,8,0.333,0.786,61,19,10,9
6288,21900139,Toronto Raptors,Los Angeles Lakers,113,104,217,9,Toronto Raptors,9,0.333,0.682,43,26,6,8,0.333,0.632,51,31,6,7
6289,21900140,Minnesota Timberwolves,Detroit Pistons,120,114,234,6,Minnesota Timberwolves,6,0.441,0.789,45,25,7,6,0.5,0.8,39,25,9,5
6290,21900141,Dallas Mavericks,Boston Celtics,106,116,222,10,Boston Celtics,10,0.262,0.75,46,22,2,5,0.429,0.76,46,25,4,5
6291,21900142,Houston Rockets,New Orleans Pelicans,122,116,238,6,Houston Rockets,6,0.293,0.688,47,16,9,6,0.311,0.741,46,26,8,3
6292,21900143,Memphis Grizzlies,San Antonio Spurs,113,109,222,4,Memphis Grizzlies,4,0.393,0.7,47,32,7,5,0.4,0.765,42,29,4,4
6293,21900144,Utah Jazz,Golden State Warriors,122,108,230,14,Utah Jazz,14,0.457,0.813,43,30,3,3,0.323,0.571,44,23,8,2
6294,21900145,Toronto Raptors,Los Angeles Clippers,88,98,186,10,Los Angeles Clippers,10,0.367,0.6,38,25,9,8,0.222,0.733,66,25,9,7
6295,21900146,Oklahoma City Thunder,Indiana Pacers,85,111,196,26,Indiana Pacers,26,0.24,0.875,40,19,9,4,0.304,0.923,50,21,6,4
6296,21900147,Cleveland Cavaliers,Philadelphia 76ers,97,98,195,1,Philadelphia 76ers,1,0.238,0.8,45,13,10,0,0.211,0.769,46,24,8,8
6297,21900148,Detroit Pistons,Miami Heat,108,117,225,9,Miami Heat,9,0.366,0.676,32,27,9,9,0.438,0.778,42,34,6,1
6298,21900149,New York Knicks,Chicago Bulls,102,120,222,18,Chicago Bulls,18,0.313,0.645,38,27,12,1,0.424,0.774,46,22,9,2
6299,21900150,Atlanta Hawks,Denver Nuggets,125,121,246,4,Atlanta Hawks,4,0.441,0.647,45,30,1,5,0.268,0.818,40,31,7,5
6300,21900151,Los Angeles Lakers,Phoenix Suns,123,115,238,8,Los Angeles Lakers,8,0.4,0.524,44,39,4,4,0.421,0.765,39,32,3,4
6301,21900152,Brooklyn Nets,Utah Jazz,114,119,233,5,Utah Jazz,5,0.297,0.84,43,19,5,8,0.231,0.771,46,16,7,4
6302,21900153,Portland Trail Blazers,Sacramento Kings,99,107,206,8,Sacramento Kings,8,0.267,0.767,40,15,4,5,0.344,0.769,46,24,9,5
6303,21900154,Memphis Grizzlies,Charlotte Hornets,119,117,236,2,Memphis Grizzlies,2,0.486,0.667,45,32,9,5,0.444,0.789,34,27,8,5
6304,21900155,Philadelphia 76ers,Orlando Magic,97,112,209,15,Orlando Magic,15,0.267,0.692,47,25,5,5,0.313,0.765,48,27,6,2
6305,21900156,Washington Wizards,Boston Celtics,133,140,273,7,Boston Celtics,7,0.379,0.815,36,28,5,4,0.444,0.897,44,32,5,5
6306,21900157,Los Angeles Clippers,Houston Rockets,93,102,195,9,Houston Rockets,9,0.303,0.5,53,17,3,3,0.333,0.815,53,12,7,6
6307,21900158,San Antonio Spurs,Minnesota Timberwolves,114,129,243,15,Minnesota Timberwolves,15,0.176,0.793,44,24,4,4,0.324,0.824,50,25,11,4
6308,21900159,Golden State Warriors,Los Angeles Lakers,94,120,214,26,Los Angeles Lakers,26,0.257,0.765,33,29,8,7,0.45,0.833,51,31,8,6
6309,21900160,Toronto Raptors,Portland Trail Blazers,114,106,220,8,Toronto Raptors,8,0.438,0.941,50,20,4,9,0.354,0.813,43,24,3,7
6310,21900161,Miami Heat,Cleveland Cavaliers,108,97,205,11,Miami Heat,11,0.4,0.909,41,31,10,7,0.25,0.81,41,18,14,2
6311,21900162,Dallas Mavericks,New York Knicks,103,106,209,3,New York Knicks,3,0.222,0.742,44,21,8,7,0.433,0.818,53,20,6,2
6312,21900163,Chicago Bulls,Milwaukee Bucks,115,124,239,9,Milwaukee Bucks,9,0.419,0.84,45,25,14,1,0.182,0.723,58,24,9,4
6313,21900164,Los Angeles Clippers,New Orleans Pelicans,127,132,259,5,New Orleans Pelicans,5,0.458,0.774,37,28,6,6,0.529,0.69,51,26,11,5
6314,21900165,Atlanta Hawks,Phoenix Suns,112,128,240,16,Phoenix Suns,16,0.258,0.8,49,25,15,5,0.385,0.816,39,32,6,2
6315,21900166,Brooklyn Nets,Denver Nuggets,93,101,194,8,Denver Nuggets,8,0.211,0.813,51,19,3,2,0.303,0.5,62,26,4,3
6316,21900167,Detroit Pistons,Charlotte Hornets,106,109,215,3,Charlotte Hornets,3,0.429,1,42,25,3,3,0.371,0.625,41,22,10,3
6317,21900168,San Antonio Spurs,Orlando Magic,109,111,220,2,Orlando Magic,2,0.5,0.6,41,23,8,8,0.414,0.794,48,22,6,5
6318,21900169,Indiana Pacers,Houston Rockets,102,111,213,9,Houston Rockets,9,0.242,0.769,42,24,2,2,0.304,0.862,44,12,11,3
6319,21900170,Utah Jazz,Memphis Grizzlies,106,107,213,1,Memphis Grizzlies,1,0.265,0.844,45,17,5,6,0.286,0.846,46,25,6,5
6320,21900171,Washington Wizards,Minnesota Timberwolves,137,116,253,21,Washington Wizards,21,0.357,0.76,51,38,10,5,0.297,0.724,43,26,6,5
6321,21900172,Philadelphia 76ers,Oklahoma City Thunder,119,127,246,8,Oklahoma City Thunder,8,0.438,0.682,43,24,6,0,0.417,0.854,36,22,7,3
6322,21900173,Boston Celtics,Golden State Warriors,105,100,205,5,Boston Celtics,5,0.394,0.783,47,24,13,5,0.179,0.794,55,17,8,4
6323,21900174,Sacramento Kings,Los Angeles Lakers,97,99,196,2,Los Angeles Lakers,2,0.41,1,43,24,7,0,0.297,0.909,41,22,11,6
6324,21900175,Brooklyn Nets,Chicago Bulls,117,111,228,6,Brooklyn Nets,6,0.233,0.871,40,30,10,9,0.231,0.927,56,15,8,2
6325,21900176,Milwaukee Bucks,Indiana Pacers,102,83,185,19,Milwaukee Bucks,19,0.282,0.714,55,23,6,8,0.353,0.778,54,19,8,7
6326,21900177,Charlotte Hornets,New York Knicks,103,102,205,1,Charlotte Hornets,1,0.354,0.737,42,22,5,3,0.3,0.783,48,22,5,1
6327,21900178,New Orleans Pelicans,Miami Heat,94,109,203,15,Miami Heat,15,0.457,0.667,31,23,10,2,0.375,0.923,45,25,13,3
6328,21900179,Houston Rockets,Minnesota Timberwolves,125,105,230,20,Houston Rockets,20,0.388,0.909,42,15,7,3,0.316,0.739,46,23,7,5
6329,21900180,Toronto Raptors,Dallas Mavericks,102,110,212,8,Dallas Mavericks,8,0.415,0.733,42,21,7,2,0.231,0.818,55,24,7,4
6330,21900181,Portland Trail Blazers,San Antonio Spurs,121,116,237,5,Portland Trail Blazers,5,0.333,0.923,48,21,2,4,0.278,0.853,43,25,8,7
6331,21900182,Atlanta Hawks,Los Angeles Clippers,101,150,251,49,Los Angeles Clippers,49,0.25,0.73,38,19,11,10,0.515,0.943,53,30,10,12
6332,21900183,Philadelphia 76ers,Cleveland Cavaliers,114,95,209,19,Philadelphia 76ers,19,0.391,0.765,44,33,6,11,0.24,0.875,42,14,9,5
6333,21900184,Boston Celtics,Sacramento Kings,99,100,199,1,Sacramento Kings,1,0.333,0.875,46,26,7,3,0.4,0.833,45,22,8,7
6334,21900185,Washington Wizards,Orlando Magic,121,125,246,4,Orlando Magic,4,0.463,0.833,38,31,7,2,0.395,0.923,52,25,5,3
6335,21900186,Denver Nuggets,Memphis Grizzlies,131,114,245,17,Denver Nuggets,17,0.563,0.652,39,36,10,10,0.444,0.833,45,29,4,3
6336,21900187,Golden State Warriors,New Orleans Pelicans,100,108,208,8,New Orleans Pelicans,8,0.28,0.826,43,23,7,3,0.391,0.8,48,24,3,5
6337,21900188,Atlanta Hawks,Los Angeles Lakers,101,122,223,21,Los Angeles Lakers,21,0.286,0.76,37,16,11,2,0.429,0.813,42,26,10,14
6338,21900189,Cleveland Cavaliers,New York Knicks,105,123,228,18,New York Knicks,18,0.472,0.533,41,18,2,1,0.348,0.771,47,17,8,10
6339,21900190,Indiana Pacers,Brooklyn Nets,115,86,201,29,Indiana Pacers,29,0.424,0.765,63,26,5,8,0.324,0.625,40,18,2,7
6340,21900191,Charlotte Hornets,Toronto Raptors,96,132,228,36,Toronto Raptors,36,0.333,0.625,37,26,3,8,0.465,0.8,53,40,13,2
6341,21900192,Milwaukee Bucks,Chicago Bulls,115,101,216,14,Milwaukee Bucks,14,0.366,0.686,48,24,12,9,0.353,0.786,50,25,6,6
6342,21900193,Portland Trail Blazers,Houston Rockets,108,132,240,24,Houston Rockets,24,0.306,0.739,44,28,7,5,0.378,0.808,58,24,9,10
6343,21900194,San Antonio Spurs,Dallas Mavericks,110,117,227,7,Dallas Mavericks,7,0.333,0.875,48,18,6,2,0.415,0.696,41,28,4,3
6344,21900195,Boston Celtics,Phoenix Suns,99,85,184,14,Boston Celtics,14,0.293,0.765,52,22,12,5,0.278,0.75,45,22,7,6
6345,21900196,Minnesota Timberwolves,Utah Jazz,112,102,214,10,Minnesota Timberwolves,10,0.368,0.842,51,22,6,10,0.387,0.769,53,20,5,5
6346,21900197,Oklahoma City Thunder,Los Angeles Clippers,88,90,178,2,Los Angeles Clippers,2,0.259,0.893,45,17,12,4,0.278,0.714,49,23,7,5
6347,21900198,Golden State Warriors,Memphis Grizzlies,114,95,209,19,Golden State Warriors,19,0.31,0.864,51,33,5,10,0.36,0.737,37,26,6,4
6348,21900199,Portland Trail Blazers,New Orleans Pelicans,104,115,219,11,New Orleans Pelicans,11,0.552,0.615,48,20,5,4,0.361,0.833,53,24,10,5
6349,21900200,Phoenix Suns,Sacramento Kings,116,120,236,4,Sacramento Kings,4,0.333,0.824,39,24,11,4,0.419,0.92,43,28,7,7
6350,21900201,Oklahoma City Thunder,Los Angeles Lakers,107,112,219,5,Los Angeles Lakers,5,0.321,0.88,39,22,10,2,0.452,0.632,46,29,9,8
6351,21900202,New York Knicks,Philadelphia 76ers,104,109,213,5,Philadelphia 76ers,5,0.52,0.733,42,17,8,6,0.406,0.692,44,30,5,5
6352,21900203,San Antonio Spurs,Washington Wizards,132,138,270,6,Washington Wizards,6,0.375,0.759,41,32,8,8,0.6,0.8,38,37,4,3
6353,21900204,Milwaukee Bucks,Atlanta Hawks,135,127,262,8,Milwaukee Bucks,8,0.395,0.765,46,25,6,8,0.452,0.806,43,27,8,2
6354,21900205,Charlotte Hornets,Brooklyn Nets,91,101,192,10,Brooklyn Nets,10,0.333,0.769,41,17,8,3,0.256,0.826,53,19,11,1
6355,21900206,Cleveland Cavaliers,Miami Heat,100,124,224,24,Miami Heat,24,0.316,0.875,34,19,13,2,0.514,0.742,44,25,8,5
6356,21900207,Orlando Magic,Toronto Raptors,97,113,210,16,Toronto Raptors,16,0.281,0.643,43,26,9,8,0.333,0.737,47,26,5,5
6357,21900208,Golden State Warriors,Dallas Mavericks,94,142,236,48,Dallas Mavericks,48,0.296,0.64,34,18,7,5,0.579,0.783,50,33,7,7
6358,21900209,Detroit Pistons,Chicago Bulls,89,109,198,20,Chicago Bulls,20,0.242,0.781,46,23,6,8,0.519,0.654,55,25,9,7
6359,21900210,Utah Jazz,Minnesota Timberwolves,103,95,198,8,Utah Jazz,8,0.424,0.704,51,22,7,6,0.311,0.524,51,13,5,9
6360,21900211,Houston Rockets,Denver Nuggets,95,105,200,10,Denver Nuggets,10,0.316,0.76,43,19,9,2,0.333,0.533,48,29,13,4
6361,21900212,Boston Celtics,Los Angeles Clippers,104,107,211,3,Los Angeles Clippers,3,0.267,0.714,53,26,11,2,0.378,0.75,53,26,12,9
6362,21900213,Portland Trail Blazers,Milwaukee Bucks,129,137,266,8,Milwaukee Bucks,8,0.436,0.857,41,32,6,11,0.372,0.808,58,32,7,3
6363,21900214,New Orleans Pelicans,Phoenix Suns,124,121,245,3,New Orleans Pelicans,3,0.457,0.636,44,28,8,6,0.419,0.875,38,28,10,3
6364,21900215,Atlanta Hawks,Detroit Pistons,103,128,231,25,Detroit Pistons,25,0.27,1,34,26,12,2,0.5,0.65,42,30,13,10
6365,21900216,Charlotte Hornets,Washington Wizards,118,125,243,7,Washington Wizards,7,0.412,1,44,24,9,5,0.412,0.75,41,34,10,3
6366,21900217,Sacramento Kings,Brooklyn Nets,97,116,213,19,Brooklyn Nets,19,0.154,0.789,33,26,8,2,0.353,0.71,48,22,9,3
6367,21900218,San Antonio Spurs,Philadelphia 76ers,104,115,219,11,Philadelphia 76ers,11,0.333,0.75,32,21,6,3,0.385,0.684,51,32,8,4
6368,21900219,Miami Heat,Chicago Bulls,116,108,224,8,Miami Heat,8,0.368,0.857,44,33,10,3,0.333,0.8,41,23,11,3
6369,21900220,Los Angeles Lakers,Oklahoma City Thunder,130,127,257,3,Los Angeles Lakers,3,0.548,0.793,45,32,7,6,0.355,0.9,37,28,8,3
6370,21900221,Cleveland Cavaliers,Dallas Mavericks,101,143,244,42,Dallas Mavericks,42,0.414,0.882,34,23,3,3,0.541,0.778,49,31,8,7
6371,21900222,Boston Celtics,Denver Nuggets,92,96,188,4,Denver Nuggets,4,0.259,0.826,40,21,12,6,0.25,0.846,48,24,7,5
6372,21900223,Golden State Warriors,Utah Jazz,109,113,222,4,Utah Jazz,4,0.429,0.917,37,28,11,3,0.438,0.813,48,23,4,10
6373,21900224,Houston Rockets,Los Angeles Clippers,119,122,241,3,Los Angeles Clippers,3,0.349,0.684,43,22,11,2,0.394,0.792,47,27,9,4
6374,21900225,Phoenix Suns,Minnesota Timberwolves,100,98,198,2,Phoenix Suns,2,0.286,0.923,56,22,9,3,0.286,0.588,57,26,2,10
6375,21900226,Chicago Bulls,Charlotte Hornets,116,115,231,1,Chicago Bulls,1,0.468,0.667,39,27,12,3,0.429,0.682,43,26,5,7
6376,21900227,Orlando Magic,Indiana Pacers,106,111,217,5,Indiana Pacers,5,0.419,0.778,33,24,11,5,0.417,0.938,42,26,6,6
6377,21900228,Toronto Raptors,Atlanta Hawks,119,116,235,3,Toronto Raptors,3,0.351,0.867,42,22,5,5,0.412,0.727,38,32,9,7
6378,21900229,San Antonio Spurs,New York Knicks,111,104,215,7,San Antonio Spurs,7,0.522,0.679,47,26,7,3,0.375,0.6,37,30,12,3
6379,21900230,Miami Heat,Philadelphia 76ers,86,113,199,27,Philadelphia 76ers,27,0.25,0.741,38,12,6,4,0.483,0.882,44,28,11,2
6380,21900231,Portland Trail Blazers,Cleveland Cavaliers,104,110,214,6,Cleveland Cavaliers,6,0.35,0.75,38,21,6,6,0.323,0.813,52,19,9,2
6381,21900232,Los Angeles Lakers,Memphis Grizzlies,109,108,217,1,Los Angeles Lakers,1,0.333,0.69,40,19,12,7,0.467,0.615,47,28,12,3
6382,21900233,Detroit Pistons,Milwaukee Bucks,90,104,194,14,Milwaukee Bucks,14,0.286,0.6,40,22,7,3,0.351,0.5,49,25,10,8
6383,21900234,New Orleans Pelicans,Utah Jazz,120,128,248,8,Utah Jazz,8,0.415,0.95,38,21,7,6,0.417,0.879,49,29,2,4
6384,21900235,Dallas Mavericks,Houston Rockets,137,123,260,14,Dallas Mavericks,14,0.386,0.786,46,28,9,5,0.227,0.742,54,26,5,2
6385,21900236,Brooklyn Nets,New York Knicks,103,101,204,2,Brooklyn Nets,2,0.368,0.794,35,18,6,1,0.514,0.563,43,22,6,4
6386,21900237,Sacramento Kings,Washington Wizards,113,106,219,7,Sacramento Kings,7,0.355,0.857,39,22,9,5,0.382,0.75,45,29,5,2
6387,21900238,Phoenix Suns,Denver Nuggets,104,116,220,12,Denver Nuggets,12,0.343,0.833,36,25,4,2,0.452,0.696,52,24,4,2
6388,21900239,New Orleans Pelicans,Los Angeles Clippers,109,134,243,25,Los Angeles Clippers,25,0.317,0.556,45,26,1,6,0.372,0.788,56,27,4,5
6389,21900240,Brooklyn Nets,Cleveland Cavaliers,108,106,214,2,Brooklyn Nets,2,0.324,0.818,48,29,8,10,0.406,0.65,45,24,5,4
6390,21900241,Orlando Magic,Detroit Pistons,88,103,191,15,Detroit Pistons,15,0.32,0.727,41,15,8,7,0.368,0.84,49,23,6,5
6391,21900242,Memphis Grizzlies,Indiana Pacers,114,126,240,12,Indiana Pacers,12,0.448,0.692,40,30,6,5,0.545,0.6,47,29,6,6
6392,21900243,Minnesota Timberwolves,Atlanta Hawks,125,113,238,12,Minnesota Timberwolves,12,0.429,0.778,47,27,10,6,0.313,0.808,42,26,6,4
6393,21900244,Sacramento Kings,Boston Celtics,102,103,205,1,Boston Celtics,1,0.383,0.667,36,28,3,8,0.233,0.87,38,20,10,4
6394,21900245,Charlotte Hornets,Miami Heat,100,117,217,17,Miami Heat,17,0.273,0.76,35,25,11,0,0.419,0.857,49,29,9,3
6395,21900246,Philadelphia 76ers,Toronto Raptors,96,101,197,5,Toronto Raptors,5,0.375,0.563,51,25,7,3,0.324,0.636,40,27,5,5
6396,21900247,Portland Trail Blazers,Chicago Bulls,117,94,211,23,Portland Trail Blazers,23,0.296,0.773,55,23,8,5,0.231,0.65,37,24,8,4
6397,21900248,Utah Jazz,Milwaukee Bucks,118,122,240,4,Milwaukee Bucks,4,0.467,0.917,40,29,4,6,0.317,0.793,49,21,6,6
6398,21900249,Los Angeles Lakers,San Antonio Spurs,114,104,218,10,Los Angeles Lakers,10,0.424,0.667,40,28,7,6,0.4,0.8,41,23,4,5
6399,21900250,Oklahoma City Thunder,Golden State Warriors,100,97,197,3,Oklahoma City Thunder,3,0.344,0.818,43,26,5,13,0.45,0.875,41,27,10,7
6400,21900251,Los Angeles Clippers,Dallas Mavericks,114,99,213,15,Los Angeles Clippers,15,0.333,0.7,56,22,12,3,0.289,0.8,46,16,12,2
6401,21900252,Washington Wizards,Denver Nuggets,104,117,221,13,Denver Nuggets,13,0.25,0.667,36,26,9,3,0.25,0.739,58,31,8,6
6402,21900253,Brooklyn Nets,Boston Celtics,110,121,231,11,Boston Celtics,11,0.375,0.474,38,32,5,6,0.382,0.917,55,23,10,5
6403,21900254,Detroit Pistons,Charlotte Hornets,101,102,203,1,Charlotte Hornets,1,0.313,0.6,46,23,2,2,0.233,0.85,41,27,3,7
6404,21900255,Orlando Magic,Cleveland Cavaliers,116,104,220,12,Orlando Magic,12,0.364,0.824,34,23,13,6,0.324,0.864,49,20,5,0
6405,21900256,Utah Jazz,Indiana Pacers,102,121,223,19,Indiana Pacers,19,0.313,0.8,40,19,7,2,0.364,0.813,42,23,8,4
6406,21900257,Sacramento Kings,Philadelphia 76ers,91,97,188,6,Philadelphia 76ers,6,0.265,0.444,42,22,9,3,0.192,0.833,49,20,8,10
6407,21900258,New York Knicks,Toronto Raptors,98,126,224,28,Toronto Raptors,28,0.293,0.833,45,19,6,4,0.512,0.765,52,26,6,4
6408,21900259,Miami Heat,Houston Rockets,108,117,225,9,Houston Rockets,9,0.378,0.741,41,22,8,3,0.341,0.788,43,19,11,2
6409,21900260,Los Angeles Clippers,Memphis Grizzlies,121,119,240,2,Los Angeles Clippers,2,0.341,0.76,43,30,11,6,0.393,0.846,48,26,9,3
6410,21900261,Atlanta Hawks,Milwaukee Bucks,102,111,213,9,Milwaukee Bucks,9,0.324,0.682,49,22,4,5,0.294,0.63,47,25,6,11
6411,21900262,Minnesota Timberwolves,San Antonio Spurs,113,101,214,12,Minnesota Timberwolves,12,0.45,0.778,53,28,4,6,0.172,0.824,46,25,4,8
6412,21900263,Washington Wizards,Phoenix Suns,140,132,272,8,Washington Wizards,8,0.543,0.95,34,32,9,5,0.395,0.875,40,29,7,6
6413,21900264,Los Angeles Lakers,New Orleans Pelicans,114,110,224,4,Los Angeles Lakers,4,0.333,0.72,37,25,9,6,0.425,0.833,42,20,7,4
6414,21900265,Oklahoma City Thunder,Portland Trail Blazers,119,136,255,17,Portland Trail Blazers,17,0.314,0.789,38,19,4,2,0.467,1,54,23,3,1
6415,21900266,Chicago Bulls,Golden State Warriors,90,104,194,14,Golden State Warriors,14,0.345,0.667,42,20,14,4,0.379,0.731,54,31,12,9
6416,21900267,Boston Celtics,Brooklyn Nets,107,112,219,5,Brooklyn Nets,5,0.321,0.762,48,16,11,7,0.415,0.692,49,30,9,6
6417,21900268,Charlotte Hornets,Detroit Pistons,110,107,217,3,Charlotte Hornets,3,0.5,0.733,37,26,8,6,0.429,0.5,45,27,5,4
6418,21900269,Toronto Raptors,Orlando Magic,90,83,173,7,Toronto Raptors,7,0.289,0.607,46,21,16,4,0.241,0.815,52,17,10,11
6419,21900270,Milwaukee Bucks,Cleveland Cavaliers,119,110,229,9,Milwaukee Bucks,9,0.353,0.739,47,28,7,4,0.5,0.5,41,32,7,1
6420,21900271,Philadelphia 76ers,New York Knicks,101,95,196,6,Philadelphia 76ers,6,0.269,0.8,46,22,5,10,0.4,0.576,37,14,5,4
6421,21900272,Atlanta Hawks,Indiana Pacers,104,105,209,1,Indiana Pacers,1,0.281,0.944,48,14,10,3,0.231,0.75,42,19,12,6
6422,21900273,Golden State Warriors,Miami Heat,105,122,227,17,Miami Heat,17,0.357,0.875,31,19,4,3,0.52,0.75,49,23,7,3
6423,21900274,Utah Jazz,Memphis Grizzlies,103,94,197,9,Utah Jazz,9,0.343,0.789,52,18,8,2,0.294,0.588,55,22,1,8
6424,21900275,New Orleans Pelicans,Oklahoma City Thunder,104,109,213,5,Oklahoma City Thunder,5,0.289,0.714,44,19,8,3,0.382,0.625,42,27,6,8
6425,21900276,Los Angeles Clippers,San Antonio Spurs,97,107,204,10,San Antonio Spurs,10,0.364,1,48,23,6,5,0.389,0.929,48,28,8,8
6426,21900277,Dallas Mavericks,Phoenix Suns,120,113,233,7,Dallas Mavericks,7,0.362,0.868,47,20,7,3,0.342,0.72,47,29,3,3
6427,21900278,Chicago Bulls,Portland Trail Blazers,103,107,210,4,Portland Trail Blazers,4,0.368,0.68,47,24,8,2,0.333,0.75,49,20,6,11
6428,21900279,Washington Wizards,Los Angeles Lakers,103,125,228,22,Los Angeles Lakers,22,0.27,0.895,45,25,10,2,0.438,0.75,47,29,9,8
6429,21900280,Denver Nuggets,Sacramento Kings,97,100,197,3,Sacramento Kings,3,0.344,0.667,48,23,11,5,0.242,0.857,50,22,12,4
6430,21900281,Indiana Pacers,Philadelphia 76ers,116,119,235,3,Philadelphia 76ers,3,0.5,0.84,31,22,7,3,0.478,0.889,32,27,12,5
6431,21900282,Atlanta Hawks,Houston Rockets,111,158,269,47,Houston Rockets,47,0.326,0.8,29,26,5,2,0.49,0.853,52,30,9,2
6432,21900283,Charlotte Hornets,Milwaukee Bucks,96,137,233,41,Milwaukee Bucks,41,0.333,0.875,53,21,4,1,0.455,0.6,53,41,7,3
6433,21900284,Miami Heat,Brooklyn Nets,109,106,215,3,Miami Heat,3,0.324,0.821,51,16,3,2,0.333,0.75,48,24,3,5
6434,21900285,Boston Celtics,New York Knicks,113,104,217,9,Boston Celtics,9,0.366,0.727,44,25,5,7,0.308,0.703,39,15,7,6
6435,21900286,Memphis Grizzlies,Minnesota Timberwolves,115,107,222,8,Memphis Grizzlies,8,0.4,0.81,50,27,8,3,0.306,0.857,53,22,7,6
6436,21900287,Dallas Mavericks,Los Angeles Lakers,114,100,214,14,Dallas Mavericks,14,0.347,0.722,51,24,11,1,0.259,0.813,45,25,9,3
6437,21900288,San Antonio Spurs,Detroit Pistons,98,132,230,34,Detroit Pistons,34,0.269,0.864,31,20,11,6,0.484,0.722,50,33,5,5
6438,21900289,Oklahoma City Thunder,New Orleans Pelicans,107,104,211,3,Oklahoma City Thunder,3,0.333,0.769,47,19,5,3,0.447,0.9,41,22,6,7
6439,21900290,Golden State Warriors,Orlando Magic,96,100,196,4,Orlando Magic,4,0.261,0.783,46,21,6,5,0.333,0.682,48,21,7,8
6440,21900291,Utah Jazz,Toronto Raptors,110,130,240,20,Toronto Raptors,20,0.371,0.724,51,21,5,3,0.528,0.81,43,36,14,8
6441,21900292,Washington Wizards,Los Angeles Clippers,125,150,275,25,Los Angeles Clippers,25,0.367,0.741,43,32,10,1,0.438,0.8,52,22,8,5
6442,21900293,Phoenix Suns,Charlotte Hornets,109,104,213,5,Phoenix Suns,5,0.214,0.733,37,30,12,7,0.28,0.808,53,27,4,7
6443,21900294,Utah Jazz,Philadelphia 76ers,94,103,197,9,Philadelphia 76ers,9,0.227,0.65,42,23,6,8,0.5,0.696,47,24,12,3
6444,21900295,Golden State Warriors,Atlanta Hawks,79,104,183,25,Atlanta Hawks,25,0.176,0.833,46,17,11,8,0.276,0.933,38,21,13,4
6445,21900296,Indiana Pacers,Memphis Grizzlies,117,104,221,13,Indiana Pacers,13,0.421,0.867,44,31,4,2,0.263,0.947,38,23,5,6
6446,21900297,New York Knicks,Milwaukee Bucks,88,132,220,44,Milwaukee Bucks,44,0.256,0.667,42,13,4,7,0.457,0.625,57,30,7,4
6447,21900298,Chicago Bulls,Sacramento Kings,113,106,219,7,Chicago Bulls,7,0.432,0.862,32,20,9,0,0.273,0.85,41,22,7,5
6448,21900299,Detroit Pistons,Cleveland Cavaliers,127,94,221,33,Detroit Pistons,33,0.514,0.636,46,33,11,7,0.296,0.714,40,16,6,6
6449,21900300,Orlando Magic,Washington Wizards,127,120,247,7,Orlando Magic,7,0.484,0.741,48,26,3,4,0.343,0.783,38,22,9,3
6450,21900301,Miami Heat,Toronto Raptors,121,110,231,11,Miami Heat,11,0.395,0.762,55,29,4,7,0.256,0.806,48,25,5,4
6451,21900302,Dallas Mavericks,New Orleans Pelicans,118,97,215,21,Dallas Mavericks,21,0.422,0.852,51,22,5,8,0.268,0.667,47,20,4,4
6452,21900303,Houston Rockets,San Antonio Spurs,133,135,268,2,San Antonio Spurs,2,0.294,0.944,60,22,11,7,0.433,0.688,56,35,10,8
6453,21900304,Los Angeles Lakers,Denver Nuggets,105,96,201,9,Los Angeles Lakers,9,0.292,0.667,56,24,8,5,0.207,0.941,35,26,9,4
6454,21900305,Portland Trail Blazers,Los Angeles Clippers,97,117,214,20,Los Angeles Clippers,20,0.259,0.8,49,20,5,6,0.5,0.56,49,25,7,3
6455,21900306,Golden State Warriors,Charlotte Hornets,91,106,197,15,Charlotte Hornets,15,0.391,0.667,37,18,7,3,0.438,0.625,44,30,11,7
6456,21900307,Milwaukee Bucks,Detroit Pistons,127,103,230,24,Milwaukee Bucks,24,0.4,0.926,55,25,7,8,0.306,0.636,40,25,5,3
6457,21900308,Phoenix Suns,Orlando Magic,114,128,242,14,Orlando Magic,14,0.455,0.65,29,36,10,0,0.56,0.8,45,27,9,7
6458,21900309,Brooklyn Nets,Atlanta Hawks,130,118,248,12,Brooklyn Nets,12,0.452,0.889,53,26,8,6,0.346,0.619,35,24,8,9
6459,21900310,Miami Heat,Boston Celtics,93,112,205,19,Boston Celtics,19,0.368,0.647,40,20,7,2,0.39,0.813,46,21,8,8
6460,21900311,Memphis Grizzlies,Chicago Bulls,99,106,205,7,Chicago Bulls,7,0.233,0.857,46,24,14,6,0.394,0.73,50,22,5,13
6461,21900312,Indiana Pacers,Oklahoma City Thunder,107,100,207,7,Indiana Pacers,7,0.375,0.824,39,19,5,1,0.346,0.9,37,25,3,5
6462,21900313,Minnesota Timberwolves,Dallas Mavericks,114,121,235,7,Dallas Mavericks,7,0.447,0.885,44,23,5,7,0.297,0.783,45,24,5,5
6463,21900314,Los Angeles Lakers,Utah Jazz,121,96,217,25,Los Angeles Lakers,25,0.483,0.6,46,27,13,12,0.452,0.737,40,20,3,3
6464,21900315,Sacramento Kings,Portland Trail Blazers,116,127,243,11,Portland Trail Blazers,11,0.324,0.739,44,26,7,7,0.5,0.81,43,28,6,10
6465,21900316,Philadelphia 76ers,Washington Wizards,113,119,232,6,Washington Wizards,6,0.464,0.75,44,25,7,6,0.407,0.813,41,25,9,1
6466,21900317,Denver Nuggets,New York Knicks,129,92,221,37,Denver Nuggets,37,0.538,0.556,48,38,8,5,0.265,0.652,33,23,9,7
6467,21900318,Houston Rockets,Toronto Raptors,119,109,228,10,Houston Rockets,10,0.4,0.895,54,29,11,2,0.308,0.875,45,27,14,5
6468,21900319,Phoenix Suns,New Orleans Pelicans,139,132,271,7,Phoenix Suns,7,0.389,0.926,51,30,16,6,0.415,0.771,40,27,13,9
6469,21900320,Brooklyn Nets,Charlotte Hornets,111,104,215,7,Brooklyn Nets,7,0.395,0.8,49,35,12,5,0.425,0.882,34,23,6,6
6470,21900321,Orlando Magic,Cleveland Cavaliers,93,87,180,6,Orlando Magic,6,0.346,0.87,43,19,10,9,0.294,0.7,45,22,9,7
6471,21900322,Indiana Pacers,Detroit Pistons,101,108,209,7,Detroit Pistons,7,0.375,0.8,33,24,8,9,0.44,0.731,51,21,7,5
6472,21900323,Denver Nuggets,Boston Celtics,95,108,203,13,Boston Celtics,13,0.167,0.8,41,18,5,4,0.371,0.875,37,21,5,5
6473,21900324,Washington Wizards,Miami Heat,103,112,215,9,Miami Heat,9,0.308,0.929,39,29,6,4,0.357,0.75,50,28,6,7
6474,21900325,Golden State Warriors,Chicago Bulls,100,98,198,2,Golden State Warriors,2,0.375,0.682,39,24,9,4,0.415,0.6,37,21,11,2
6475,21900326,Minnesota Timberwolves,Oklahoma City Thunder,127,139,266,12,Oklahoma City Thunder,12,0.342,0.7,36,25,8,2,0.278,0.9,39,19,8,9
6476,21900327,Los Angeles Clippers,Milwaukee Bucks,91,119,210,28,Milwaukee Bucks,28,0.25,0.895,48,18,9,4,0.389,0.81,53,29,11,6
6477,21900328,Sacramento Kings,San Antonio Spurs,104,105,209,1,San Antonio Spurs,1,0.265,0.833,52,19,10,3,0.344,0.706,52,25,10,5
6478,21900329,Los Angeles Lakers,Portland Trail Blazers,136,113,249,23,Los Angeles Lakers,23,0.472,0.818,45,26,10,8,0.294,0.862,34,20,9,4
6479,21900330,New Orleans Pelicans,Dallas Mavericks,84,130,214,46,Dallas Mavericks,46,0.094,0.81,34,17,4,2,0.342,0.806,55,25,8,4
6480,21900331,Indiana Pacers,New York Knicks,104,103,207,1,Indiana Pacers,1,0.429,0.769,42,26,7,9,0.323,0.714,52,24,11,6
6481,21900332,Cleveland Cavaliers,Philadelphia 76ers,94,141,235,47,Philadelphia 76ers,47,0.257,0.765,35,20,4,0,0.423,0.696,51,43,13,8
6482,21900333,Phoenix Suns,Houston Rockets,109,115,224,6,Houston Rockets,6,0.314,0.643,51,29,4,3,0.275,0.733,51,21,10,7
6483,21900334,Memphis Grizzlies,Utah Jazz,112,126,238,14,Utah Jazz,14,0.286,0.64,28,23,15,3,0.559,0.944,41,32,8,0
6484,21900335,Denver Nuggets,Brooklyn Nets,102,105,207,3,Brooklyn Nets,3,0.429,0.857,37,25,4,5,0.25,0.783,48,25,5,1
6485,21900336,Atlanta Hawks,Charlotte Hornets,122,107,229,15,Atlanta Hawks,15,0.4,0.941,48,28,8,8,0.355,0.828,44,22,8,3
6486,21900337,Chicago Bulls,Miami Heat,105,110,215,5,Miami Heat,5,0.361,0.815,39,20,8,1,0.314,0.795,43,20,9,2
6487,21900338,Toronto Raptors,Philadelphia 76ers,104,110,214,6,Philadelphia 76ers,6,0.333,0.85,42,21,13,4,0.438,0.762,40,31,7,5
6488,21900339,Los Angeles Clippers,Washington Wizards,135,119,254,16,Los Angeles Clippers,16,0.375,0.741,45,27,8,4,0.424,0.833,38,28,5,3
6489,21900340,Sacramento Kings,Dallas Mavericks,110,106,216,4,Sacramento Kings,4,0.382,0.818,35,24,7,1,0.386,0.875,40,24,3,1
6490,21900341,Oklahoma City Thunder,Portland Trail Blazers,108,96,204,12,Oklahoma City Thunder,12,0.344,0.794,54,12,7,2,0.273,0.833,51,16,7,8
6491,21900342,Minnesota Timberwolves,Los Angeles Lakers,125,142,267,17,Los Angeles Lakers,17,0.405,0.846,31,27,5,6,0.452,0.9,41,32,9,1
6492,21900343,Los Angeles Clippers,Indiana Pacers,110,99,209,11,Los Angeles Clippers,11,0.313,0.741,56,19,7,7,0.286,0.75,56,16,7,3
6493,21900344,Cleveland Cavaliers,Boston Celtics,88,110,198,22,Boston Celtics,22,0.226,0.474,45,18,8,2,0.556,0.625,39,22,8,9
6494,21900345,Toronto Raptors,Chicago Bulls,93,92,185,1,Toronto Raptors,1,0.241,0.692,54,19,8,9,0.261,0.714,45,30,6,4
6495,21900346,Sacramento Kings,Houston Rockets,119,118,237,1,Sacramento Kings,1,0.444,0.864,37,24,14,5,0.34,0.826,51,25,4,6
6496,21900347,Orlando Magic,Milwaukee Bucks,101,110,211,9,Milwaukee Bucks,9,0.323,0.808,44,24,8,10,0.39,0.533,54,30,7,4
6497,21900348,Detroit Pistons,New Orleans Pelicans,105,103,208,2,Detroit Pistons,2,0.314,0.815,46,15,6,3,0.211,0.682,45,24,6,1
6498,21900349,Minnesota Timberwolves,Phoenix Suns,109,125,234,16,Phoenix Suns,16,0.273,0.793,45,14,6,7,0.4,0.789,42,31,5,5
6499,21900350,Oklahoma City Thunder,Utah Jazz,104,90,194,14,Oklahoma City Thunder,14,0.286,0.842,46,21,9,7,0.258,0.833,48,19,7,0
6500,21900351,Memphis Grizzlies,Golden State Warriors,110,102,212,8,Memphis Grizzlies,8,0.375,0.765,42,29,13,6,0.407,0.84,46,23,10,6
6501,21900352,Washington Wizards,Charlotte Hornets,107,114,221,7,Charlotte Hornets,7,0.314,0.8,45,27,7,7,0.39,0.786,48,22,4,4
6502,21900353,Denver Nuggets,Philadelphia 76ers,92,97,189,5,Philadelphia 76ers,5,0.259,0.917,38,29,12,9,0.333,0.688,49,24,9,3
6503,21900354,Atlanta Hawks,Miami Heat,121,135,256,14,Miami Heat,14,0.37,0.611,37,30,4,6,0.341,0.682,53,35,5,3
6504,21900355,New York Knicks,Portland Trail Blazers,87,115,202,28,Portland Trail Blazers,28,0.184,0.615,47,16,5,3,0.415,0.833,58,20,6,7
6505,21900356,Houston Rockets,Cleveland Cavaliers,116,110,226,6,Houston Rockets,6,0.405,1,36,18,10,6,0.406,0.625,36,29,8,4
6506,21900357,Boston Celtics,Indiana Pacers,117,122,239,5,Indiana Pacers,5,0.389,0.773,44,25,6,4,0.4,0.833,36,27,11,4
6507,21900358,Los Angeles Lakers,Orlando Magic,96,87,183,9,Los Angeles Lakers,9,0.387,0.526,49,20,10,4,0.308,0.647,41,20,10,5
6508,21900359,Los Angeles Clippers,Toronto Raptors,112,92,204,20,Los Angeles Clippers,20,0.3,0.889,50,29,8,5,0.222,0.88,47,21,10,8
6509,21900360,Charlotte Hornets,Brooklyn Nets,113,108,221,5,Charlotte Hornets,5,0.429,0.813,47,20,2,6,0.263,0.667,52,20,5,3
6510,21900361,Atlanta Hawks,Chicago Bulls,102,136,238,34,Chicago Bulls,34,0.342,0.731,41,26,7,5,0.458,0.895,42,32,15,7
6511,21900362,Utah Jazz,Minnesota Timberwolves,127,116,243,11,Utah Jazz,11,0.457,0.773,45,23,4,7,0.366,0.808,42,18,9,3
6512,21900363,Memphis Grizzlies,Phoenix Suns,115,108,223,7,Memphis Grizzlies,7,0.417,0.808,55,23,8,4,0.265,0.833,44,29,6,4
6513,21900364,New Orleans Pelicans,Milwaukee Bucks,112,127,239,15,Milwaukee Bucks,15,0.356,0.818,42,29,8,5,0.487,0.889,43,27,13,2
6514,21900365,Oklahoma City Thunder,Sacramento Kings,93,94,187,1,Sacramento Kings,1,0.394,0.667,43,24,8,8,0.323,0.6,41,12,8,3
6515,21900366,New York Knicks,Golden State Warriors,124,122,246,2,New York Knicks,2,0.414,0.765,58,25,5,7,0.27,0.733,46,27,10,6
6516,21900367,Philadelphia 76ers,Boston Celtics,115,109,224,6,Philadelphia 76ers,6,0.5,0.826,45,27,4,8,0.355,0.824,33,24,4,7
6517,21900368,Cleveland Cavaliers,San Antonio Spurs,117,109,226,8,Cleveland Cavaliers,8,0.333,0.7,50,22,6,3,0.313,0.8,36,19,11,7
6518,21900369,Dallas Mavericks,Detroit Pistons,122,111,233,11,Dallas Mavericks,11,0.364,0.696,52,25,4,5,0.357,0.696,34,23,8,2
6519,21900370,Portland Trail Blazers,Denver Nuggets,99,114,213,15,Denver Nuggets,15,0.3,0.727,35,22,4,7,0.5,0.632,48,25,6,2
6520,21900371,Houston Rockets,Orlando Magic,130,107,237,23,Houston Rockets,23,0.564,0.923,42,21,5,7,0.405,0.75,37,24,3,6
6521,21900372,New Orleans Pelicans,Philadelphia 76ers,109,116,225,7,Philadelphia 76ers,7,0.375,0.686,45,24,5,2,0.35,0.676,47,24,7,8
6522,21900373,Indiana Pacers,Atlanta Hawks,110,100,210,10,Indiana Pacers,10,0.318,0.733,46,28,7,0,0.214,0.696,50,24,6,4
6523,21900374,Los Angeles Lakers,Miami Heat,113,110,223,3,Los Angeles Lakers,3,0.324,0.652,50,26,5,9,0.303,0.786,34,24,8,2
6524,21900375,Charlotte Hornets,Chicago Bulls,83,73,156,10,Charlotte Hornets,10,0.194,0.81,60,21,9,5,0.206,0.857,45,20,11,7
6525,21900376,Milwaukee Bucks,Memphis Grizzlies,127,114,241,13,Milwaukee Bucks,13,0.367,0.848,55,22,4,3,0.408,0.783,45,27,9,5
6526,21900377,Los Angeles Clippers,Minnesota Timberwolves,124,117,241,7,Los Angeles Clippers,7,0.44,0.897,45,16,5,2,0.244,0.838,39,17,9,3
6527,21900378,New York Knicks,Sacramento Kings,103,101,204,2,New York Knicks,2,0.3,0.6,48,24,7,3,0.436,0.75,41,19,0,3
6528,21900379,Golden State Warriors,Utah Jazz,106,114,220,8,Utah Jazz,8,0.31,0.682,48,19,9,7,0.421,0.774,43,22,5,3
6529,21900380,San Antonio Spurs,Phoenix Suns,121,119,240,2,San Antonio Spurs,2,0.267,0.735,62,23,6,9,0.25,0.731,59,29,5,5
6530,21900381,Brooklyn Nets,Toronto Raptors,102,110,212,8,Toronto Raptors,8,0.261,0.706,59,24,4,7,0.35,0.8,51,21,10,10
6531,21900382,Los Angeles Clippers,Chicago Bulls,106,109,215,3,Chicago Bulls,3,0.455,0.722,40,20,9,4,0.452,0.833,50,21,12,9
6532,21900383,Washington Wizards,Memphis Grizzlies,111,128,239,17,Memphis Grizzlies,17,0.368,0.781,34,22,12,4,0.407,0.875,46,32,11,7
6533,21900384,Miami Heat,Dallas Mavericks,122,118,240,4,Miami Heat,4,0.4,0.824,49,27,8,3,0.386,0.647,48,30,4,3
6534,21900385,Cleveland Cavaliers,Milwaukee Bucks,108,125,233,17,Milwaukee Bucks,17,0.429,0.733,45,27,10,3,0.378,0.731,41,26,12,6
6535,21900386,Detroit Pistons,Houston Rockets,115,107,222,8,Detroit Pistons,8,0.324,0.84,55,27,6,6,0.289,0.667,46,18,9,8
6536,21900387,Oklahoma City Thunder,Denver Nuggets,102,110,212,8,Denver Nuggets,8,0.261,0.87,37,22,7,3,0.259,0.739,44,30,6,3
6537,21900388,Orlando Magic,New Orleans Pelicans,130,119,249,11,Orlando Magic,11,0.5,0.808,39,32,8,2,0.442,0.5,40,34,6,7
6538,21900389,Charlotte Hornets,Indiana Pacers,85,107,192,22,Indiana Pacers,22,0.156,0.686,56,18,4,5,0.286,0.85,51,30,6,9
6539,21900390,Los Angeles Lakers,Atlanta Hawks,101,96,197,5,Los Angeles Lakers,5,0.161,0.727,56,21,14,9,0.286,0.88,42,18,8,5
6540,21900391,Philadelphia 76ers,Brooklyn Nets,89,109,198,20,Brooklyn Nets,20,0.192,0.588,38,19,9,13,0.375,0.778,51,22,9,1
6541,21900392,New York Knicks,Denver Nuggets,105,111,216,6,Denver Nuggets,6,0.25,0.9,47,20,9,2,0.357,0.684,48,27,5,6
6542,21900393,Sacramento Kings,Golden State Warriors,100,79,179,21,Sacramento Kings,21,0.455,0.875,38,27,9,3,0.24,0.722,25,24,14,1
6543,21900394,Washington Wizards,Detroit Pistons,133,119,252,14,Washington Wizards,14,0.529,0.81,35,31,6,5,0.333,0.706,36,29,6,4
6544,21900395,Cleveland Cavaliers,Toronto Raptors,113,133,246,20,Toronto Raptors,20,0.343,0.765,39,30,6,1,0.5,0.765,41,31,7,2
6545,21900396,San Antonio Spurs,Houston Rockets,107,109,216,2,Houston Rockets,2,0.364,0.85,53,23,5,4,0.256,0.667,58,20,9,6
6546,21900397,Miami Heat,Memphis Grizzlies,111,118,229,7,Memphis Grizzlies,7,0.458,0.839,35,22,9,7,0.361,0.7,45,28,4,6
6547,21900398,Dallas Mavericks,Milwaukee Bucks,120,116,236,4,Dallas Mavericks,4,0.39,0.815,52,27,5,6,0.268,0.708,52,29,8,4
6548,21900399,Chicago Bulls,Oklahoma City Thunder,106,109,215,3,Oklahoma City Thunder,3,0.29,0.846,31,27,17,6,0.471,0.821,42,21,8,6
6549,21900400,Portland Trail Blazers,Phoenix Suns,111,110,221,1,Portland Trail Blazers,1,0.412,0.85,41,21,9,9,0.353,0.842,44,31,11,5
6550,21900401,Sacramento Kings,Charlotte Hornets,102,110,212,8,Charlotte Hornets,8,0.359,0.923,33,23,10,5,0.433,0.704,51,26,5,8
6551,21900402,Los Angeles Lakers,Indiana Pacers,102,105,207,3,Indiana Pacers,3,0.258,0.471,42,28,5,6,0.4,0.65,43,22,9,6
6552,21900403,Atlanta Hawks,New York Knicks,120,143,263,23,New York Knicks,23,0.349,0.75,36,20,7,3,0.464,0.774,55,30,7,6
6553,21900404,Brooklyn Nets,New Orleans Pelicans,108,101,209,7,Brooklyn Nets,7,0.282,0.739,54,25,3,10,0.275,0.667,58,20,3,9
6554,21900405,Orlando Magic,Utah Jazz,102,109,211,7,Utah Jazz,7,0.2,0.733,41,21,6,5,0.417,0.625,58,27,3,3
6555,21900406,Phoenix Suns,Los Angeles Clippers,99,120,219,21,Los Angeles Clippers,21,0.286,0.7,50,30,11,3,0.438,0.727,44,23,14,4
6556,21900407,Charlotte Hornets,Cleveland Cavaliers,98,100,198,2,Cleveland Cavaliers,2,0.351,0.611,35,25,12,3,0.269,0.765,48,25,7,3
6557,21900408,Toronto Raptors,Detroit Pistons,112,99,211,13,Toronto Raptors,13,0.371,0.875,47,27,9,6,0.171,0.682,48,19,7,6
6558,21900409,Chicago Bulls,Washington Wizards,110,109,219,1,Chicago Bulls,1,0.297,0.875,53,25,10,6,0.311,0.844,55,21,8,7
6559,21900410,Miami Heat,Philadelphia 76ers,108,104,212,4,Miami Heat,4,0.387,0.8,47,26,6,4,0.308,0.889,41,24,9,5
6560,21900411,New Orleans Pelicans,Minnesota Timberwolves,107,99,206,8,New Orleans Pelicans,8,0.424,0.81,55,23,6,4,0.256,0.63,43,20,9,3
6561,21900412,Memphis Grizzlies,Oklahoma City Thunder,122,126,248,4,Oklahoma City Thunder,4,0.385,0.8,47,27,5,2,0.292,0.794,35,25,6,6
6562,21900413,Boston Celtics,Dallas Mavericks,109,103,212,6,Boston Celtics,6,0.316,0.9,54,13,3,4,0.349,0.8,42,23,7,10
6563,21900414,Orlando Magic,Denver Nuggets,104,113,217,9,Denver Nuggets,9,0.379,0.905,35,25,9,5,0.407,0.88,52,28,8,3
6564,21900415,Golden State Warriors,Portland Trail Blazers,112,122,234,10,Portland Trail Blazers,10,0.421,0.609,50,24,7,7,0.29,0.893,57,19,6,8
6565,21900416,Utah Jazz,Atlanta Hawks,111,106,217,5,Utah Jazz,5,0.25,0.711,53,18,8,6,0.379,0.895,40,24,8,1
6566,21900417,Los Angeles Lakers,Milwaukee Bucks,104,111,215,7,Milwaukee Bucks,7,0.343,0.783,38,24,4,6,0.41,0.719,40,22,14,7
6567,21900418,Brooklyn Nets,San Antonio Spurs,105,118,223,13,San Antonio Spurs,13,0.194,0.933,47,16,9,3,0.394,0.826,47,26,10,8
6568,21900419,Houston Rockets,Los Angeles Clippers,122,117,239,5,Houston Rockets,5,0.378,0.759,43,23,9,4,0.432,0.789,38,23,10,7
6569,21900420,Memphis Grizzlies,Cleveland Cavaliers,107,114,221,7,Cleveland Cavaliers,7,0.341,0.714,46,31,9,8,0.459,0.739,60,26,4,10
6570,21900421,Sacramento Kings,Indiana Pacers,105,119,224,14,Indiana Pacers,14,0.313,0.867,41,25,4,6,0.452,0.833,39,34,5,7
6571,21900422,Detroit Pistons,Boston Celtics,93,114,207,21,Boston Celtics,21,0.355,0.737,36,21,13,2,0.333,0.714,51,24,13,9
6572,21900423,Washington Wizards,Toronto Raptors,118,122,240,4,Toronto Raptors,4,0.359,0.75,39,24,6,1,0.4,0.773,42,26,6,3
6573,21900424,New York Knicks,Miami Heat,114,129,243,15,Miami Heat,15,0.294,0.667,41,23,11,2,0.474,0.735,51,34,6,3
6574,21900425,Dallas Mavericks,Philadelphia 76ers,117,98,215,19,Dallas Mavericks,19,0.424,0.773,49,23,10,4,0.294,0.667,46,25,9,2
6575,21900426,Phoenix Suns,Oklahoma City Thunder,108,126,234,18,Oklahoma City Thunder,18,0.344,0.913,37,26,9,4,0.417,0.857,41,23,7,7
6576,21900427,Minnesota Timberwolves,Denver Nuggets,100,109,209,9,Denver Nuggets,9,0.238,0.667,46,20,8,8,0.357,0.917,44,27,9,5
6577,21900428,Orlando Magic,Portland Trail Blazers,103,118,221,15,Portland Trail Blazers,15,0.25,0.692,48,21,14,5,0.472,0.895,54,16,4,11
6578,21900429,New Orleans Pelicans,Golden State Warriors,102,106,208,4,Golden State Warriors,4,0.265,0.652,48,23,8,5,0.303,0.96,47,25,10,4
6579,21900430,Utah Jazz,Charlotte Hornets,114,107,221,7,Utah Jazz,7,0.5,0.95,42,27,7,4,0.414,0.773,36,20,13,4
6580,21900431,Atlanta Hawks,Brooklyn Nets,112,122,234,10,Brooklyn Nets,10,0.229,0.852,52,17,7,5,0.367,0.679,61,23,8,4
6581,21900432,Chicago Bulls,Detroit Pistons,119,107,226,12,Chicago Bulls,12,0.514,0.84,46,21,8,4,0.457,0.917,29,30,14,4
6582,21900433,Washington Wizards,Philadelphia 76ers,108,125,233,17,Philadelphia 76ers,17,0.226,0.853,38,18,7,3,0.424,0.619,53,28,7,4
6583,21900434,Milwaukee Bucks,New York Knicks,123,102,225,21,Milwaukee Bucks,21,0.419,0.657,52,26,9,14,0.3,0.714,47,23,10,6
6584,21900435,Sacramento Kings,Memphis Grizzlies,115,119,234,4,Memphis Grizzlies,4,0.306,0.75,51,22,10,3,0.429,0.828,44,32,8,6
6585,21900436,Los Angeles Clippers,San Antonio Spurs,134,109,243,25,Los Angeles Clippers,25,0.333,0.737,43,32,11,2,0.357,0.789,36,24,5,8
6586,21900437,Houston Rockets,Phoenix Suns,139,125,264,14,Houston Rockets,14,0.463,0.783,37,23,4,5,0.286,0.767,41,26,5,1
6587,21900438,Minnesota Timberwolves,Portland Trail Blazers,106,113,219,7,Portland Trail Blazers,7,0.405,0.938,39,16,8,8,0.371,0.8,45,19,9,13
6588,21900439,Dallas Mavericks,Toronto Raptors,107,110,217,3,Toronto Raptors,3,0.326,0.815,53,27,6,4,0.294,0.839,51,21,12,5
6589,21900440,Charlotte Hornets,Boston Celtics,93,119,212,26,Boston Celtics,26,0.294,0.739,27,26,3,5,0.438,0.813,57,25,2,9
6590,21900441,Indiana Pacers,Milwaukee Bucks,89,117,206,28,Milwaukee Bucks,28,0.3,0.6,48,27,7,5,0.341,0.824,61,31,10,9
6591,21900442,Los Angeles Clippers,Oklahoma City Thunder,112,118,230,6,Oklahoma City Thunder,6,0.407,0.875,42,22,7,2,0.333,0.85,49,24,10,4
6592,21900443,Denver Nuggets,Los Angeles Lakers,128,104,232,24,Denver Nuggets,24,0.344,0.9,44,31,13,2,0.345,0.727,45,18,7,9
6593,21900444,Atlanta Hawks,Cleveland Cavaliers,118,121,239,3,Cleveland Cavaliers,3,0.357,0.765,37,23,11,7,0.379,0.833,43,19,8,6
6594,21900445,Philadelphia 76ers,Detroit Pistons,125,109,234,16,Philadelphia 76ers,16,0.4,0.818,48,33,8,8,0.333,0.722,30,27,9,1
6595,21900446,Toronto Raptors,Indiana Pacers,115,120,235,5,Indiana Pacers,5,0.275,0.75,50,30,6,8,0.429,0.6,45,34,7,8
6596,21900447,Washington Wizards,New York Knicks,121,115,236,6,Washington Wizards,6,0.333,0.567,48,27,12,7,0.417,0.8,44,29,4,10
6597,21900448,Chicago Bulls,Orlando Magic,95,103,198,8,Orlando Magic,8,0.351,0.8,47,20,7,5,0.385,0.652,46,23,10,13
6598,21900449,Utah Jazz,Miami Heat,104,107,211,3,Miami Heat,3,0.333,0.778,45,17,10,6,0.36,0.889,56,16,8,3
6599,21900450,San Antonio Spurs,Memphis Grizzlies,145,115,260,30,San Antonio Spurs,30,0.625,0.714,46,36,9,4,0.405,0.625,35,28,7,0
6600,21900451,Denver Nuggets,Phoenix Suns,113,111,224,2,Denver Nuggets,2,0.536,0.8,39,31,10,1,0.351,0.778,38,29,10,0
6601,21900452,New Orleans Pelicans,Portland Trail Blazers,102,94,196,8,New Orleans Pelicans,8,0.429,0.688,55,23,6,6,0.138,0.889,48,17,6,6
6602,21900453,Houston Rockets,Sacramento Kings,113,104,217,9,Houston Rockets,9,0.385,0.87,39,18,10,3,0.233,0.652,49,20,4,4
6603,21900454,Minnesota Timberwolves,Golden State Warriors,104,113,217,9,Golden State Warriors,9,0.324,0.793,40,16,10,7,0.4,0.833,55,27,11,6
6604,21900455,Boston Celtics,Toronto Raptors,118,102,220,16,Boston Celtics,16,0.424,0.857,45,26,7,3,0.348,0.818,34,17,13,7
6605,21900456,Milwaukee Bucks,Philadelphia 76ers,109,121,230,12,Philadelphia 76ers,12,0.394,0.75,47,23,6,6,0.477,0.8,49,29,9,7
6606,21900457,Houston Rockets,Golden State Warriors,104,116,220,12,Golden State Warriors,12,0.314,0.875,49,19,8,3,0.321,0.893,54,27,7,8
6607,21900458,Los Angeles Clippers,Los Angeles Lakers,111,106,217,5,Los Angeles Clippers,5,0.36,0.75,50,24,6,6,0.267,0.762,42,24,11,10
6608,21900459,New Orleans Pelicans,Denver Nuggets,112,100,212,12,New Orleans Pelicans,12,0.419,1,52,23,9,5,0.324,0.778,40,24,10,4
6609,21900460,Washington Wizards,Detroit Pistons,102,132,234,30,Detroit Pistons,30,0.292,0.704,44,18,7,5,0.396,0.808,48,32,5,5
6610,21900461,New York Knicks,Brooklyn Nets,94,82,176,12,New York Knicks,12,0.31,0.733,60,16,6,2,0.26,0.75,50,17,3,3
6611,21900462,Memphis Grizzlies,Oklahoma City Thunder,110,97,207,13,Memphis Grizzlies,13,0.4,0.727,50,26,6,8,0.286,0.846,34,23,11,4
6612,21900463,San Antonio Spurs,Dallas Mavericks,98,102,200,4,Dallas Mavericks,4,0.276,0.667,45,18,9,7,0.4,0.667,52,22,7,3
6613,21900464,Minnesota Timberwolves,Sacramento Kings,105,104,209,1,Minnesota Timberwolves,1,0.217,0.793,65,23,7,5,0.231,0.84,67,20,8,8
6614,21900465,Portland Trail Blazers,Utah Jazz,115,121,236,6,Utah Jazz,6,0.441,0.737,43,14,4,1,0.389,0.682,41,22,3,1
6615,21900466,Cleveland Cavaliers,Boston Celtics,117,129,246,12,Boston Celtics,12,0.391,0.69,38,22,7,3,0.35,0.895,43,28,4,10
6616,21900467,Oklahoma City Thunder,Charlotte Hornets,104,102,206,2,Oklahoma City Thunder,2,0.161,0.613,49,19,8,4,0.179,0.611,54,26,8,4
6617,21900468,Philadelphia 76ers,Orlando Magic,97,98,195,1,Orlando Magic,1,0.345,0.81,45,23,10,3,0.333,0.609,48,26,4,5
6618,21900469,Milwaukee Bucks,Atlanta Hawks,112,86,198,26,Milwaukee Bucks,26,0.393,0.692,56,29,9,8,0.293,0.571,46,20,10,8
6619,21900470,Indiana Pacers,Miami Heat,112,113,225,1,Miami Heat,1,0.452,0.833,34,27,8,4,0.421,0.895,56,29,3,2
6620,21900471,Phoenix Suns,Golden State Warriors,96,105,201,9,Golden State Warriors,9,0.212,0.792,49,22,6,1,0.333,0.8,41,22,10,5
6621,21900472,Memphis Grizzlies,Denver Nuggets,110,119,229,9,Denver Nuggets,9,0.3,0.76,45,32,5,5,0.31,0.741,43,28,9,4
6622,21900473,Toronto Raptors,Boston Celtics,113,97,210,16,Toronto Raptors,16,0.412,0.647,53,27,8,3,0.219,0.778,31,18,11,4
6623,21900474,Indiana Pacers,New Orleans Pelicans,98,120,218,22,New Orleans Pelicans,22,0.214,0.897,46,17,6,2,0.429,0.8,49,25,9,2
6624,21900475,Philadelphia 76ers,Miami Heat,116,117,233,1,Miami Heat,1,0.333,0.759,47,24,5,4,0.357,0.793,43,26,6,4
6625,21900476,New York Knicks,Washington Wizards,107,100,207,7,New York Knicks,7,0.355,0.769,56,25,5,5,0.4,0.774,49,16,15,3
6626,21900477,Atlanta Hawks,Chicago Bulls,81,116,197,35,Chicago Bulls,35,0.265,0.727,39,24,8,5,0.484,0.789,51,22,13,5
6627,21900478,Brooklyn Nets,Houston Rockets,98,108,206,10,Houston Rockets,10,0.282,0.619,47,24,7,5,0.31,0.438,54,16,7,6
6628,21900479,Cleveland Cavaliers,Minnesota Timberwolves,94,88,182,6,Cleveland Cavaliers,6,0.2,0.722,60,13,9,4,0.216,0.737,40,17,17,8
6629,21900480,Orlando Magic,Milwaukee Bucks,100,111,211,11,Milwaukee Bucks,11,0.4,0.842,34,21,16,7,0.351,0.667,58,30,6,5
6630,21900481,Detroit Pistons,San Antonio Spurs,109,136,245,27,San Antonio Spurs,27,0.333,0.567,40,20,9,5,0.514,0.8,51,30,8,7
6631,21900482,Dallas Mavericks,Golden State Warriors,141,121,262,20,Dallas Mavericks,20,0.471,1,46,35,11,7,0.462,0.765,42,28,4,3
6632,21900483,Phoenix Suns,Sacramento Kings,112,110,222,2,Phoenix Suns,2,0.346,0.867,40,30,10,2,0.387,0.667,36,19,3,4
6633,21900484,Los Angeles Lakers,Portland Trail Blazers,128,120,248,8,Los Angeles Lakers,8,0.344,0.821,44,32,6,7,0.429,0.852,39,18,4,8
6634,21900485,Utah Jazz,Los Angeles Clippers,120,107,227,13,Utah Jazz,13,0.486,0.765,47,25,4,2,0.3,0.926,46,22,9,4
6635,21900486,Oklahoma City Thunder,Toronto Raptors,98,97,195,1,Oklahoma City Thunder,1,0.303,0.87,43,15,8,6,0.375,1,42,21,7,2
6636,21900487,Charlotte Hornets,Memphis Grizzlies,104,117,221,13,Memphis Grizzlies,13,0.29,0.656,42,23,8,4,0.286,1,51,30,5,5
6637,21900488,Houston Rockets,New Orleans Pelicans,112,127,239,15,New Orleans Pelicans,15,0.385,0.65,41,29,5,3,0.409,0.692,46,32,9,4
6638,21900489,Sacramento Kings,Denver Nuggets,115,120,235,5,Denver Nuggets,5,0.382,0.706,35,32,5,4,0.276,0.903,37,23,6,4
6639,21900490,Dallas Mavericks,Los Angeles Lakers,95,108,203,13,Los Angeles Lakers,13,0.302,0.9,45,17,11,4,0.391,0.821,39,28,12,7
6640,21900491,Atlanta Hawks,Orlando Magic,101,93,194,8,Atlanta Hawks,8,0.31,0.824,52,21,8,4,0.2,0.583,40,22,9,6
6641,21900492,Miami Heat,Washington Wizards,105,123,228,18,Washington Wizards,18,0.357,0.744,44,18,5,1,0.459,0.667,40,26,13,6
6642,21900493,Milwaukee Bucks,Chicago Bulls,123,102,225,21,Milwaukee Bucks,21,0.344,0.833,59,29,6,9,0.386,0.625,43,26,10,2
6643,21900494,Brooklyn Nets,Minnesota Timberwolves,115,122,237,7,Minnesota Timberwolves,7,0.366,0.741,58,22,4,6,0.386,0.724,60,20,12,8
6644,21900495,Detroit Pistons,Utah Jazz,81,104,185,23,Utah Jazz,23,0.286,0.739,43,14,10,5,0.385,0.8,46,20,7,6
6645,21900496,Phoenix Suns,Portland Trail Blazers,122,116,238,6,Phoenix Suns,6,0.565,0.955,44,29,6,4,0.412,0.778,42,24,5,4
6646,21900497,Boston Celtics,Charlotte Hornets,109,92,201,17,Boston Celtics,17,0.368,0.7,54,25,12,9,0.353,0.75,41,25,7,4
6647,21900498,Philadelphia 76ers,Indiana Pacers,97,115,212,18,Indiana Pacers,18,0.207,0.85,47,24,4,6,0.44,0.769,38,35,3,6
6648,21900499,Los Angeles Clippers,Sacramento Kings,105,87,192,18,Los Angeles Clippers,18,0.333,0.955,51,21,9,2,0.286,0.684,41,20,8,5
6649,21900500,Cleveland Cavaliers,Toronto Raptors,97,117,214,20,Toronto Raptors,20,0.263,0.813,41,21,5,4,0.436,0.8,45,29,5,7
6650,21900501,Denver Nuggets,Houston Rockets,104,130,234,26,Houston Rockets,26,0.32,0.667,39,25,7,5,0.471,0.71,43,20,6,7
6651,21900502,Golden State Warriors,San Antonio Spurs,113,117,230,4,San Antonio Spurs,4,0.444,0.722,44,31,5,6,0.452,0.765,53,30,6,6
6652,21900503,Dallas Mavericks,Oklahoma City Thunder,101,106,207,5,Oklahoma City Thunder,5,0.294,0.741,49,19,5,4,0.222,0.786,56,18,7,5
6653,21900504,Orlando Magic,Washington Wizards,122,101,223,21,Orlando Magic,21,0.375,0.741,52,25,11,6,0.29,0.839,46,18,5,4
6654,21900505,Portland Trail Blazers,New York Knicks,93,117,210,24,New York Knicks,24,0.313,0.6,47,17,4,5,0.389,0.643,55,29,3,6
6655,21900506,Minnesota Timberwolves,Milwaukee Bucks,104,106,210,2,Milwaukee Bucks,2,0.326,0.75,48,18,7,8,0.25,0.654,60,24,4,12
6656,21900507,Phoenix Suns,Los Angeles Lakers,107,117,224,10,Los Angeles Lakers,10,0.261,0.739,47,32,7,3,0.25,0.706,45,25,9,5
6657,21900508,Charlotte Hornets,Cleveland Cavaliers,109,106,215,3,Charlotte Hornets,3,0.395,0.833,39,25,5,0,0.371,0.786,42,26,6,3
6658,21900509,Denver Nuggets,Indiana Pacers,124,116,240,8,Denver Nuggets,8,0.296,0.889,47,27,7,2,0.462,0.72,34,32,7,3
6659,21900510,Toronto Raptors,Miami Heat,76,84,160,8,Miami Heat,8,0.143,0.824,48,20,4,6,0.324,0.545,50,23,6,4
6660,21900511,Utah Jazz,Chicago Bulls,102,98,200,4,Utah Jazz,4,0.367,0.773,42,24,5,6,0.306,0.765,45,22,8,5
6661,21900512,Golden State Warriors,Minnesota Timberwolves,84,99,183,15,Minnesota Timberwolves,15,0.15,0.714,43,20,9,1,0.302,0.588,52,22,7,7
6662,21900513,Brooklyn Nets,Dallas Mavericks,111,123,234,12,Dallas Mavericks,12,0.324,0.882,44,29,5,1,0.474,0.882,46,22,4,8
6663,21900514,Oklahoma City Thunder,San Antonio Spurs,109,103,212,6,Oklahoma City Thunder,6,0.36,0.7,43,19,7,6,0.419,0.833,45,22,1,8
6664,21900515,Memphis Grizzlies,Sacramento Kings,123,128,251,5,Sacramento Kings,5,0.382,0.952,42,31,4,0,0.412,0.839,41,26,9,8
6665,21900516,Detroit Pistons,Los Angeles Clippers,112,126,238,14,Los Angeles Clippers,14,0.212,0.714,45,20,10,1,0.393,0.714,51,29,6,11
6666,21900517,Atlanta Hawks,Boston Celtics,106,109,215,3,Boston Celtics,3,0.356,0.8,42,26,6,5,0.24,0.724,54,23,9,7
6667,21900518,Miami Heat,Orlando Magic,85,105,190,20,Orlando Magic,20,0.189,0.783,49,16,7,2,0.371,0.897,44,25,11,4
6668,21900519,Portland Trail Blazers,Washington Wizards,122,103,225,19,Portland Trail Blazers,19,0.24,0.788,41,16,6,7,0.333,0.64,41,19,5,4
6669,21900520,Philadelphia 76ers,Houston Rockets,108,118,226,10,Houston Rockets,10,0.222,0.72,44,32,7,6,0.375,0.75,46,22,6,3
6670,21900521,New York Knicks,Phoenix Suns,112,120,232,8,Phoenix Suns,8,0.27,0.667,52,19,7,7,0.357,0.788,48,28,7,3
6671,21900522,New Orleans Pelicans,Los Angeles Lakers,113,123,236,10,Los Angeles Lakers,10,0.297,0.857,40,24,4,10,0.483,0.821,47,29,9,4
6672,21900523,Memphis Grizzlies,Los Angeles Clippers,140,114,254,26,Memphis Grizzlies,26,0.462,0.857,54,36,8,10,0.233,0.773,49,20,3,1
6673,21900524,Toronto Raptors,Brooklyn Nets,121,102,223,19,Toronto Raptors,19,0.406,0.714,43,21,10,4,0.371,0.735,38,24,4,11
6674,21900525,Utah Jazz,Orlando Magic,109,96,205,13,Utah Jazz,13,0.4,0.643,51,22,3,3,0.297,0.75,46,21,6,5
6675,21900526,Indiana Pacers,Atlanta Hawks,111,116,227,5,Atlanta Hawks,5,0.37,0.829,39,24,8,4,0.313,0.917,40,22,8,4
6676,21900527,Oklahoma City Thunder,Cleveland Cavaliers,121,106,227,15,Oklahoma City Thunder,15,0.378,0.808,52,24,6,4,0.467,0.824,42,19,4,0
6677,21900528,Denver Nuggets,Washington Wizards,114,128,242,14,Washington Wizards,14,0.207,0.824,33,18,6,2,0.375,0.815,49,20,5,6
6678,21900529,Boston Celtics,Chicago Bulls,111,104,215,7,Boston Celtics,7,0.421,0.81,44,22,10,5,0.382,0.742,37,23,15,5
6679,21900530,Charlotte Hornets,Dallas Mavericks,123,120,243,3,Charlotte Hornets,3,0.44,0.903,53,27,5,5,0.3,0.846,41,28,7,4
6680,21900531,San Antonio Spurs,Milwaukee Bucks,118,127,245,9,Milwaukee Bucks,9,0.344,0.912,50,20,7,0,0.378,0.727,49,23,4,10
6681,21900532,Detroit Pistons,Golden State Warriors,111,104,215,7,Detroit Pistons,7,0.407,0.875,46,24,13,5,0.524,0.844,42,26,13,3
6682,21900533,New Orleans Pelicans,Sacramento Kings,117,115,232,2,New Orleans Pelicans,2,0.356,0.758,44,28,11,3,0.571,0.75,51,20,9,3
6683,21900534,New York Knicks,Los Angeles Clippers,132,135,267,3,Los Angeles Clippers,3,0.522,0.649,37,22,11,4,0.563,0.818,42,25,4,3
6684,21900535,Portland Trail Blazers,Miami Heat,111,122,233,11,Miami Heat,11,0.351,0.9,40,21,5,4,0.409,0.625,47,34,4,5
6685,21900536,Minnesota Timberwolves,Cleveland Cavaliers,118,103,221,15,Minnesota Timberwolves,15,0.368,0.769,43,32,16,8,0.32,0.789,44,15,6,2
6686,21900537,Memphis Grizzlies,Phoenix Suns,121,114,235,7,Memphis Grizzlies,7,0.429,0.765,42,31,4,8,0.231,0.846,46,25,7,4
6687,21900538,Detroit Pistons,Los Angeles Lakers,99,106,205,7,Los Angeles Lakers,7,0.423,0.857,43,21,8,6,0.3,0.696,50,23,8,20
6688,21900539,Indiana Pacers,Charlotte Hornets,115,104,219,11,Indiana Pacers,11,0.385,0.786,43,31,8,5,0.333,0.909,38,21,3,3
6689,21900540,Brooklyn Nets,Orlando Magic,89,101,190,12,Orlando Magic,12,0.213,0.789,46,20,11,1,0.308,0.742,60,21,8,3
6690,21900541,Oklahoma City Thunder,Philadelphia 76ers,113,120,233,7,Philadelphia 76ers,7,0.414,0.677,47,17,3,3,0.5,0.833,42,31,4,0
6691,21900542,Boston Celtics,Washington Wizards,94,99,193,5,Washington Wizards,5,0.216,0.769,55,17,7,8,0.333,0.609,47,18,8,9
6692,21900543,Denver Nuggets,Atlanta Hawks,123,115,238,8,Denver Nuggets,8,0.333,0.741,41,27,4,6,0.462,0.844,34,24,3,5
6693,21900544,Utah Jazz,New Orleans Pelicans,128,126,254,2,Utah Jazz,2,0.485,0.833,43,19,3,3,0.387,0.8,48,23,4,5
6694,21900545,Chicago Bulls,Dallas Mavericks,110,118,228,8,Dallas Mavericks,8,0.29,0.818,45,25,10,6,0.39,0.737,43,25,5,6
6695,21900546,Milwaukee Bucks,San Antonio Spurs,104,126,230,22,San Antonio Spurs,22,0.333,0.929,38,24,5,5,0.543,0.895,54,23,4,2
6696,21900547,Golden State Warriors,Sacramento Kings,98,111,209,13,Sacramento Kings,13,0.192,0.781,44,19,13,4,0.5,0.783,43,27,10,3
6697,21900548,Detroit Pistons,Cleveland Cavaliers,115,113,228,2,Detroit Pistons,2,0.394,0.857,40,26,8,3,0.452,0.938,46,29,7,4
6698,21900549,Portland Trail Blazers,Toronto Raptors,101,99,200,2,Portland Trail Blazers,2,0.371,0.857,45,23,6,11,0.357,0.737,57,21,5,7
6699,21900550,Oklahoma City Thunder,Brooklyn Nets,111,103,214,8,Oklahoma City Thunder,8,0.297,0.828,51,19,11,3,0.297,0.75,52,19,5,5
6700,21900551,Minnesota Timberwolves,Memphis Grizzlies,112,119,231,7,Memphis Grizzlies,7,0.319,0.81,40,23,10,1,0.286,0.905,44,22,12,6
6701,21900552,Sacramento Kings,Phoenix Suns,114,103,217,11,Sacramento Kings,11,0.417,0.893,41,18,8,1,0.314,0.818,41,24,4,2
6702,21900553,New York Knicks,Los Angeles Lakers,87,117,204,30,Los Angeles Lakers,30,0.2,0.563,47,15,10,3,0.472,0.857,48,27,11,11
6703,21900554,San Antonio Spurs,Boston Celtics,129,114,243,15,San Antonio Spurs,15,0.31,0.923,49,28,9,6,0.342,0.9,39,26,7,2
6704,21900555,Toronto Raptors,Charlotte Hornets,112,110,222,2,Toronto Raptors,2,0.389,0.7,46,34,7,5,0.405,0.731,50,30,6,6
6705,21900556,Miami Heat,Indiana Pacers,122,108,230,14,Miami Heat,14,0.421,0.8,41,28,8,4,0.333,0.76,37,25,5,3
6706,21900557,Washington Wizards,Orlando Magic,89,123,212,34,Orlando Magic,34,0.261,0.579,40,24,8,5,0.37,0.794,51,24,18,3
6707,21900558,Houston Rockets,Atlanta Hawks,122,115,237,7,Houston Rockets,7,0.289,0.756,59,22,7,7,0.295,0.889,54,20,6,8
6708,21900559,Denver Nuggets,Dallas Mavericks,107,106,213,1,Denver Nuggets,1,0.375,0.8,38,27,7,5,0.343,0.667,38,27,8,6
6709,21900560,Chicago Bulls,New Orleans Pelicans,108,123,231,15,New Orleans Pelicans,15,0.4,0.571,39,22,12,2,0.341,0.813,50,31,7,8
6710,21900561,New York Knicks,Utah Jazz,104,128,232,24,Utah Jazz,24,0.36,1,41,18,3,1,0.372,0.609,50,29,6,6
6711,21900562,Milwaukee Bucks,Golden State Warriors,107,98,205,9,Milwaukee Bucks,9,0.22,0.875,47,22,11,3,0.395,0.85,52,29,7,4
6712,21900563,Cleveland Cavaliers,Detroit Pistons,115,112,227,3,Cleveland Cavaliers,3,0.25,0.7,39,24,9,5,0.3,0.625,46,20,8,9
6713,21900564,Boston Celtics,Philadelphia 76ers,98,109,207,11,Philadelphia 76ers,11,0.389,1,38,17,8,1,0.407,0.706,48,24,6,5
6714,21900565,Portland Trail Blazers,Minnesota Timberwolves,102,116,218,14,Minnesota Timberwolves,14,0.297,0.677,41,14,9,6,0.406,0.714,56,25,7,9
6715,21900566,Houston Rockets,Oklahoma City Thunder,92,113,205,21,Oklahoma City Thunder,21,0.275,0.929,39,16,4,3,0.344,0.8,52,22,8,2
6716,21900567,Atlanta Hawks,Washington Wizards,101,111,212,10,Washington Wizards,10,0.241,0.5,56,19,5,9,0.345,0.607,57,26,11,1
6717,21900568,Miami Heat,Brooklyn Nets,113,117,230,4,Brooklyn Nets,4,0.241,0.857,40,26,6,3,0.341,0.632,51,31,5,4
6718,21900569,New Orleans Pelicans,New York Knicks,123,111,234,12,New Orleans Pelicans,12,0.474,0.529,43,35,8,6,0.185,0.7,46,26,13,1
6719,21900570,Indiana Pacers,Chicago Bulls,116,105,221,11,Indiana Pacers,11,0.367,0.643,46,31,9,5,0.439,0.813,36,16,6,3
6720,21900571,San Antonio Spurs,Memphis Grizzlies,121,134,255,13,Memphis Grizzlies,13,0.425,0.87,37,29,3,6,0.421,0.875,49,39,5,6
6721,21900572,Los Angeles Lakers,Dallas Mavericks,129,114,243,15,Los Angeles Lakers,15,0.417,0.781,49,18,6,5,0.289,0.676,47,19,4,3
6722,21900573,Orlando Magic,Phoenix Suns,94,98,192,4,Phoenix Suns,4,0.273,0.792,49,15,9,6,0.321,0.885,44,19,10,8
6723,21900574,Charlotte Hornets,Utah Jazz,92,109,201,17,Utah Jazz,17,0.308,0.737,37,20,6,3,0.429,0.786,40,28,9,6
6724,21900575,Milwaukee Bucks,Sacramento Kings,127,106,233,21,Milwaukee Bucks,21,0.256,0.767,52,29,11,4,0.286,0.8,45,26,8,3
6725,21900576,Golden State Warriors,Los Angeles Clippers,100,109,209,9,Los Angeles Clippers,9,0.205,0.72,46,28,9,1,0.282,0.727,54,27,5,7
6726,21900577,Minnesota Timberwolves,Houston Rockets,109,139,248,30,Houston Rockets,30,0.271,0.667,44,28,12,4,0.4,0.793,58,29,9,6
6727,21900578,New Orleans Pelicans,Boston Celtics,105,140,245,35,Boston Celtics,35,0.311,0.611,43,29,4,6,0.483,0.889,53,29,14,3
6728,21900579,Chicago Bulls,Detroit Pistons,108,99,207,9,Chicago Bulls,9,0.314,0.929,38,24,11,6,0.321,0.667,42,22,7,4
6729,21900580,Los Angeles Lakers,Oklahoma City Thunder,125,110,235,15,Los Angeles Lakers,15,0.469,0.8,54,21,3,4,0.29,0.882,37,23,6,6
6730,21900581,Philadelphia 76ers,Dallas Mavericks,91,109,200,18,Dallas Mavericks,18,0.243,0.667,43,22,11,5,0.407,0.667,54,22,4,8
6731,21900582,Cleveland Cavaliers,Denver Nuggets,111,103,214,8,Cleveland Cavaliers,8,0.324,0.846,55,22,5,1,0.205,0.722,42,23,9,4
6732,21900583,Milwaukee Bucks,Portland Trail Blazers,122,101,223,21,Milwaukee Bucks,21,0.368,0.7,60,21,6,5,0.278,0.81,48,17,6,4
6733,21900584,Miami Heat,New York Knicks,121,124,245,3,New York Knicks,3,0.4,0.821,39,24,1,5,0.29,0.821,39,24,11,3
6734,21900585,Utah Jazz,Washington Wizards,127,116,243,11,Utah Jazz,11,0.333,0.84,44,24,6,2,0.318,0.882,37,28,5,4
6735,21900586,Atlanta Hawks,Brooklyn Nets,86,108,194,22,Brooklyn Nets,22,0.25,0.909,33,23,16,4,0.385,0.552,62,25,8,2
6736,21900587,San Antonio Spurs,Toronto Raptors,105,104,209,1,San Antonio Spurs,1,0.219,0.733,51,24,6,5,0.354,0.818,45,30,7,3
6737,21900588,Golden State Warriors,Memphis Grizzlies,102,122,224,20,Memphis Grizzlies,20,0.5,0.714,47,23,11,6,0.314,0.84,60,33,17,7
6738,21900589,Los Angeles Clippers,Denver Nuggets,104,114,218,10,Denver Nuggets,10,0.242,0.769,42,21,8,5,0.44,0.784,44,24,7,4
6739,21900590,Charlotte Hornets,Phoenix Suns,92,100,192,8,Phoenix Suns,8,0.229,0.667,37,25,10,3,0.333,0.611,51,22,8,5
6740,21900591,New Orleans Pelicans,Detroit Pistons,117,110,227,7,New Orleans Pelicans,7,0.346,0.815,61,23,6,5,0.344,0.792,43,27,11,8
6741,21900592,Philadelphia 76ers,Indiana Pacers,95,101,196,6,Indiana Pacers,6,0.182,0.789,52,17,6,4,0.385,0.806,50,24,6,6
6742,21900593,Chicago Bulls,Boston Celtics,101,113,214,12,Boston Celtics,12,0.24,0.808,38,16,5,5,0.391,0.897,43,28,7,6
6743,21900594,Oklahoma City Thunder,Minnesota Timberwolves,117,104,221,13,Oklahoma City Thunder,13,0.4,0.885,51,25,4,6,0.343,0.762,37,23,10,6
6744,21900595,Charlotte Hornets,Portland Trail Blazers,112,115,227,3,Portland Trail Blazers,3,0.474,0.778,42,24,7,3,0.432,0.789,47,26,4,5
6745,21900596,Orlando Magic,Sacramento Kings,114,112,226,2,Orlando Magic,2,0.31,0.833,46,17,6,5,0.387,0.909,44,25,6,4
6746,21900597,Cleveland Cavaliers,Los Angeles Lakers,99,128,227,29,Los Angeles Lakers,29,0.28,0.667,40,21,4,1,0.367,0.75,45,33,8,3
6747,21900598,Phoenix Suns,Atlanta Hawks,110,123,233,13,Atlanta Hawks,13,0.2,0.813,40,20,9,6,0.452,0.85,46,25,3,10
6748,21900599,Utah Jazz,Brooklyn Nets,118,107,225,11,Utah Jazz,11,0.361,0.867,41,19,8,3,0.308,0.6,43,22,4,4
6749,21900600,Houston Rockets,Memphis Grizzlies,110,121,231,11,Memphis Grizzlies,11,0.311,0.917,41,18,4,2,0.351,0.842,42,29,6,9
6750,21900601,New York Knicks,Milwaukee Bucks,102,128,230,26,Milwaukee Bucks,26,0.297,0.731,49,26,7,3,0.417,0.821,59,27,4,8
6751,21900602,Dallas Mavericks,Golden State Warriors,124,97,221,27,Dallas Mavericks,27,0.351,0.619,53,23,5,2,0.281,0.769,36,27,4,1
6752,21900603,Cleveland Cavaliers,Los Angeles Clippers,103,128,231,25,Los Angeles Clippers,25,0.378,0.867,40,25,5,6,0.395,0.714,53,29,7,8
6753,21900604,Detroit Pistons,Boston Celtics,116,103,219,13,Detroit Pistons,13,0.375,0.526,34,30,8,4,0.321,0.6,44,21,7,2
6754,21900605,Brooklyn Nets,Philadelphia 76ers,106,117,223,11,Philadelphia 76ers,11,0.48,0.6,44,20,9,1,0.367,0.64,49,25,7,11
6755,21900606,San Antonio Spurs,Miami Heat,100,106,206,6,Miami Heat,6,0.303,0.8,41,22,8,4,0.425,0.538,49,26,4,5
6756,21900607,Washington Wizards,Chicago Bulls,106,115,221,9,Chicago Bulls,9,0.407,0.808,38,25,8,6,0.368,0.682,41,26,11,5
6757,21900608,Indiana Pacers,Minnesota Timberwolves,104,99,203,5,Indiana Pacers,5,0.304,0.75,45,27,7,3,0.393,0.75,45,26,6,7
6758,21900609,Toronto Raptors,Oklahoma City Thunder,130,121,251,9,Toronto Raptors,9,0.556,0.733,36,33,13,1,0.381,0.95,31,32,14,3
6759,21900610,Charlotte Hornets,Denver Nuggets,86,100,186,14,Denver Nuggets,14,0.343,0.571,42,28,4,6,0.321,0.6,40,28,8,7
6760,21900611,Portland Trail Blazers,Houston Rockets,117,107,224,10,Portland Trail Blazers,10,0.306,0.828,58,22,6,4,0.327,0.652,50,24,4,4
6761,21900612,Dallas Mavericks,Sacramento Kings,127,123,250,4,Dallas Mavericks,4,0.325,0.833,47,24,4,2,0.364,0.55,42,28,5,0
6762,21900613,Orlando Magic,Los Angeles Lakers,119,118,237,1,Orlando Magic,1,0.385,0.793,48,22,10,2,0.395,0.636,48,34,7,6
6763,21900614,Phoenix Suns,New York Knicks,121,98,219,23,Phoenix Suns,23,0.4,0.833,53,31,11,4,0.308,0.667,40,21,12,3
6764,21900615,Boston Celtics,Milwaukee Bucks,123,128,251,5,Milwaukee Bucks,5,0.306,0.815,43,16,4,7,0.516,0.703,50,21,6,6
6765,21900616,Utah Jazz,New Orleans Pelicans,132,138,270,6,New Orleans Pelicans,6,0.385,0.781,43,23,9,6,0.423,0.714,45,29,8,9
6766,21900617,Denver Nuggets,Golden State Warriors,134,131,265,3,Denver Nuggets,3,0.486,0.885,56,31,11,6,0.444,0.871,42,36,12,6
6767,21900618,Orlando Magic,Los Angeles Clippers,95,122,217,27,Los Angeles Clippers,27,0.333,0.563,42,24,4,4,0.438,0.7,59,29,4,4
6768,21900619,Minnesota Timberwolves,Indiana Pacers,114,116,230,2,Indiana Pacers,2,0.436,0.81,36,22,4,1,0.333,0.8,41,24,4,8
6769,21900620,Chicago Bulls,Philadelphia 76ers,89,100,189,11,Philadelphia 76ers,11,0.229,0.733,37,21,8,3,0.31,1,44,30,9,7
6770,21900621,Washington Wizards,Toronto Raptors,111,140,251,29,Toronto Raptors,29,0.429,0.696,43,19,9,3,0.512,0.875,41,35,16,2
6771,21900622,Cleveland Cavaliers,Memphis Grizzlies,109,113,222,4,Memphis Grizzlies,4,0.25,0.692,50,18,6,2,0.321,0.7,44,32,11,8
6772,21900623,Miami Heat,Oklahoma City Thunder,115,108,223,7,Miami Heat,7,0.389,0.792,45,26,4,3,0.391,0.889,35,29,4,5
6773,21900624,Atlanta Hawks,San Antonio Spurs,121,120,241,1,Atlanta Hawks,1,0.475,0.741,43,21,10,6,0.276,0.957,48,28,12,6
6774,21900625,Portland Trail Blazers,Dallas Mavericks,112,120,232,8,Dallas Mavericks,8,0.3,0.682,40,25,6,5,0.426,0.786,43,19,6,4
6775,21900626,Los Angeles Clippers,New Orleans Pelicans,133,130,263,3,Los Angeles Clippers,3,0.323,0.795,36,22,12,2,0.366,0.639,48,32,7,4
6776,21900627,Milwaukee Bucks,Brooklyn Nets,117,97,214,20,Milwaukee Bucks,20,0.459,0.625,54,30,8,6,0.306,0.941,47,23,11,7
6777,21900628,Phoenix Suns,Boston Celtics,123,119,242,4,Phoenix Suns,4,0.419,0.867,52,27,6,6,0.357,0.909,39,26,11,6
6778,21900629,Detroit Pistons,Atlanta Hawks,136,103,239,33,Detroit Pistons,33,0.469,0.76,41,31,12,8,0.294,0.867,32,18,9,6
6779,21900630,Philadelphia 76ers,New York Knicks,90,87,177,3,Philadelphia 76ers,3,0.313,0.632,41,26,8,6,0.24,0.611,48,20,4,5
6780,21900631,Cleveland Cavaliers,Chicago Bulls,116,118,234,2,Chicago Bulls,2,0.517,0.913,36,27,5,5,0.36,0.765,26,25,18,4
6781,21900632,Toronto Raptors,Minnesota Timberwolves,122,112,234,10,Toronto Raptors,10,0.371,0.882,42,25,13,9,0.28,0.815,49,34,8,5
6782,21900633,Los Angeles Lakers,Houston Rockets,124,115,239,9,Los Angeles Lakers,9,0.333,0.719,49,25,13,9,0.324,0.793,46,20,8,4
6783,21900634,Orlando Magic,Golden State Warriors,95,109,204,14,Golden State Warriors,14,0.29,0.615,46,21,7,5,0.3,1,44,25,9,2
6784,21900635,Portland Trail Blazers,Oklahoma City Thunder,106,119,225,13,Oklahoma City Thunder,13,0.375,0.762,40,11,7,7,0.318,0.722,48,25,5,4
6785,21900636,Sacramento Kings,Utah Jazz,101,123,224,22,Utah Jazz,22,0.385,0.583,37,20,3,3,0.333,0.958,47,24,7,4
6786,21900637,Miami Heat,San Antonio Spurs,102,107,209,5,San Antonio Spurs,5,0.294,0.9,47,23,8,3,0.364,0.958,43,27,5,4
6787,21900638,Indiana Pacers,Denver Nuggets,115,107,222,8,Indiana Pacers,8,0.448,0.842,38,31,1,4,0.13,0.688,44,22,10,4
6788,21900639,Detroit Pistons,Washington Wizards,100,106,206,6,Washington Wizards,6,0.313,0.7,41,19,10,5,0.375,0.813,44,22,9,6
6789,21900640,Toronto Raptors,Atlanta Hawks,122,117,239,5,Toronto Raptors,5,0.31,0.767,45,25,13,3,0.364,0.697,50,26,9,8
6790,21900641,Philadelphia 76ers,Brooklyn Nets,117,111,228,6,Philadelphia 76ers,6,0.333,0.741,43,30,12,6,0.379,0.647,47,22,7,2
6791,21900642,Orlando Magic,Charlotte Hornets,106,83,189,23,Orlando Magic,23,0.5,0.444,47,25,9,4,0.303,0.75,39,21,4,5
6792,21900643,New York Knicks,Cleveland Cavaliers,106,86,192,20,New York Knicks,20,0.391,0.882,49,17,6,9,0.333,0.647,53,15,5,4
6793,21900644,Sacramento Kings,Miami Heat,113,118,231,5,Miami Heat,5,0.255,0.8,49,27,11,3,0.381,0.818,42,26,9,3
6794,21900645,Oklahoma City Thunder,Houston Rockets,112,107,219,5,Oklahoma City Thunder,5,0.375,0.769,47,14,8,6,0.2,0.706,43,21,6,7
6795,21900646,New Orleans Pelicans,Memphis Grizzlies,126,116,242,10,New Orleans Pelicans,10,0.438,0.875,43,24,7,7,0.273,0.714,51,26,8,3
6796,21900647,Chicago Bulls,Milwaukee Bucks,98,111,209,13,Milwaukee Bucks,13,0.292,0.889,39,18,11,2,0.423,0.435,48,34,7,5
6797,21900648,Los Angeles Lakers,Boston Celtics,107,139,246,32,Boston Celtics,32,0.269,0.759,36,22,5,8,0.471,0.655,48,31,10,5
6798,21900649,Denver Nuggets,Minnesota Timberwolves,107,100,207,7,Denver Nuggets,7,0.355,0.833,53,26,9,1,0.31,0.786,42,26,7,5
6799,21900650,San Antonio Spurs,Phoenix Suns,120,118,238,2,San Antonio Spurs,2,0.548,0.773,31,30,12,7,0.364,0.867,43,26,3,3
6800,21900651,Indiana Pacers,Utah Jazz,88,118,206,30,Utah Jazz,30,0.269,0.429,30,23,15,9,0.387,1,53,22,5,4
6801,21900652,Golden State Warriors,Portland Trail Blazers,124,129,253,5,Portland Trail Blazers,5,0.25,0.864,60,30,7,5,0.318,0.9,54,21,4,11
6802,21900653,Los Angeles Clippers,Dallas Mavericks,110,107,217,3,Los Angeles Clippers,3,0.316,0.788,57,19,9,3,0.279,0.708,49,23,7,8
6803,21900654,Sacramento Kings,Detroit Pistons,106,127,233,21,Detroit Pistons,21,0.286,0.522,45,23,10,1,0.414,0.841,48,19,9,4
6804,21900655,Oklahoma City Thunder,Orlando Magic,120,114,234,6,Oklahoma City Thunder,6,0.474,0.826,36,22,10,7,0.4,0.75,39,26,9,3
6805,21900656,Los Angeles Clippers,Atlanta Hawks,95,102,197,7,Atlanta Hawks,7,0.19,0.641,45,19,5,8,0.314,0.826,63,21,8,3
6806,21900657,Memphis Grizzlies,Boston Celtics,95,119,214,24,Boston Celtics,24,0.344,0.8,40,24,7,8,0.438,0.75,44,32,11,9
6807,21900658,Washington Wizards,Miami Heat,129,134,263,5,Miami Heat,5,0.31,0.8,41,30,10,5,0.515,0.861,43,29,3,6
6808,21900659,Los Angeles Lakers,New York Knicks,100,92,192,8,Los Angeles Lakers,8,0.333,0.679,43,18,13,8,0.324,0.692,47,24,4,4
6809,21900660,Philadelphia 76ers,Toronto Raptors,95,107,202,12,Toronto Raptors,12,0.391,0.722,45,25,8,6,0.394,0.667,53,27,6,2
6810,21900661,Minnesota Timberwolves,Chicago Bulls,110,117,227,7,Chicago Bulls,7,0.341,0.542,43,27,7,3,0.3,0.811,50,21,9,2
6811,21900662,Denver Nuggets,Houston Rockets,105,121,226,16,Houston Rockets,16,0.357,0.733,40,25,12,6,0.448,0.857,53,26,10,7
6812,21900663,San Antonio Spurs,New Orleans Pelicans,121,117,238,4,San Antonio Spurs,4,0.407,0.8,44,17,7,4,0.389,0.781,41,26,6,3
6813,21900664,Indiana Pacers,Phoenix Suns,112,87,199,25,Indiana Pacers,25,0.45,0.65,42,26,8,8,0.2,0.885,44,13,7,3
6814,21900665,Utah Jazz,Golden State Warriors,129,96,225,33,Utah Jazz,33,0.425,0.522,56,31,5,3,0.261,0.833,37,20,5,5
6815,21900666,Washington Wizards,Cleveland Cavaliers,124,112,236,12,Washington Wizards,12,0.444,0.778,41,28,3,3,0.333,0.765,36,24,7,1
6816,21900667,Los Angeles Lakers,Brooklyn Nets,128,113,241,15,Los Angeles Lakers,15,0.5,0.75,52,28,9,6,0.457,0.8,41,30,12,3
6817,21900668,Dallas Mavericks,Portland Trail Blazers,133,125,258,8,Dallas Mavericks,8,0.468,0.625,41,27,5,7,0.538,0.8,43,20,4,4
6818,21900669,Milwaukee Bucks,Charlotte Hornets,116,103,219,13,Milwaukee Bucks,13,0.278,0.75,53,26,8,8,0.359,0.833,39,24,6,3
6819,21900670,Memphis Grizzlies,Detroit Pistons,125,112,237,13,Memphis Grizzlies,13,0.5,0.903,49,27,6,4,0.344,0.742,37,23,8,1
6820,21900671,Boston Celtics,Orlando Magic,109,98,207,11,Boston Celtics,11,0.4,0.833,44,27,10,7,0.324,0.737,46,18,5,1
6821,21900672,Toronto Raptors,New York Knicks,118,112,230,6,Toronto Raptors,6,0.486,0.826,31,25,10,6,0.361,0.714,46,26,5,4
6822,21900673,Los Angeles Clippers,Miami Heat,122,117,239,5,Los Angeles Clippers,5,0.457,0.87,48,33,5,3,0.295,0.828,45,25,4,4
6823,21900674,Sacramento Kings,Chicago Bulls,98,81,179,17,Sacramento Kings,17,0.313,0.857,42,24,8,8,0.216,0.786,43,23,6,4
6824,21900675,Houston Rockets,Minnesota Timberwolves,131,124,255,7,Houston Rockets,7,0.344,0.839,35,24,11,9,0.344,0.85,51,28,8,8
6825,21900676,Denver Nuggets,New Orleans Pelicans,113,106,219,7,Denver Nuggets,7,0.317,1,56,26,14,6,0.444,0.6,45,24,8,7
6826,21900677,Atlanta Hawks,Oklahoma City Thunder,111,140,251,29,Oklahoma City Thunder,29,0.306,0.8,37,24,6,7,0.56,0.765,45,28,6,5
6827,21900678,Phoenix Suns,San Antonio Spurs,103,99,202,4,Phoenix Suns,4,0.276,0.81,42,25,6,4,0.2,0.848,43,19,9,8
6828,21900679,Indiana Pacers,Golden State Warriors,129,118,247,11,Indiana Pacers,11,0.607,0.923,36,35,15,4,0.487,0.826,38,31,6,3
6829,21900680,Dallas Mavericks,Utah Jazz,107,112,219,5,Utah Jazz,5,0.39,0.538,44,19,6,3,0.349,0.773,54,22,5,6
6830,21900681,Brooklyn Nets,Detroit Pistons,121,111,232,10,Brooklyn Nets,10,0.357,0.88,55,19,3,5,0.371,0.667,52,20,5,3
6831,21900682,Chicago Bulls,Cleveland Cavaliers,118,106,224,12,Chicago Bulls,12,0.364,0.75,36,24,15,2,0.433,0.818,43,30,5,1
6832,21900683,Oklahoma City Thunder,Minnesota Timberwolves,113,104,217,9,Oklahoma City Thunder,9,0.458,0.96,43,20,8,9,0.279,0.667,41,33,9,4
6833,21900684,Los Angeles Lakers,Philadelphia 76ers,91,108,199,17,Philadelphia 76ers,17,0.194,0.652,35,23,12,1,0.351,0.684,41,19,12,3
6834,21900685,Houston Rockets,Denver Nuggets,110,117,227,7,Denver Nuggets,7,0.333,0.704,44,19,6,7,0.393,0.9,42,28,10,3
6835,21900686,Toronto Raptors,San Antonio Spurs,110,106,216,4,Toronto Raptors,4,0.32,0.8,50,31,11,2,0.432,0.917,48,27,5,8
6836,21900687,Washington Wizards,Atlanta Hawks,133,152,285,19,Atlanta Hawks,19,0.333,0.905,34,20,5,7,0.429,0.853,48,30,7,3
6837,21900688,Brooklyn Nets,New York Knicks,97,110,207,13,New York Knicks,13,0.333,0.696,34,21,6,4,0.316,0.462,48,19,7,8
6838,21900689,Los Angeles Clippers,Orlando Magic,112,97,209,15,Los Angeles Clippers,15,0.433,0.862,53,20,2,7,0.219,0.688,44,27,9,7
6839,21900690,Phoenix Suns,Memphis Grizzlies,109,114,223,5,Memphis Grizzlies,5,0.379,0.8,42,23,14,7,0.421,0.692,46,25,10,8
6840,21900691,Boston Celtics,New Orleans Pelicans,108,123,231,15,New Orleans Pelicans,15,0.242,0.818,37,21,6,5,0.444,0.655,54,31,7,5
6841,21900692,Indiana Pacers,Portland Trail Blazers,129,139,268,10,Portland Trail Blazers,10,0.464,0.952,31,31,5,2,0.571,0.84,43,27,1,7
6842,21900693,Cleveland Cavaliers,Detroit Pistons,115,100,215,15,Cleveland Cavaliers,15,0.375,0.769,45,25,9,6,0.343,0.706,37,18,8,7
6843,21900694,Orlando Magic,Miami Heat,92,113,205,21,Miami Heat,21,0.297,0.789,41,23,7,6,0.5,0.938,41,31,2,9
6844,21900695,San Antonio Spurs,Chicago Bulls,109,110,219,1,Chicago Bulls,1,0.4,0.676,47,21,2,6,0.378,0.8,50,28,8,2
6845,21900696,Sacramento Kings,Minnesota Timberwolves,133,129,262,4,Sacramento Kings,4,0.45,0.794,44,27,6,8,0.5,0.606,45,29,7,8
6846,21900697,Dallas Mavericks,Oklahoma City Thunder,107,97,204,10,Dallas Mavericks,10,0.373,0.667,56,21,3,3,0.4,0.895,48,23,2,4
6847,21900698,Houston Rockets,Utah Jazz,126,117,243,9,Houston Rockets,9,0.375,0.714,40,14,11,4,0.286,0.731,38,24,7,3
6848,21900699,New York Knicks,Charlotte Hornets,92,97,189,5,Charlotte Hornets,5,0.281,0.636,42,17,5,7,0.25,0.778,51,22,5,4
6849,21900700,New Orleans Pelicans,Cleveland Cavaliers,125,111,236,14,New Orleans Pelicans,14,0.382,0.75,41,29,9,11,0.324,0.889,46,25,7,2
6850,21900701,Boston Celtics,Miami Heat,109,101,210,8,Boston Celtics,8,0.361,0.75,48,24,5,8,0.243,0.839,45,15,11,2
6851,21900702,Golden State Warriors,Philadelphia 76ers,104,115,219,11,Philadelphia 76ers,11,0.375,0.714,40,29,6,3,0.344,0.769,44,28,5,3
6852,21900703,Atlanta Hawks,Toronto Raptors,114,130,244,16,Toronto Raptors,16,0.255,0.8,44,28,10,2,0.302,0.778,52,26,10,6
6853,21900704,Denver Nuggets,Memphis Grizzlies,96,104,200,8,Memphis Grizzlies,8,0.378,0.833,44,23,9,4,0.333,0.429,41,32,12,11
6854,21900705,Washington Wizards,Milwaukee Bucks,131,151,282,20,Milwaukee Bucks,20,0.438,0.853,35,28,6,6,0.514,0.914,46,31,3,3
6855,21900706,Phoenix Suns,Dallas Mavericks,133,104,237,29,Phoenix Suns,29,0.429,0.905,39,34,10,4,0.212,0.852,33,19,6,0
6856,21900708,Chicago Bulls,Indiana Pacers,106,115,221,9,Indiana Pacers,9,0.182,0.667,34,26,10,3,0.259,0.727,46,26,8,2
6857,21900709,Detroit Pistons,Brooklyn Nets,115,125,240,10,Brooklyn Nets,10,0.385,0.75,41,25,6,5,0.385,0.8,37,26,8,7
6858,21900710,Memphis Grizzlies,New York Knicks,127,106,233,21,Memphis Grizzlies,21,0.464,0.848,44,25,7,3,0.321,0.655,46,26,9,6
6859,21900711,Utah Jazz,San Antonio Spurs,120,127,247,7,San Antonio Spurs,7,0.368,0.696,43,18,4,0,0.258,0.9,35,23,5,2
6860,21900712,Houston Rockets,Portland Trail Blazers,112,125,237,13,Portland Trail Blazers,13,0.362,0.833,39,21,8,5,0.361,0.741,50,24,8,8
6861,21900713,Oklahoma City Thunder,Sacramento Kings,120,100,220,20,Oklahoma City Thunder,20,0.441,0.85,45,32,9,5,0.231,0.636,39,22,6,2
6862,21900714,Toronto Raptors,Cleveland Cavaliers,115,109,224,6,Toronto Raptors,6,0.375,0.75,37,23,13,3,0.361,0.857,52,23,7,3
6863,21900715,Charlotte Hornets,Washington Wizards,107,121,228,14,Washington Wizards,14,0.3,0.632,38,32,9,4,0.378,0.926,57,24,3,6
6864,21900716,Philadelphia 76ers,Atlanta Hawks,117,127,244,10,Atlanta Hawks,10,0.29,0.711,42,22,11,2,0.314,0.865,48,29,5,4
6865,21900717,Golden State Warriors,Boston Celtics,104,119,223,15,Boston Celtics,15,0.308,0.867,30,24,11,6,0.429,0.909,51,27,12,4
6866,21900718,Utah Jazz,Denver Nuggets,100,106,206,6,Denver Nuggets,6,0.459,0.647,35,24,4,6,0.333,0.81,43,25,7,5
6867,21900719,Sacramento Kings,Los Angeles Clippers,124,103,227,21,Sacramento Kings,21,0.512,0.833,47,27,11,8,0.419,0.8,39,26,6,6
6868,21900720,Toronto Raptors,Detroit Pistons,105,92,197,13,Toronto Raptors,13,0.333,0.727,42,26,6,7,0.306,0.735,45,18,5,6
6869,21900721,Chicago Bulls,Brooklyn Nets,118,133,251,15,Brooklyn Nets,15,0.353,0.846,38,27,7,3,0.484,0.72,37,31,8,5
6870,21900722,Dallas Mavericks,Houston Rockets,121,128,249,7,Houston Rockets,7,0.389,0.778,52,29,2,9,0.467,0.85,37,25,11,5
6871,21900723,Memphis Grizzlies,New Orleans Pelicans,111,139,250,28,New Orleans Pelicans,28,0.194,0.577,34,17,10,8,0.441,0.846,57,30,8,4
6872,21900724,Denver Nuggets,Milwaukee Bucks,127,115,242,12,Denver Nuggets,12,0.478,1,50,29,8,10,0.3,0.654,46,29,7,5
6873,21900725,Oklahoma City Thunder,Phoenix Suns,111,107,218,4,Oklahoma City Thunder,4,0.226,0.909,41,26,13,4,0.375,0.897,40,20,6,6
6874,21900726,Portland Trail Blazers,Los Angeles Lakers,127,119,246,8,Portland Trail Blazers,8,0.361,0.762,40,25,10,8,0.344,0.643,62,28,2,10
6875,21900727,Minnesota Timberwolves,Los Angeles Clippers,106,118,224,12,Los Angeles Clippers,12,0.179,0.838,44,24,9,4,0.353,0.889,50,20,8,7
6876,21900728,New York Knicks,Indiana Pacers,92,85,177,7,New York Knicks,7,0.269,0.739,57,19,5,1,0.333,0.619,34,21,4,1
6877,21900729,Miami Heat,Orlando Magic,102,89,191,13,Miami Heat,13,0.455,0.808,48,24,6,8,0.273,0.824,39,21,5,5
6878,21900730,Golden State Warriors,Cleveland Cavaliers,131,112,243,19,Golden State Warriors,19,0.514,0.895,44,39,11,10,0.364,1,46,26,8,3
6879,21900731,Brooklyn Nets,Washington Wizards,107,113,220,6,Washington Wizards,6,0.34,0.619,53,25,5,7,0.281,0.615,51,21,9,8
6880,21900732,Philadelphia 76ers,Boston Celtics,95,116,211,21,Boston Celtics,21,0.212,0.839,47,15,6,3,0.267,0.78,42,15,9,2
6881,21900733,Atlanta Hawks,Dallas Mavericks,100,123,223,23,Dallas Mavericks,23,0.303,0.762,50,19,6,4,0.513,0.938,53,26,6,8
6882,21900734,Charlotte Hornets,San Antonio Spurs,90,114,204,24,San Antonio Spurs,24,0.278,0.833,37,29,5,7,0.357,0.667,44,27,13,2
6883,21900735,Utah Jazz,Portland Trail Blazers,107,124,231,17,Portland Trail Blazers,17,0.439,1,37,19,6,4,0.517,0.833,51,20,4,5
6884,21900736,Los Angeles Lakers,Sacramento Kings,129,113,242,16,Los Angeles Lakers,16,0.442,0.815,46,33,10,5,0.318,0.808,44,21,5,4
6885,21900737,Denver Nuggets,Detroit Pistons,123,128,251,5,Detroit Pistons,5,0.313,0.773,47,30,7,7,0.452,0.75,43,33,4,2
6886,21900738,New Orleans Pelicans,Houston Rockets,109,117,226,8,Houston Rockets,8,0.303,0.75,63,21,6,6,0.314,0.864,43,22,14,3
6887,21900739,Phoenix Suns,Milwaukee Bucks,108,129,237,21,Milwaukee Bucks,21,0.261,0.87,49,20,8,3,0.395,0.667,60,30,4,12
6888,21900740,Chicago Bulls,Toronto Raptors,102,129,231,27,Toronto Raptors,27,0.313,0.654,41,25,10,0,0.471,0.826,46,28,6,5
6889,21900741,Orlando Magic,Charlotte Hornets,112,100,212,12,Orlando Magic,12,0.471,0.588,37,35,7,3,0.29,0.643,46,24,8,2
6890,21900742,New York Knicks,Cleveland Cavaliers,139,134,273,5,New York Knicks,5,0.385,0.714,46,33,11,1,0.514,0.667,34,34,6,3
6891,21900743,Dallas Mavericks,Indiana Pacers,112,103,215,9,Dallas Mavericks,9,0.4,0.957,51,20,3,2,0.206,0.727,40,28,7,6
6892,21900744,Golden State Warriors,Washington Wizards,125,117,242,8,Golden State Warriors,8,0.5,0.774,44,31,8,6,0.409,0.828,35,28,6,4
6893,21900745,Boston Celtics,Atlanta Hawks,123,115,238,8,Boston Celtics,8,0.414,0.882,44,21,10,5,0.4,0.905,32,22,9,6
6894,21900746,Phoenix Suns,Brooklyn Nets,97,119,216,22,Brooklyn Nets,22,0.353,0.722,43,23,7,6,0.441,0.857,44,28,8,5
6895,21900747,Philadelphia 76ers,Miami Heat,106,137,243,31,Miami Heat,31,0.342,0.84,44,24,3,1,0.5,0.833,35,27,8,1
6896,21900748,Detroit Pistons,Memphis Grizzlies,82,96,178,14,Memphis Grizzlies,14,0.308,0.667,51,21,6,2,0.118,0.833,47,27,6,12
6897,21900749,Minnesota Timberwolves,Sacramento Kings,109,113,222,4,Sacramento Kings,4,0.342,0.786,45,25,12,6,0.519,0.742,34,26,7,7
6898,21900750,San Antonio Spurs,Los Angeles Clippers,105,108,213,3,Los Angeles Clippers,3,0.324,0.813,46,21,5,9,0.407,0.792,51,28,3,2
6899,21900751,Milwaukee Bucks,New Orleans Pelicans,120,108,228,12,Milwaukee Bucks,12,0.306,0.765,53,34,11,7,0.286,0.75,49,26,10,6
6900,21900752,Charlotte Hornets,Houston Rockets,110,125,235,15,Houston Rockets,15,0.394,0.792,53,22,2,2,0.333,0.826,41,25,11,5
6901,21900753,Portland Trail Blazers,Denver Nuggets,99,127,226,28,Denver Nuggets,28,0.29,0.818,36,16,5,6,0.5,0.72,50,30,5,7
6902,21900754,San Antonio Spurs,Los Angeles Lakers,102,129,231,27,Los Angeles Lakers,27,0.481,0.6,28,21,6,2,0.429,0.68,58,28,5,4
6903,21900755,Phoenix Suns,Detroit Pistons,108,116,224,8,Detroit Pistons,8,0.462,0.8,37,29,4,5,0.429,0.75,42,31,9,2
6904,21900756,Orlando Magic,Boston Celtics,100,116,216,16,Boston Celtics,16,0.419,0.767,39,20,10,6,0.565,0.688,41,23,10,6
6905,21900757,Golden State Warriors,Brooklyn Nets,88,129,217,41,Brooklyn Nets,41,0.128,0.722,34,20,6,7,0.412,0.867,65,29,4,1
6906,21900758,Indiana Pacers,Toronto Raptors,118,119,237,1,Toronto Raptors,1,0.487,0.813,42,29,6,5,0.375,0.875,37,27,12,0
6907,21900759,Atlanta Hawks,Minnesota Timberwolves,127,120,247,7,Atlanta Hawks,7,0.406,0.933,44,23,7,4,0.257,0.75,33,18,13,7
6908,21900760,Cleveland Cavaliers,Oklahoma City Thunder,103,109,212,6,Oklahoma City Thunder,6,0.395,0.545,45,31,4,2,0.346,0.8,40,21,9,6
6909,21900761,Memphis Grizzlies,Dallas Mavericks,121,107,228,14,Memphis Grizzlies,14,0.48,0.75,52,27,6,4,0.395,0.917,42,19,5,6
6910,21900762,Denver Nuggets,Utah Jazz,98,95,193,3,Denver Nuggets,3,0.233,0.722,52,23,8,5,0.359,0.643,46,20,5,1
6911,21900763,Miami Heat,Los Angeles Clippers,111,128,239,17,Los Angeles Clippers,17,0.381,0.714,46,29,7,2,0.444,0.737,51,35,6,5
6912,21900764,Orlando Magic,New York Knicks,103,105,208,2,New York Knicks,2,0.29,0.867,39,22,8,9,0.3,0.684,39,27,12,5
6913,21900765,New Orleans Pelicans,Chicago Bulls,125,119,244,6,New Orleans Pelicans,6,0.421,0.579,45,38,12,7,0.448,0.609,40,25,11,1
6914,21900766,Philadelphia 76ers,Milwaukee Bucks,101,112,213,11,Milwaukee Bucks,11,0.422,0.571,50,24,7,4,0.324,0.667,60,19,3,8
6915,21900767,San Antonio Spurs,Portland Trail Blazers,117,125,242,8,Portland Trail Blazers,8,0.357,0.893,39,25,9,3,0.486,0.75,50,28,2,6
6916,21900768,Houston Rockets,Los Angeles Lakers,121,111,232,10,Houston Rockets,10,0.452,0.889,37,20,8,4,0.29,0.75,38,33,10,4
6917,21900769,Memphis Grizzlies,Philadelphia 76ers,107,119,226,12,Philadelphia 76ers,12,0.238,0.839,40,25,13,6,0.56,0.6,50,34,8,11
6918,21900770,Dallas Mavericks,Washington Wizards,118,119,237,1,Washington Wizards,1,0.4,0.857,49,27,7,2,0.5,0.769,39,28,8,4
6919,21900771,Atlanta Hawks,Boston Celtics,107,112,219,5,Boston Celtics,5,0.333,0.923,46,21,7,8,0.432,0.815,47,23,5,8
6920,21900772,Toronto Raptors,Indiana Pacers,115,106,221,9,Toronto Raptors,9,0.447,0.824,39,28,12,3,0.294,0.818,47,26,5,5
6921,21900773,Detroit Pistons,Oklahoma City Thunder,101,108,209,7,Oklahoma City Thunder,7,0.289,0.737,37,19,7,1,0.217,0.833,42,21,4,6
6922,21900774,Houston Rockets,Phoenix Suns,91,127,218,36,Phoenix Suns,36,0.229,0.846,29,16,8,5,0.484,0.963,51,29,10,9
6923,21900775,Miami Heat,Sacramento Kings,97,105,202,8,Sacramento Kings,8,0.3,0.68,42,21,7,5,0.432,0.5,36,29,8,3
6924,21900776,Portland Trail Blazers,Utah Jazz,114,117,231,3,Utah Jazz,3,0.425,0.643,43,14,9,4,0.333,0.708,56,21,6,2
6925,21900777,Milwaukee Bucks,Orlando Magic,111,95,206,16,Milwaukee Bucks,16,0.385,0.75,62,26,4,5,0.25,0.786,46,28,10,6
6926,21900778,Dallas Mavericks,Charlotte Hornets,116,100,216,16,Dallas Mavericks,16,0.486,1,46,29,5,6,0.306,0.722,39,15,5,4
6927,21900779,New York Knicks,Detroit Pistons,95,92,187,3,New York Knicks,3,0.364,0.647,47,24,5,6,0.448,0.688,28,21,5,7
6928,21900780,New Orleans Pelicans,Indiana Pacers,124,117,241,7,New Orleans Pelicans,7,0.395,0.84,53,27,8,2,0.346,0.741,37,25,5,9
6929,21900781,Brooklyn Nets,Toronto Raptors,118,119,237,1,Toronto Raptors,1,0.364,0.833,46,27,5,5,0.4,0.714,48,22,6,5
6930,21900782,Los Angeles Clippers,Minnesota Timberwolves,115,142,257,27,Minnesota Timberwolves,27,0.346,0.828,43,24,8,5,0.591,0.667,46,39,8,3
6931,21900783,Los Angeles Lakers,Golden State Warriors,125,120,245,5,Los Angeles Lakers,5,0.483,0.735,47,29,11,2,0.406,0.652,33,31,15,6
6932,21900784,Denver Nuggets,Phoenix Suns,117,108,225,9,Denver Nuggets,9,0.393,0.762,40,23,7,7,0.281,1,41,25,7,4
6933,21900785,San Antonio Spurs,Sacramento Kings,102,122,224,20,Sacramento Kings,20,0.292,0.722,41,23,7,4,0.543,0.65,39,25,6,2
6934,21900786,Boston Celtics,Oklahoma City Thunder,112,111,223,1,Boston Celtics,1,0.444,0.741,53,19,6,2,0.407,0.759,44,14,3,3
6935,21900787,New York Knicks,Atlanta Hawks,135,140,275,5,Atlanta Hawks,5,0.382,0.72,56,30,12,6,0.35,0.903,50,29,9,8
6936,21900788,Chicago Bulls,Philadelphia 76ers,111,118,229,7,Philadelphia 76ers,7,0.375,0.765,42,23,8,3,0.407,0.719,44,29,12,6
6937,21900789,Memphis Grizzlies,Washington Wizards,106,99,205,7,Memphis Grizzlies,7,0.156,0.6,62,19,4,4,0.212,0.759,50,25,7,4
6938,21900790,Utah Jazz,Houston Rockets,114,113,227,1,Utah Jazz,1,0.395,0.833,48,25,2,4,0.357,0.714,36,20,10,5
6939,21900791,Los Angeles Clippers,Cleveland Cavaliers,133,92,225,41,Los Angeles Clippers,41,0.333,0.75,52,28,11,6,0.212,0.682,45,22,9,1
6940,21900792,Miami Heat,Portland Trail Blazers,109,115,224,6,Portland Trail Blazers,6,0.408,0.786,49,31,6,5,0.452,0.727,43,20,9,6
6941,21900793,Charlotte Hornets,Detroit Pistons,87,76,163,11,Charlotte Hornets,11,0.25,0.857,45,19,10,3,0.2,0.846,52,21,4,5
6942,21900794,Brooklyn Nets,Indiana Pacers,106,105,211,1,Brooklyn Nets,1,0.324,0.75,53,20,5,7,0.233,0.727,40,28,7,3
6943,21900795,Atlanta Hawks,Orlando Magic,126,135,261,9,Orlando Magic,9,0.432,0.941,31,33,5,5,0.474,0.773,45,33,9,5
6944,21900796,Minnesota Timberwolves,Toronto Raptors,126,137,263,11,Toronto Raptors,11,0.45,0.857,38,24,6,4,0.515,0.783,41,29,15,4
6945,21900797,Sacramento Kings,Milwaukee Bucks,111,123,234,12,Milwaukee Bucks,12,0.326,0.722,49,23,6,5,0.429,0.826,55,26,7,5
6946,21900798,Utah Jazz,Dallas Mavericks,123,119,242,4,Utah Jazz,4,0.429,0.762,45,27,5,2,0.349,0.839,26,24,8,3
6947,21900799,San Antonio Spurs,Denver Nuggets,120,127,247,7,Denver Nuggets,7,0.5,0.88,36,33,7,1,0.514,0.826,37,34,7,5
6948,21900800,Miami Heat,Golden State Warriors,113,101,214,12,Miami Heat,12,0.364,0.714,45,36,10,3,0.324,0.882,40,23,8,2
6949,21900801,Phoenix Suns,Los Angeles Lakers,100,125,225,25,Los Angeles Lakers,25,0.355,0.806,29,26,7,2,0.378,0.68,59,28,8,4
6950,21900802,Los Angeles Clippers,Philadelphia 76ers,103,110,213,7,Philadelphia 76ers,7,0.452,0.692,42,25,2,6,0.296,0.667,50,25,3,7
6951,21900803,Chicago Bulls,Washington Wizards,114,126,240,12,Washington Wizards,12,0.41,0.714,44,25,9,4,0.344,0.792,44,28,11,6
6952,21900804,Portland Trail Blazers,New Orleans Pelicans,117,138,255,21,New Orleans Pelicans,21,0.241,0.786,40,21,5,3,0.412,0.813,50,40,7,5
6953,21900805,San Antonio Spurs,Oklahoma City Thunder,114,106,220,8,San Antonio Spurs,8,0.28,0.926,46,20,9,7,0.355,0.81,35,19,8,2
6954,21900806,Boston Celtics,Houston Rockets,105,116,221,11,Houston Rockets,11,0.344,0.8,48,24,11,4,0.289,0.881,45,17,9,6
6955,21900807,Atlanta Hawks,Cleveland Cavaliers,105,127,232,22,Cleveland Cavaliers,22,0.382,0.8,38,24,11,5,0.357,0.84,55,25,8,6
6956,21900808,Detroit Pistons,Orlando Magic,112,116,228,4,Orlando Magic,4,0.4,0.933,47,28,5,7,0.333,0.889,46,34,13,7
6957,21900809,Toronto Raptors,Brooklyn Nets,91,101,192,10,Brooklyn Nets,10,0.302,0.769,42,21,6,4,0.257,0.8,55,27,7,5
6958,21900810,Milwaukee Bucks,Indiana Pacers,111,118,229,7,Indiana Pacers,7,0.351,0.96,44,18,7,5,0.333,0.792,44,28,10,3
6959,21900811,Washington Wizards,New York Knicks,114,96,210,18,Washington Wizards,18,0.357,0.727,40,25,13,7,0.13,0.724,52,19,10,3
6960,21900812,Portland Trail Blazers,Memphis Grizzlies,104,111,215,7,Memphis Grizzlies,7,0.351,0.792,51,21,7,3,0.261,0.682,57,26,8,9
6961,21900813,Charlotte Hornets,Minnesota Timberwolves,115,108,223,7,Charlotte Hornets,7,0.412,0.652,52,22,7,4,0.286,0.8,48,25,10,7
6962,21900814,Sacramento Kings,Dallas Mavericks,111,130,241,19,Dallas Mavericks,19,0.308,0.773,40,26,7,2,0.425,0.81,47,34,1,7
6963,21900815,Golden State Warriors,Phoenix Suns,106,112,218,6,Phoenix Suns,6,0.355,0.895,38,27,8,7,0.378,0.933,40,25,14,4
6964,21900816,Miami Heat,Utah Jazz,101,116,217,15,Utah Jazz,15,0.333,0.75,37,19,11,4,0.389,0.87,53,23,6,3
6965,21900817,Los Angeles Lakers,Denver Nuggets,120,116,236,4,Los Angeles Lakers,4,0.364,0.519,49,29,8,4,0.44,0.773,42,32,9,2
6966,21900818,Los Angeles Clippers,Boston Celtics,133,141,274,8,Boston Celtics,8,0.314,0.811,55,19,4,10,0.419,0.825,51,22,9,6
6967,21900819,Oklahoma City Thunder,New Orleans Pelicans,123,118,241,5,Oklahoma City Thunder,5,0.481,0.818,40,28,11,5,0.4,0.741,46,31,3,7
6968,21900820,Milwaukee Bucks,Detroit Pistons,126,106,232,20,Milwaukee Bucks,20,0.303,0.815,41,24,14,3,0.351,0.813,46,25,3,5
6969,21900821,Miami Heat,Atlanta Hawks,124,129,253,5,Atlanta Hawks,5,0.297,0.868,51,28,9,7,0.457,0.886,41,22,8,6
6970,21900822,Brooklyn Nets,Philadelphia 76ers,104,112,216,8,Philadelphia 76ers,8,0.294,0.786,49,22,3,1,0.182,0.914,48,19,10,6
6971,21900823,Charlotte Hornets,Chicago Bulls,103,93,196,10,Charlotte Hornets,10,0.286,0.862,44,22,9,4,0.226,0.632,38,24,12,3
6972,21900824,Memphis Grizzlies,Sacramento Kings,125,129,254,4,Sacramento Kings,4,0.4,0.844,51,25,5,5,0.487,0.722,27,22,9,2
6973,21900825,Houston Rockets,Golden State Warriors,135,105,240,30,Houston Rockets,30,0.51,0.909,36,31,14,7,0.212,0.833,40,26,11,7
6974,21900826,Dallas Mavericks,Orlando Magic,122,106,228,16,Dallas Mavericks,16,0.395,0.808,50,26,6,7,0.209,0.789,48,21,11,2
6975,21900827,Cleveland Cavaliers,Washington Wizards,113,108,221,5,Cleveland Cavaliers,5,0.407,0.64,47,19,3,6,0.243,0.739,47,24,12,3
6976,21900828,Indiana Pacers,New York Knicks,106,98,204,8,Indiana Pacers,8,0.286,0.788,50,20,7,5,0.44,0.68,40,21,7,7
6977,21900829,Phoenix Suns,Toronto Raptors,101,118,219,17,Toronto Raptors,17,0.176,0.826,34,29,12,3,0.378,0.909,48,24,7,13
6978,21900830,Boston Celtics,Minnesota Timberwolves,127,117,244,10,Boston Celtics,10,0.345,0.784,58,21,5,6,0.357,0.857,43,23,8,10
6979,21900831,Denver Nuggets,Oklahoma City Thunder,101,113,214,12,Oklahoma City Thunder,12,0.222,0.913,39,19,7,3,0.346,0.889,44,19,12,3
6980,21900832,San Antonio Spurs,Utah Jazz,113,104,217,9,San Antonio Spurs,9,0.5,0.885,48,22,12,7,0.364,0.846,47,25,4,6
6981,21900833,Memphis Grizzlies,Los Angeles Lakers,105,117,222,12,Los Angeles Lakers,12,0.333,0.516,50,22,9,1,0.31,0.65,49,25,9,14
6982,21900834,New Orleans Pelicans,Portland Trail Blazers,128,115,243,13,New Orleans Pelicans,13,0.529,0.606,46,36,8,3,0.37,0.76,46,20,7,9
6983,21900835,Sacramento Kings,Los Angeles Clippers,112,103,215,9,Sacramento Kings,9,0.387,0.769,48,25,11,4,0.333,0.862,47,20,7,3
6984,21900836,Brooklyn Nets,Charlotte Hornets,115,86,201,29,Brooklyn Nets,29,0.362,0.737,54,26,10,6,0.343,0.571,45,22,5,2
6985,21900837,Dallas Mavericks,Atlanta Hawks,107,111,218,4,Atlanta Hawks,4,0.318,0.684,48,23,5,10,0.216,0.654,53,27,9,4
6986,21900838,Cleveland Cavaliers,Miami Heat,105,124,229,19,Miami Heat,19,0.361,0.727,40,29,8,2,0.475,0.75,29,34,16,4
6987,21900839,Phoenix Suns,Chicago Bulls,112,104,216,8,Phoenix Suns,8,0.333,0.839,47,26,10,4,0.368,0.857,38,18,11,7
6988,21900840,Philadelphia 76ers,Milwaukee Bucks,98,119,217,21,Milwaukee Bucks,21,0.342,0.833,43,17,10,4,0.341,0.692,57,35,2,6
6989,21900841,Houston Rockets,Utah Jazz,120,110,230,10,Houston Rockets,10,0.417,0.714,42,20,9,5,0.226,0.792,46,18,1,2
6990,21900842,Boston Celtics,Los Angeles Lakers,112,114,226,2,Los Angeles Lakers,2,0.382,0.767,44,20,7,3,0.324,0.676,46,20,9,4
6991,21900843,Indiana Pacers,Toronto Raptors,81,127,208,46,Toronto Raptors,46,0.242,0.647,39,23,13,4,0.386,0.889,57,32,9,10
6992,21900844,Minnesota Timberwolves,Denver Nuggets,116,128,244,12,Denver Nuggets,12,0.35,0.759,38,26,7,2,0.367,0.647,38,29,9,7
6993,21900845,Washington Wizards,Chicago Bulls,117,126,243,9,Chicago Bulls,9,0.4,0.861,34,24,15,3,0.486,0.643,37,27,15,4
6994,21900846,San Antonio Spurs,Oklahoma City Thunder,103,131,234,28,Oklahoma City Thunder,28,0.289,0.842,43,27,5,1,0.455,0.875,54,28,7,7
6995,21900847,New Orleans Pelicans,Golden State Warriors,115,101,216,14,New Orleans Pelicans,14,0.405,0.462,52,34,7,5,0.314,0.667,48,28,9,7
6996,21900848,Detroit Pistons,Portland Trail Blazers,104,107,211,3,Portland Trail Blazers,3,0.314,0.95,44,18,7,5,0.433,0.632,41,20,6,5
6997,21900849,Miami Heat,Cleveland Cavaliers,119,125,244,6,Cleveland Cavaliers,6,0.381,0.75,49,33,6,11,0.378,0.735,53,25,8,6
6998,21900850,Atlanta Hawks,Philadelphia 76ers,112,129,241,17,Philadelphia 76ers,17,0.211,0.889,44,19,5,2,0.4,0.9,48,27,9,5
6999,21900851,Milwaukee Bucks,Washington Wizards,137,134,271,3,Milwaukee Bucks,3,0.459,0.815,45,26,7,4,0.429,0.758,41,27,8,0
7000,21900852,Orlando Magic,Brooklyn Nets,115,113,228,2,Orlando Magic,2,0.382,0.824,41,27,6,9,0.432,0.625,49,29,6,3
7001,21900853,New York Knicks,Houston Rockets,112,123,235,11,Houston Rockets,11,0.379,0.7,54,20,12,8,0.333,0.677,38,20,11,7
7002,21900854,Minnesota Timberwolves,Dallas Mavericks,123,139,262,16,Dallas Mavericks,16,0.357,0.706,42,16,4,6,0.364,0.75,54,28,7,3
7003,21900855,Phoenix Suns,Utah Jazz,131,111,242,20,Phoenix Suns,20,0.6,0.875,38,33,10,1,0.385,0.86,30,16,8,2
7004,21900856,Memphis Grizzlies,Los Angeles Clippers,97,124,221,27,Los Angeles Clippers,27,0.259,0.727,45,20,6,7,0.432,0.824,50,33,7,5
7005,21900857,Charlotte Hornets,Indiana Pacers,80,119,199,39,Indiana Pacers,39,0.303,0.444,39,22,10,1,0.435,0.846,56,35,8,11
7006,21900858,Milwaukee Bucks,Toronto Raptors,108,97,205,11,Milwaukee Bucks,11,0.333,0.833,53,23,10,10,0.346,0.714,43,21,4,5
7007,21900859,Oklahoma City Thunder,Chicago Bulls,124,122,246,2,Oklahoma City Thunder,2,0.467,0.743,37,25,8,7,0.387,0.667,39,22,6,4
7008,21900860,Detroit Pistons,Denver Nuggets,98,115,213,17,Denver Nuggets,17,0.366,0.81,33,24,8,2,0.474,0.818,41,33,12,3
7009,21900861,New Orleans Pelicans,Los Angeles Lakers,109,118,227,9,Los Angeles Lakers,9,0.296,0.767,45,31,10,2,0.295,0.714,51,27,10,12
7010,21900862,Boston Celtics,Portland Trail Blazers,118,106,224,12,Boston Celtics,12,0.487,0.929,45,19,6,3,0.419,0.739,41,24,8,4
7011,21900863,Sacramento Kings,Golden State Warriors,112,94,206,18,Sacramento Kings,18,0.433,0.559,40,25,7,4,0.143,0.833,34,21,7,2
7012,21900864,New York Knicks,Charlotte Hornets,101,107,208,6,Charlotte Hornets,6,0.267,0.647,42,22,5,6,0.333,0.76,37,25,7,4
7013,21900865,Philadelphia 76ers,Cleveland Cavaliers,94,108,202,14,Cleveland Cavaliers,14,0.342,0.643,31,22,13,9,0.458,0.882,48,24,5,4
7014,21900866,Brooklyn Nets,Washington Wizards,106,110,216,4,Washington Wizards,4,0.278,0.686,56,15,7,1,0.385,0.813,39,22,9,2
7015,21900867,Orlando Magic,Atlanta Hawks,130,120,250,10,Orlando Magic,10,0.438,0.72,52,30,7,9,0.361,0.92,42,30,5,5
7016,21900868,Minnesota Timberwolves,Miami Heat,129,126,255,3,Minnesota Timberwolves,3,0.37,0.72,33,28,16,8,0.423,0.767,43,30,9,8
7017,21900869,Dallas Mavericks,San Antonio Spurs,109,103,212,6,Dallas Mavericks,6,0.378,0.667,43,25,11,9,0.333,0.737,55,22,8,7
7018,21900870,Memphis Grizzlies,Houston Rockets,112,140,252,28,Houston Rockets,28,0.333,0.619,49,28,9,3,0.46,0.867,44,22,8,7
7019,21900871,Los Angeles Clippers,Phoenix Suns,102,92,194,10,Los Angeles Clippers,10,0.368,0.933,46,22,11,2,0.265,0.833,48,29,8,3
7020,21900872,Boston Celtics,Utah Jazz,114,103,217,11,Boston Celtics,11,0.423,0.813,44,21,7,4,0.3,0.733,41,16,5,3
7021,21900873,New York Knicks,Philadelphia 76ers,106,115,221,9,Philadelphia 76ers,9,0.348,0.583,39,28,2,3,0.484,0.769,44,32,5,7
7022,21900874,Portland Trail Blazers,Indiana Pacers,100,106,206,6,Indiana Pacers,6,0.3,0.643,45,14,5,5,0.32,0.783,48,21,8,4
7023,21900875,Sacramento Kings,Oklahoma City Thunder,108,112,220,4,Oklahoma City Thunder,4,0.343,1,45,30,6,2,0.346,0.724,37,20,6,4
7024,21900876,Los Angeles Lakers,Golden State Warriors,116,86,202,30,Los Angeles Lakers,30,0.333,0.667,44,24,13,5,0.281,0.9,37,27,7,3
7025,21900877,Minnesota Timberwolves,Orlando Magic,125,136,261,11,Orlando Magic,11,0.386,0.667,33,27,10,6,0.3,0.818,54,36,6,7
7026,21900878,Brooklyn Nets,Atlanta Hawks,118,141,259,23,Atlanta Hawks,23,0.391,0.762,38,30,5,8,0.487,0.733,52,32,8,4
7027,21900879,Charlotte Hornets,Toronto Raptors,99,96,195,3,Charlotte Hornets,3,0.433,0.72,58,23,3,8,0.233,0.69,45,19,11,3
7028,21900880,Dallas Mavericks,Miami Heat,118,126,244,8,Miami Heat,8,0.42,0.895,35,25,0,3,0.486,0.75,40,30,6,2
7029,21900881,Sacramento Kings,Memphis Grizzlies,104,101,205,3,Sacramento Kings,3,0.289,0.81,47,24,11,3,0.267,0.75,52,27,7,5
7030,21900882,Oklahoma City Thunder,Milwaukee Bucks,86,133,219,47,Milwaukee Bucks,47,0.171,0.7,36,14,8,3,0.467,0.857,66,34,6,2
7031,21900883,Cleveland Cavaliers,New Orleans Pelicans,104,116,220,12,New Orleans Pelicans,12,0.355,0.583,34,27,7,2,0.391,0.733,49,36,12,8
7032,21900884,Detroit Pistons,Phoenix Suns,113,111,224,2,Detroit Pistons,2,0.406,0.75,31,27,14,3,0.391,0.706,38,31,9,5
7033,21900885,Washington Wizards,Utah Jazz,119,129,248,10,Utah Jazz,10,0.378,0.714,41,23,12,4,0.514,0.733,54,23,7,5
7034,21900886,Denver Nuggets,Los Angeles Clippers,103,132,235,29,Los Angeles Clippers,29,0.36,0.75,39,19,7,6,0.462,0.9,46,35,6,5
7035,21900887,Chicago Bulls,New York Knicks,115,125,240,10,New York Knicks,10,0.486,0.696,33,26,12,3,0.4,0.697,50,29,6,4
7036,21900888,Portland Trail Blazers,Atlanta Hawks,117,129,246,12,Atlanta Hawks,12,0.286,0.714,42,14,9,4,0.429,0.864,36,34,7,5
7037,21900889,Brooklyn Nets,Miami Heat,113,116,229,3,Miami Heat,3,0.364,0.739,44,30,3,3,0.368,0.833,45,27,4,4
7038,21900890,Indiana Pacers,Cleveland Cavaliers,113,104,217,9,Indiana Pacers,9,0.348,0.786,38,30,10,6,0.227,0.85,36,30,9,3
7039,21900891,Los Angeles Lakers,Memphis Grizzlies,88,105,193,17,Memphis Grizzlies,17,0.257,0.583,45,26,5,3,0.323,0.818,51,27,10,4
7040,21900892,Houston Rockets,Boston Celtics,111,110,221,1,Houston Rockets,1,0.273,0.778,53,17,10,8,0.31,0.76,54,22,11,6
7041,21900893,Orlando Magic,San Antonio Spurs,113,114,227,1,San Antonio Spurs,1,0.405,0.696,41,28,9,5,0.452,0.75,31,28,11,5
7042,21900894,Golden State Warriors,Phoenix Suns,115,99,214,16,Golden State Warriors,16,0.3,0.75,49,30,9,6,0.414,0.826,40,24,3,5
7043,21900895,Milwaukee Bucks,Charlotte Hornets,93,85,178,8,Milwaukee Bucks,8,0.226,0.762,61,20,7,6,0.229,0.9,47,22,7,8
7044,21900896,Dallas Mavericks,Minnesota Timberwolves,111,91,202,20,Dallas Mavericks,20,0.275,0.632,56,28,10,7,0.31,0.4,57,19,9,3
7045,21900897,Philadelphia 76ers,Los Angeles Clippers,130,136,266,6,Los Angeles Clippers,6,0.488,0.65,37,27,7,4,0.542,0.805,37,25,6,6
7046,21900898,Toronto Raptors,Denver Nuggets,118,133,251,15,Denver Nuggets,15,0.263,0.897,36,24,9,4,0.5,0.7,41,38,6,1
7047,21900899,Detroit Pistons,Sacramento Kings,100,106,206,6,Sacramento Kings,6,0.429,0.667,42,23,6,4,0.257,0.885,51,18,8,7
7048,21900900,Los Angeles Lakers,New Orleans Pelicans,122,114,236,8,Los Angeles Lakers,8,0.371,0.9,36,23,9,10,0.219,0.818,52,24,7,3
7049,21900901,Washington Wizards,Golden State Warriors,124,110,234,14,Washington Wizards,14,0.667,0.889,34,24,10,5,0.321,0.708,52,25,7,7
7050,21900902,Utah Jazz,Cleveland Cavaliers,126,113,239,13,Utah Jazz,13,0.488,0.857,47,30,3,7,0.415,0.667,36,28,10,1
7051,21900903,Houston Rockets,New York Knicks,123,125,248,2,New York Knicks,2,0.357,0.926,34,25,11,5,0.4,0.633,65,26,6,7
7052,21900904,Portland Trail Blazers,Orlando Magic,130,107,237,23,Portland Trail Blazers,23,0.485,1,49,27,6,4,0.326,0.864,39,29,3,2
7053,21900905,Memphis Grizzlies,Atlanta Hawks,127,88,215,39,Memphis Grizzlies,39,0.438,0.677,60,30,12,8,0.257,0.938,43,20,6,8
7054,21900906,Milwaukee Bucks,Miami Heat,89,105,194,16,Miami Heat,16,0.206,0.632,48,19,4,5,0.486,0.722,46,28,4,4
7055,21900907,Dallas Mavericks,Chicago Bulls,107,109,216,2,Chicago Bulls,2,0.286,0.75,44,26,9,5,0.278,0.647,42,24,7,5
7056,21900908,Indiana Pacers,San Antonio Spurs,116,111,227,5,Indiana Pacers,5,0.484,0.885,40,22,9,5,0.5,0.789,33,21,6,5
7057,21900909,San Antonio Spurs,Charlotte Hornets,104,103,207,1,San Antonio Spurs,1,0.344,0.85,33,25,12,5,0.414,0.722,46,25,4,2
7058,21900910,Brooklyn Nets,Boston Celtics,129,120,249,9,Brooklyn Nets,9,0.286,0.763,63,22,7,6,0.306,0.739,42,24,10,6
7059,21900911,Minnesota Timberwolves,New Orleans Pelicans,139,134,273,5,Minnesota Timberwolves,5,0.412,0.85,42,31,11,2,0.359,0.593,44,37,13,2
7060,21900912,Los Angeles Clippers,Oklahoma City Thunder,109,94,203,15,Los Angeles Clippers,15,0.306,0.846,41,19,7,1,0.321,0.654,43,16,7,7
7061,21900913,Golden State Warriors,Denver Nuggets,116,100,216,16,Golden State Warriors,16,0.439,0.636,35,31,8,3,0.15,0.731,53,22,6,5
7062,21900914,Toronto Raptors,Phoenix Suns,123,114,237,9,Toronto Raptors,9,0.412,0.829,47,17,9,5,0.385,0.84,35,30,6,6
7063,21900915,Philadelphia 76ers,Los Angeles Lakers,107,120,227,13,Los Angeles Lakers,13,0.4,0.75,42,24,10,1,0.394,0.833,43,25,9,6
7064,21900916,Washington Wizards,Sacramento Kings,126,133,259,7,Sacramento Kings,7,0.421,0.824,31,28,10,5,0.448,0.833,42,23,13,2
7065,21900917,Boston Celtics,Cleveland Cavaliers,112,106,218,6,Boston Celtics,6,0.367,0.808,49,16,10,7,0.342,0.75,50,24,6,2
7066,21900918,Oklahoma City Thunder,Detroit Pistons,114,107,221,7,Oklahoma City Thunder,7,0.417,0.706,33,25,13,8,0.419,0.6,36,27,8,5
7067,21900919,Orlando Magic,Miami Heat,113,116,229,3,Miami Heat,3,0.433,0.857,35,28,6,5,0.5,0.8,36,31,8,5
7068,21900920,Memphis Grizzlies,Brooklyn Nets,118,79,197,39,Memphis Grizzlies,39,0.455,0.857,59,21,8,5,0.167,0.706,42,15,6,4
7069,21900921,Utah Jazz,New York Knicks,112,104,216,8,Utah Jazz,8,0.278,0.8,37,26,5,5,0.35,0.833,42,23,3,1
7070,21900922,Chicago Bulls,Minnesota Timberwolves,108,115,223,7,Minnesota Timberwolves,7,0.367,0.636,40,24,10,5,0.442,0.64,43,27,5,4
7071,21900923,New Orleans Pelicans,Dallas Mavericks,123,127,250,4,Dallas Mavericks,4,0.37,0.545,52,28,8,4,0.44,0.708,49,30,6,13
7072,21900924,Indiana Pacers,Milwaukee Bucks,100,119,219,19,Milwaukee Bucks,19,0.259,0.818,39,22,12,2,0.283,0.909,56,26,8,4
7073,21900925,Washington Wizards,Portland Trail Blazers,104,125,229,21,Portland Trail Blazers,21,0.314,0.619,48,27,8,4,0.419,0.875,47,24,7,11
7074,21900926,Denver Nuggets,Charlotte Hornets,114,112,226,2,Denver Nuggets,2,0.308,0.9,38,29,7,5,0.394,0.821,34,24,7,2
7075,21900927,Los Angeles Clippers,Houston Rockets,120,105,225,15,Los Angeles Clippers,15,0.325,0.744,57,22,5,6,0.167,0.778,51,19,6,5
7076,21900928,Philadelphia 76ers,Sacramento Kings,125,108,233,17,Philadelphia 76ers,17,0.459,0.824,45,24,8,2,0.379,0.722,37,23,7,4
7077,21900929,Toronto Raptors,Golden State Warriors,121,113,234,8,Toronto Raptors,8,0.317,0.903,39,28,10,3,0.269,0.76,52,34,4,5
7078,21900930,Atlanta Hawks,Washington Wizards,112,118,230,6,Washington Wizards,6,0.375,0.667,36,25,9,4,0.484,0.886,38,24,9,4
7079,21900931,San Antonio Spurs,Brooklyn Nets,120,139,259,19,Brooklyn Nets,19,0.294,0.889,38,25,3,5,0.417,0.71,52,32,1,2
7080,21900932,Oklahoma City Thunder,New York Knicks,126,103,229,23,Oklahoma City Thunder,23,0.387,0.8,38,26,8,6,0.167,0.773,48,19,4,8
7081,21900933,Utah Jazz,Boston Celtics,99,94,193,5,Utah Jazz,5,0.378,0.833,40,23,8,7,0.278,0.778,45,19,6,6
7082,21900934,Indiana Pacers,Chicago Bulls,108,102,210,6,Indiana Pacers,6,0.364,0.727,46,24,9,8,0.237,0.867,45,27,12,6
7083,21900935,Orlando Magic,Minnesota Timberwolves,132,118,250,14,Orlando Magic,14,0.333,0.742,45,31,5,5,0.27,0.8,36,30,6,3
7084,21900936,Miami Heat,New Orleans Pelicans,104,110,214,6,New Orleans Pelicans,6,0.273,0.677,45,27,11,9,0.368,0.714,53,28,7,6
7085,21900937,Memphis Grizzlies,Dallas Mavericks,96,121,217,25,Dallas Mavericks,25,0.3,0.692,47,29,7,4,0.383,0.765,48,30,11,9
7086,21900938,Portland Trail Blazers,Phoenix Suns,117,127,244,10,Phoenix Suns,10,0.406,0.75,39,26,6,6,0.452,0.947,47,29,9,4
7087,21900939,Milwaukee Bucks,Los Angeles Lakers,103,113,216,10,Los Angeles Lakers,10,0.279,0.739,45,22,8,1,0.188,0.816,52,19,11,4
7088,21900940,Houston Rockets,Charlotte Hornets,99,108,207,9,Charlotte Hornets,9,0.333,0.7,42,22,9,3,0.469,0.76,30,29,7,1
7089,21900941,Utah Jazz,Detroit Pistons,111,105,216,6,Utah Jazz,6,0.303,0.75,40,17,10,4,0.3,0.727,38,24,4,2
7090,21900942,Denver Nuggets,Cleveland Cavaliers,102,104,206,2,Cleveland Cavaliers,2,0.406,0.375,33,28,15,0,0.429,0.667,39,32,8,2
7091,21900943,Atlanta Hawks,Memphis Grizzlies,101,118,219,17,Memphis Grizzlies,17,0.265,0.857,46,23,9,2,0.364,0.606,58,27,9,6
7092,21900944,Philadelphia 76ers,Golden State Warriors,114,118,232,4,Golden State Warriors,4,0.382,0.864,41,29,3,2,0.36,0.75,35,30,4,2
7093,21900945,Sacramento Kings,Portland Trail Blazers,123,111,234,12,Sacramento Kings,12,0.538,0.87,47,30,9,3,0.256,0.654,41,22,9,3
7094,21900946,Chicago Bulls,Brooklyn Nets,107,110,217,3,Brooklyn Nets,3,0.353,0.68,31,23,14,3,0.367,0.854,50,21,4,5
7095,21900947,New Orleans Pelicans,Minnesota Timberwolves,120,107,227,13,New Orleans Pelicans,13,0.314,0.677,54,28,7,5,0.242,0.806,42,20,15,3
7096,21900948,Los Angeles Lakers,Los Angeles Clippers,112,103,215,9,Los Angeles Lakers,9,0.286,0.857,45,22,8,7,0.226,0.757,49,12,5,5
7097,21900949,Oklahoma City Thunder,Boston Celtics,105,104,209,1,Oklahoma City Thunder,1,0.4,0.735,39,16,9,7,0.351,0.789,46,22,9,5
7098,21900950,Milwaukee Bucks,Phoenix Suns,131,140,271,9,Phoenix Suns,9,0.394,0.762,36,23,7,3,0.442,0.871,47,30,6,4
7099,21900951,Miami Heat,Washington Wizards,100,89,189,11,Miami Heat,11,0.464,0.821,46,21,7,8,0.404,0.857,29,19,11,2
7100,21900952,Indiana Pacers,Dallas Mavericks,112,109,221,3,Indiana Pacers,3,0.348,0.667,47,23,5,6,0.326,0.68,42,19,7,5
7101,21900953,Orlando Magic,Houston Rockets,126,106,232,20,Orlando Magic,20,0.448,0.806,49,21,11,4,0.281,0.76,38,21,10,7
7102,21900954,San Antonio Spurs,Cleveland Cavaliers,129,132,261,3,Cleveland Cavaliers,3,0.385,0.917,44,20,15,6,0.382,0.733,60,26,4,4
7103,21900955,Detroit Pistons,New York Knicks,84,96,180,12,New York Knicks,12,0.289,0.682,35,21,8,2,0.316,0.72,51,15,10,5
7104,21900956,Toronto Raptors,Sacramento Kings,118,113,231,5,Toronto Raptors,5,0.396,0.778,36,27,10,3,0.258,0.913,50,24,5,7
7105,21900957,Charlotte Hornets,Atlanta Hawks,138,143,281,5,Atlanta Hawks,5,0.396,0.913,35,31,9,6,0.488,0.593,53,33,1,5
7106,21900958,Milwaukee Bucks,Denver Nuggets,95,109,204,14,Denver Nuggets,14,0.3,0.667,48,23,8,4,0.39,0.917,48,28,11,8
7107,21900959,Toronto Raptors,Utah Jazz,101,92,193,9,Toronto Raptors,9,0.361,0.889,53,22,9,2,0.372,0.714,34,24,12,4
7108,21900960,Boston Celtics,Indiana Pacers,114,111,225,3,Boston Celtics,3,0.351,0.864,46,19,9,4,0.375,0.909,43,23,5,8
7109,21900961,New York Knicks,Washington Wizards,115,122,237,7,Washington Wizards,7,0.381,0.742,36,30,10,3,0.4,0.844,37,23,8,4
7110,21900962,Cleveland Cavaliers,Chicago Bulls,103,108,211,5,Chicago Bulls,5,0.25,0.739,35,29,9,5,0.353,0.8,46,23,8,6
7111,21900963,Minnesota Timberwolves,Houston Rockets,111,117,228,6,Houston Rockets,6,0.4,0.739,41,21,9,0,0.395,0.769,33,24,9,5
7112,21900964,Orlando Magic,Memphis Grizzlies,120,115,235,5,Orlando Magic,5,0.424,0.909,41,31,10,3,0.379,0.737,39,24,7,5
7113,21900965,Dallas Mavericks,San Antonio Spurs,109,119,228,10,San Antonio Spurs,10,0.386,0.727,42,23,8,3,0.469,0.8,40,32,11,10
7114,21900966,Phoenix Suns,Portland Trail Blazers,105,121,226,16,Portland Trail Blazers,16,0.344,0.96,43,26,3,5,0.486,0.824,46,20,9,9
7115,21900967,Los Angeles Clippers,Golden State Warriors,131,107,238,24,Los Angeles Clippers,24,0.455,1,47,28,5,2,0.289,0.815,35,25,3,0
7116,21900968,Brooklyn Nets,Los Angeles Lakers,104,102,206,2,Brooklyn Nets,2,0.325,0.739,47,24,7,3,0.375,0.583,46,24,7,4
7117,21900969,New York Knicks,Atlanta Hawks,136,131,267,5,New York Knicks,5,0.393,0.735,47,32,14,9,0.341,0.808,53,26,6,3
7118,21900970,Charlotte Hornets,Miami Heat,109,98,207,11,Charlotte Hornets,11,0.5,0.818,50,20,7,4,0.341,0.833,36,32,8,5
7119,21900971,Detroit Pistons,Philadelphia 76ers,106,124,230,18,Philadelphia 76ers,18,0.314,0.68,32,25,10,3,0.424,0.813,50,28,7,4
7120,21900973,Denver Nuggets,Dallas Mavericks,97,113,210,16,Dallas Mavericks,16,0.359,0.625,40,23,6,4,0.343,0.739,52,23,9,2
7121,21901231,Utah Jazz,New Orleans Pelicans,106,104,210,2,Utah Jazz,2,0.235,0.857,43,17,11,6,0.355,0.722,45,22,12,2
7122,21901232,Los Angeles Clippers,Los Angeles Lakers,101,103,204,2,Los Angeles Lakers,2,0.444,0.75,36,17,6,5,0.306,0.757,45,21,6,3
7123,21901233,Orlando Magic,Brooklyn Nets,128,118,246,10,Orlando Magic,10,0.355,0.893,42,31,8,3,0.31,0.739,39,30,4,2
7124,21901234,Memphis Grizzlies,Portland Trail Blazers,135,140,275,5,Portland Trail Blazers,5,0.317,0.76,39,25,9,5,0.433,0.853,42,27,10,9
7125,21901235,Phoenix Suns,Washington Wizards,125,112,237,13,Phoenix Suns,13,0.344,0.938,37,29,10,3,0.364,0.87,36,18,7,2
7126,21901236,Boston Celtics,Milwaukee Bucks,112,119,231,7,Milwaukee Bucks,7,0.297,0.794,48,18,8,5,0.317,0.824,47,25,9,7
7127,21901237,Sacramento Kings,San Antonio Spurs,120,129,249,9,San Antonio Spurs,9,0.316,0.8,42,22,11,2,0.44,0.815,42,32,6,4
7128,21901238,Houston Rockets,Dallas Mavericks,153,149,302,4,Houston Rockets,4,0.396,0.769,43,26,12,10,0.429,0.737,55,30,7,4
7129,21901239,Miami Heat,Denver Nuggets,125,105,230,20,Miami Heat,20,0.448,0.865,38,29,7,2,0.229,0.792,38,28,7,2
7130,21901240,Utah Jazz,Oklahoma City Thunder,94,110,204,16,Oklahoma City Thunder,16,0.258,0.818,35,17,11,4,0.385,0.75,47,19,9,8
7131,21901241,New Orleans Pelicans,Los Angeles Clippers,103,126,229,23,Los Angeles Clippers,23,0.3,0.643,48,24,4,1,0.532,0.771,48,23,10,2
7132,21901242,Philadelphia 76ers,Indiana Pacers,121,127,248,6,Indiana Pacers,6,0.36,0.8,55,20,6,5,0.412,0.739,34,31,8,5
7133,21901243,Los Angeles Lakers,Toronto Raptors,92,107,199,15,Toronto Raptors,15,0.25,0.727,40,17,8,12,0.412,0.885,51,24,7,5
7134,21901244,Washington Wizards,Brooklyn Nets,110,118,228,8,Brooklyn Nets,8,0.29,0.778,46,26,6,6,0.333,0.838,48,23,5,4
7135,21901245,Portland Trail Blazers,Boston Celtics,124,128,252,4,Boston Celtics,4,0.452,0.938,35,31,8,5,0.6,0.765,36,24,9,6
7136,21901246,San Antonio Spurs,Memphis Grizzlies,108,106,214,2,San Antonio Spurs,2,0.414,0.727,49,22,5,6,0.233,0.833,39,27,5,3
7137,21901247,Sacramento Kings,Orlando Magic,116,132,248,16,Orlando Magic,16,0.286,0.818,39,30,10,0,0.474,0.8,46,31,10,4
7138,21901248,Milwaukee Bucks,Houston Rockets,116,120,236,4,Houston Rockets,4,0.257,0.739,65,21,6,6,0.344,0.871,36,22,15,3
7139,21901249,Dallas Mavericks,Phoenix Suns,115,117,232,2,Phoenix Suns,2,0.194,0.892,49,22,8,5,0.364,0.913,49,22,5,4
7140,21901250,Toronto Raptors,Miami Heat,107,103,210,4,Toronto Raptors,4,0.5,0.917,39,19,6,3,0.311,0.938,41,29,9,8
7141,21901251,Denver Nuggets,Oklahoma City Thunder,121,113,234,8,Denver Nuggets,8,0.28,0.769,46,23,10,3,0.417,0.774,42,20,4,5
7142,21901252,Indiana Pacers,Washington Wizards,111,100,211,11,Indiana Pacers,11,0.269,1,45,20,6,11,0.367,0.538,45,30,6,7
7143,21901253,Memphis Grizzlies,New Orleans Pelicans,99,109,208,10,New Orleans Pelicans,10,0.279,0.867,43,25,3,10,0.379,0.615,49,25,7,1
7144,21901254,San Antonio Spurs,Philadelphia 76ers,130,132,262,2,Philadelphia 76ers,2,0.462,0.897,44,21,7,6,0.452,0.867,35,26,6,6
7145,21901255,Los Angeles Lakers,Utah Jazz,116,108,224,8,Los Angeles Lakers,8,0.346,0.806,38,23,12,3,0.279,0.88,42,25,8,3
7146,21901256,Brooklyn Nets,Milwaukee Bucks,119,116,235,3,Brooklyn Nets,3,0.368,0.75,42,30,5,6,0.333,0.652,54,28,3,5
7147,21901257,Dallas Mavericks,Sacramento Kings,114,110,224,4,Dallas Mavericks,4,0.22,0.78,61,22,4,2,0.372,0.667,47,26,8,3
7148,21901258,Phoenix Suns,Los Angeles Clippers,117,115,232,2,Phoenix Suns,2,0.531,0.714,44,25,5,0,0.276,0.852,48,21,2,3
7149,21901259,Orlando Magic,Indiana Pacers,109,120,229,11,Indiana Pacers,11,0.353,0.826,43,21,3,2,0.394,0.789,32,29,10,3
7150,21901260,Boston Celtics,Miami Heat,106,112,218,6,Miami Heat,6,0.303,0.815,45,15,7,4,0.349,0.744,42,22,8,5
7151,21901261,Houston Rockets,Portland Trail Blazers,102,110,212,8,Portland Trail Blazers,8,0.358,0.625,39,24,7,3,0.387,0.69,64,18,7,5
7152,21901262,Memphis Grizzlies,Utah Jazz,115,124,239,9,Utah Jazz,9,0.379,0.72,41,21,7,3,0.4,0.909,46,25,5,4
7153,21901263,Philadelphia 76ers,Washington Wizards,107,98,205,9,Philadelphia 76ers,9,0.379,0.69,41,27,11,4,0.333,0.792,48,17,8,5
7154,21901264,Denver Nuggets,San Antonio Spurs,132,126,258,6,Denver Nuggets,6,0.389,0.857,46,31,6,5,0.367,0.852,35,29,10,5
7155,21901265,Oklahoma City Thunder,Los Angeles Lakers,105,86,191,19,Oklahoma City Thunder,19,0.208,0.889,52,17,9,2,0.135,0.655,46,17,7,3
7156,21901266,Toronto Raptors,Orlando Magic,109,99,208,10,Toronto Raptors,10,0.364,0.7,44,25,6,2,0.268,0.692,43,26,8,4
7157,21901267,Brooklyn Nets,Boston Celtics,115,149,264,34,Boston Celtics,34,0.25,0.81,34,23,9,2,0.513,0.829,43,29,10,10
7158,21901268,New Orleans Pelicans,Sacramento Kings,125,140,265,15,Sacramento Kings,15,0.412,0.739,30,31,4,3,0.485,0.727,39,26,11,3
7159,21901269,Miami Heat,Milwaukee Bucks,116,130,246,14,Milwaukee Bucks,14,0.457,0.926,39,28,6,1,0.405,0.868,44,27,7,3
7160,21901270,Indiana Pacers,Phoenix Suns,99,114,213,15,Phoenix Suns,15,0.345,0.789,38,20,6,5,0.265,0.95,53,27,6,4
7161,21901271,Los Angeles Clippers,Dallas Mavericks,126,111,237,15,Los Angeles Clippers,15,0.452,0.8,45,22,3,3,0.354,0.762,37,24,3,4
7162,21901272,Portland Trail Blazers,Denver Nuggets,125,115,240,10,Portland Trail Blazers,10,0.59,0.8,39,30,7,6,0.5,0.765,44,30,5,4
7163,21901273,Los Angeles Lakers,Houston Rockets,97,113,210,16,Houston Rockets,16,0.105,0.694,48,18,11,6,0.368,0.87,34,26,11,5
7164,21901274,Utah Jazz,San Antonio Spurs,111,119,230,8,San Antonio Spurs,8,0.432,0.792,49,25,8,4,0.409,0.769,47,27,10,5
7165,21901275,Oklahoma City Thunder,Memphis Grizzlies,92,121,213,29,Memphis Grizzlies,29,0.302,0.733,36,19,12,2,0.355,0.9,58,24,6,4
7166,21901276,Sacramento Kings,Brooklyn Nets,106,119,225,13,Brooklyn Nets,13,0.3,0.75,50,19,3,4,0.425,0.643,44,30,9,3
7167,21901277,Orlando Magic,Philadelphia 76ers,101,108,209,7,Philadelphia 76ers,7,0.25,0.76,47,17,5,2,0.276,0.727,51,19,4,4
7168,21901278,Washington Wizards,New Orleans Pelicans,107,118,225,11,New Orleans Pelicans,11,0.37,0.913,40,22,9,4,0.343,0.846,45,25,7,8
7169,21901279,Boston Celtics,Toronto Raptors,122,100,222,22,Boston Celtics,22,0.348,0.75,52,27,8,2,0.263,0.824,48,20,8,7
7170,21901280,Los Angeles Clippers,Portland Trail Blazers,122,117,239,5,Los Angeles Clippers,5,0.441,0.821,45,24,5,2,0.395,0.706,41,24,5,2
7171,21901281,Utah Jazz,Denver Nuggets,132,134,266,2,Denver Nuggets,2,0.4,0.727,51,34,6,4,0.243,0.767,52,29,10,5
7172,21901282,Los Angeles Lakers,Indiana Pacers,111,116,227,5,Indiana Pacers,5,0.333,0.737,44,20,13,6,0.455,0.929,42,25,12,4
7173,21901283,Phoenix Suns,Miami Heat,119,112,231,7,Phoenix Suns,7,0.375,0.95,52,27,5,4,0.306,0.864,37,28,6,9
7174,21901284,Milwaukee Bucks,Dallas Mavericks,132,136,268,4,Dallas Mavericks,4,0.341,0.676,55,26,3,9,0.321,0.92,54,37,6,2
7175,21901285,Washington Wizards,Oklahoma City Thunder,103,121,224,18,Oklahoma City Thunder,18,0.25,0.818,44,23,6,3,0.462,0.773,43,25,7,3
7176,21901286,Memphis Grizzlies,Toronto Raptors,99,108,207,9,Toronto Raptors,9,0.333,0.688,42,24,14,3,0.385,0.758,40,25,17,7
7177,21901287,San Antonio Spurs,New Orleans Pelicans,122,113,235,9,San Antonio Spurs,9,0.393,0.969,51,22,12,6,0.4,0.773,48,30,5,5
7178,21901288,Orlando Magic,Boston Celtics,119,122,241,3,Boston Celtics,3,0.319,0.846,52,24,7,4,0.3,0.833,54,32,9,7
7179,21901289,Philadelphia 76ers,Portland Trail Blazers,121,124,245,3,Portland Trail Blazers,3,0.467,0.765,48,24,6,3,0.314,0.931,41,19,8,6
7180,21901290,Houston Rockets,Sacramento Kings,129,112,241,17,Houston Rockets,17,0.316,0.833,48,21,9,3,0.27,0.87,41,29,9,2
7181,21901291,Brooklyn Nets,Los Angeles Clippers,129,120,249,9,Brooklyn Nets,9,0.465,0.789,46,32,5,5,0.361,0.85,39,23,8,2
7182,21901292,Oklahoma City Thunder,Phoenix Suns,101,128,229,27,Phoenix Suns,27,0.333,0.857,40,24,10,2,0.5,0.931,53,29,11,7
7183,21901293,Dallas Mavericks,Utah Jazz,122,114,236,8,Dallas Mavericks,8,0.5,0.875,34,29,6,3,0.457,0.75,38,28,5,6
7184,21901294,Toronto Raptors,Milwaukee Bucks,114,106,220,8,Toronto Raptors,8,0.3,0.692,55,24,11,6,0.326,0.743,49,25,4,6
7185,21901295,Indiana Pacers,Miami Heat,92,114,206,22,Miami Heat,22,0.286,0.64,45,20,5,4,0.325,0.684,59,29,11,9
7186,21901296,Denver Nuggets,Los Angeles Lakers,121,124,245,3,Los Angeles Lakers,3,0.565,0.783,35,27,6,2,0.483,0.688,32,28,8,4
7187,21901297,Brooklyn Nets,Orlando Magic,108,96,204,12,Brooklyn Nets,12,0.302,0.792,47,26,9,4,0.304,0.862,49,13,9,3
7188,21901298,Houston Rockets,San Antonio Spurs,105,123,228,18,San Antonio Spurs,18,0.292,0.905,37,18,14,3,0.406,0.9,59,28,10,5
7189,21901299,Phoenix Suns,Philadelphia 76ers,130,117,247,13,Phoenix Suns,13,0.429,0.952,44,28,4,3,0.455,0.714,34,28,5,4
7190,21901300,Portland Trail Blazers,Dallas Mavericks,134,131,265,3,Portland Trail Blazers,3,0.395,0.931,48,18,9,3,0.455,0.818,37,28,4,5
7191,21901301,Boston Celtics,Memphis Grizzlies,122,107,229,15,Boston Celtics,15,0.432,0.783,46,29,7,7,0.241,0.789,44,26,8,4
7192,21901302,New Orleans Pelicans,Sacramento Kings,106,112,218,6,Sacramento Kings,6,0.292,0.789,34,25,8,6,0.423,0.938,45,27,4,6
7193,21901303,Milwaukee Bucks,Washington Wizards,126,113,239,13,Milwaukee Bucks,13,0.474,0.714,53,25,6,0,0.343,0.767,44,22,2,3
7194,21901304,Indiana Pacers,Houston Rockets,108,104,212,4,Indiana Pacers,4,0.355,0.773,54,25,15,7,0.281,0.857,49,20,8,6
7195,21901305,Toronto Raptors,Philadelphia 76ers,125,121,246,4,Toronto Raptors,4,0.419,0.675,47,28,8,7,0.425,0.788,47,27,9,10
7196,21901306,Miami Heat,Oklahoma City Thunder,115,116,231,1,Oklahoma City Thunder,1,0.333,0.85,40,24,14,2,0.381,0.815,50,20,7,4
7197,21901307,Los Angeles Clippers,Denver Nuggets,124,111,235,13,Los Angeles Clippers,13,0.378,0.783,40,29,11,1,0.371,0.632,42,33,4,3
7198,21901308,Washington Wizards,Boston Celtics,96,90,186,6,Washington Wizards,6,0.385,0.75,56,22,11,6,0.229,0.857,51,22,8,7
7199,21901309,Portland Trail Blazers,Brooklyn Nets,134,133,267,1,Portland Trail Blazers,1,0.333,0.875,42,25,10,4,0.424,0.684,46,28,5,5
7200,21901310,Sacramento Kings,Los Angeles Lakers,136,122,258,14,Sacramento Kings,14,0.447,0.583,44,37,12,2,0.429,0.733,47,29,6,1
7201,21901311,Milwaukee Bucks,Memphis Grizzlies,106,119,225,13,Memphis Grizzlies,13,0.317,0.652,45,27,8,3,0.394,0.696,55,36,4,3
7202,21901312,New Orleans Pelicans,Orlando Magic,127,133,260,6,Orlando Magic,6,0.294,0.778,40,22,6,4,0.536,0.733,33,25,6,2
7203,21901313,Dallas Mavericks,Phoenix Suns,102,128,230,26,Phoenix Suns,26,0.308,0.842,43,17,3,4,0.412,0.762,45,34,6,4
7204,21901314,San Antonio Spurs,Utah Jazz,112,118,230,6,Utah Jazz,6,0.5,0.667,44,24,4,8,0.326,0.9,43,25,7,5
7205,21901315,Philadelphia 76ers,Houston Rockets,134,96,230,38,Philadelphia 76ers,38,0.474,0.818,51,31,8,4,0.25,0.875,27,25,10,9
7206,21901316,Miami Heat,Indiana Pacers,92,109,201,17,Indiana Pacers,17,0.263,0.741,48,14,6,5,0.395,0.727,51,32,11,3
7207,21901317,Oklahoma City Thunder,Los Angeles Clippers,103,107,210,4,Los Angeles Clippers,4,0.318,0.591,48,18,5,6,0.324,0.692,61,23,10,2
7208,21901318,Denver Nuggets,Toronto Raptors,109,117,226,8,Toronto Raptors,8,0.421,0.913,41,27,9,11,0.514,0.643,51,27,8,5
7209,22000001,Golden State Warriors,Brooklyn Nets,99,125,224,26,Brooklyn Nets,26,0.303,0.652,47,26,6,6,0.429,0.813,57,24,11,7
7210,22000002,Los Angeles Clippers,Los Angeles Lakers,116,109,225,7,Los Angeles Clippers,7,0.35,0.737,40,22,10,3,0.31,0.774,45,22,4,2
7211,22000003,Milwaukee Bucks,Boston Celtics,121,122,243,1,Boston Celtics,1,0.4,0.833,52,19,4,6,0.45,0.727,37,23,8,6
7212,22000004,Dallas Mavericks,Phoenix Suns,102,106,208,4,Phoenix Suns,4,0.243,0.808,39,17,6,0,0.367,0.704,48,21,7,7
7213,22000005,New Orleans Pelicans,Miami Heat,98,111,209,13,Miami Heat,13,0.286,0.788,41,18,8,2,0.432,0.826,35,29,11,2
7214,22000006,Golden State Warriors,Milwaukee Bucks,99,138,237,39,Milwaukee Bucks,39,0.222,0.84,43,14,5,6,0.556,0.692,60,25,6,4
7215,22000007,Brooklyn Nets,Boston Celtics,123,95,218,28,Brooklyn Nets,28,0.517,0.839,43,21,5,10,0.296,0.684,47,23,6,5
7216,22000008,Dallas Mavericks,Los Angeles Lakers,115,138,253,23,Los Angeles Lakers,23,0.406,0.769,27,20,13,3,0.487,0.708,53,33,9,4
7217,22000009,Los Angeles Clippers,Denver Nuggets,121,108,229,13,Los Angeles Clippers,13,0.5,0.833,38,32,9,4,0.306,0.742,32,25,7,1
7218,22000010,Charlotte Hornets,Cleveland Cavaliers,114,121,235,7,Cleveland Cavaliers,7,0.364,0.533,32,29,10,4,0.467,0.75,50,34,12,3
7219,22000011,New York Knicks,Indiana Pacers,107,121,228,14,Indiana Pacers,14,0.429,0.739,40,25,8,8,0.235,0.724,50,28,6,9
7220,22000012,Miami Heat,Orlando Magic,107,113,220,6,Orlando Magic,6,0.35,0.842,43,25,11,2,0.357,0.633,41,23,15,3
7221,22000013,Washington Wizards,Philadelphia 76ers,107,113,220,6,Philadelphia 76ers,6,0.481,0.696,40,28,7,4,0.286,0.767,47,22,11,8
7222,22000014,New Orleans Pelicans,Toronto Raptors,113,99,212,14,New Orleans Pelicans,14,0.452,0.5,45,30,13,7,0.304,0.75,35,26,10,5
7223,22000015,Atlanta Hawks,Chicago Bulls,124,104,228,20,Atlanta Hawks,20,0.4,0.828,46,24,6,3,0.229,0.857,37,20,10,3
7224,22000016,Oklahoma City Thunder,Houston Rockets,114,112,226,2,Oklahoma City Thunder,2,0.333,0.68,52,22,8,2,0.368,0.741,38,22,7,4
7225,22000017,San Antonio Spurs,Memphis Grizzlies,131,119,250,12,San Antonio Spurs,12,0.4,0.862,48,28,8,8,0.37,0.611,42,27,6,8
7226,22000018,Detroit Pistons,Minnesota Timberwolves,101,111,212,10,Minnesota Timberwolves,10,0.229,0.375,44,29,5,2,0.268,0.857,48,25,6,5
7227,22000019,Sacramento Kings,Denver Nuggets,124,122,246,2,Sacramento Kings,2,0.323,0.774,54,27,5,7,0.276,0.833,46,28,6,11
7228,22000020,Utah Jazz,Portland Trail Blazers,120,100,220,20,Utah Jazz,20,0.38,0.789,59,24,3,3,0.364,0.824,40,23,6,3
7229,22000021,Atlanta Hawks,Memphis Grizzlies,122,112,234,10,Atlanta Hawks,10,0.361,0.868,54,23,4,5,0.302,0.862,46,20,5,6
7230,22000022,Oklahoma City Thunder,Charlotte Hornets,109,107,216,2,Oklahoma City Thunder,2,0.278,0.792,54,25,10,7,0.406,0.625,47,27,11,8
7231,22000023,Cleveland Cavaliers,Detroit Pistons,128,119,247,9,Cleveland Cavaliers,9,0.433,0.633,51,29,13,4,0.356,0.719,57,24,9,5
7232,22000024,Orlando Magic,Washington Wizards,130,120,250,10,Orlando Magic,10,0.355,0.793,54,25,8,0,0.351,0.536,43,28,5,3
7233,22000025,Philadelphia 76ers,New York Knicks,109,89,198,20,Philadelphia 76ers,20,0.355,0.727,47,20,9,6,0.276,0.739,43,19,6,4
7234,22000026,Indiana Pacers,Chicago Bulls,125,106,231,19,Indiana Pacers,19,0.346,0.632,49,34,15,4,0.41,0.88,41,23,7,7
7235,22000027,Toronto Raptors,San Antonio Spurs,114,119,233,5,San Antonio Spurs,5,0.366,0.733,46,32,8,9,0.412,0.688,53,36,4,3
7236,22000028,Minnesota Timberwolves,Utah Jazz,116,111,227,5,Minnesota Timberwolves,5,0.448,0.722,40,21,9,5,0.294,0.784,57,15,5,4
7237,22000029,Houston Rockets,Portland Trail Blazers,126,128,254,2,Portland Trail Blazers,2,0.314,0.781,42,27,5,5,0.422,0.652,45,27,10,5
7238,22000030,Phoenix Suns,Sacramento Kings,103,106,209,3,Sacramento Kings,3,0.25,0.769,40,25,8,5,0.217,0.697,56,20,4,9
7239,22000031,Dallas Mavericks,Los Angeles Clippers,124,73,197,51,Dallas Mavericks,51,0.341,0.889,54,25,10,2,0.121,0.85,36,13,2,2
7240,22000032,Brooklyn Nets,Charlotte Hornets,104,106,210,2,Charlotte Hornets,2,0.362,0.68,46,23,4,5,0.294,0.588,52,35,8,3
7241,22000033,Orlando Magic,Washington Wizards,120,113,233,7,Orlando Magic,7,0.36,0.974,45,19,6,3,0.25,0.846,47,27,6,4
7242,22000034,San Antonio Spurs,New Orleans Pelicans,95,98,193,3,New Orleans Pelicans,3,0.306,1,47,26,5,10,0.208,0.724,56,15,11,4
7243,22000035,Philadelphia 76ers,Cleveland Cavaliers,94,118,212,24,Cleveland Cavaliers,24,0.324,0.727,39,24,9,5,0.391,0.813,45,31,13,6
7244,22000036,Milwaukee Bucks,New York Knicks,110,130,240,20,New York Knicks,20,0.184,0.724,44,24,7,5,0.593,0.815,46,27,5,4
7245,22000037,Boston Celtics,Indiana Pacers,107,108,215,1,Indiana Pacers,1,0.391,0.75,40,21,13,7,0.269,0.733,37,23,11,7
7246,22000038,Golden State Warriors,Chicago Bulls,129,128,257,1,Golden State Warriors,1,0.383,0.9,41,25,17,4,0.415,0.742,54,27,4,6
7247,22000039,Phoenix Suns,Sacramento Kings,116,100,216,16,Phoenix Suns,16,0.4,0.909,44,34,6,3,0.435,0.72,39,21,5,4
7248,22000040,Minnesota Timberwolves,Los Angeles Lakers,91,127,218,36,Los Angeles Lakers,36,0.171,0.643,48,24,11,6,0.371,0.778,46,32,6,14
7249,22000041,Detroit Pistons,Atlanta Hawks,120,128,248,8,Atlanta Hawks,8,0.317,0.875,48,24,7,4,0.476,0.875,45,30,5,7
7250,22000042,Memphis Grizzlies,Brooklyn Nets,116,111,227,5,Memphis Grizzlies,5,0.345,0.759,56,20,10,4,0.333,0.882,50,28,13,6
7251,22000043,Utah Jazz,Oklahoma City Thunder,110,109,219,1,Utah Jazz,1,0.361,0.786,43,24,9,6,0.395,0.737,37,21,9,5
7252,22000044,Houston Rockets,Denver Nuggets,111,124,235,13,Denver Nuggets,13,0.41,0.739,38,25,8,3,0.452,0.563,52,31,8,7
7253,22000045,Portland Trail Blazers,Los Angeles Lakers,115,107,222,8,Portland Trail Blazers,8,0.348,0.867,45,27,9,6,0.37,0.833,41,20,6,5
7254,22000046,New York Knicks,Cleveland Cavaliers,95,86,181,9,New York Knicks,9,0.56,0.619,55,23,9,6,0.219,0.682,43,22,13,10
7255,22000047,Golden State Warriors,Detroit Pistons,116,106,222,10,Golden State Warriors,10,0.424,0.722,40,21,8,8,0.371,0.793,45,21,8,6
7256,22000048,Boston Celtics,Indiana Pacers,116,111,227,5,Boston Celtics,5,0.409,0.73,43,21,10,3,0.364,0.813,36,27,9,5
7257,22000049,Toronto Raptors,Philadelphia 76ers,93,100,193,7,Philadelphia 76ers,7,0.378,0.857,47,21,12,7,0.258,0.848,54,21,10,10
7258,22000050,Chicago Bulls,Washington Wizards,115,107,222,8,Chicago Bulls,8,0.417,0.75,37,26,7,1,0.27,0.885,47,25,6,6
7259,22000051,Milwaukee Bucks,Miami Heat,144,97,241,47,Milwaukee Bucks,47,0.569,0.867,45,32,14,2,0.297,0.667,30,23,9,6
7260,22000052,Orlando Magic,Oklahoma City Thunder,118,107,225,11,Orlando Magic,11,0.318,0.813,46,26,12,2,0.324,0.526,47,20,3,7
7261,22000053,New Orleans Pelicans,Phoenix Suns,86,111,197,25,Phoenix Suns,25,0.125,0.5,41,18,8,3,0.404,0.947,43,24,7,4
7262,22000054,Minnesota Timberwolves,Los Angeles Clippers,101,124,225,23,Los Angeles Clippers,23,0.342,0.824,39,22,7,6,0.516,0.875,46,32,6,10
7263,22000055,Denver Nuggets,Sacramento Kings,115,125,240,10,Sacramento Kings,10,0.393,0.8,39,27,7,5,0.485,0.773,37,33,9,2
7264,22000056,Memphis Grizzlies,Boston Celtics,107,126,233,19,Boston Celtics,19,0.273,0.72,46,26,8,3,0.41,0.857,42,27,17,11
7265,22000057,Atlanta Hawks,Brooklyn Nets,141,145,286,4,Brooklyn Nets,4,0.391,0.829,54,27,5,2,0.463,0.783,40,30,6,3
7266,22000058,Milwaukee Bucks,Miami Heat,108,119,227,11,Miami Heat,11,0.39,0.923,47,26,14,6,0.385,0.828,52,25,5,5
7267,22000059,Charlotte Hornets,Dallas Mavericks,118,99,217,19,Charlotte Hornets,19,0.441,0.81,50,30,6,6,0.286,0.576,39,24,10,6
7268,22000060,Los Angeles Lakers,San Antonio Spurs,121,107,228,14,Los Angeles Lakers,14,0.538,0.75,47,25,4,3,0.417,0.739,39,25,8,4
7269,22000061,Portland Trail Blazers,Los Angeles Clippers,105,128,233,23,Los Angeles Clippers,23,0.316,0.853,41,14,5,4,0.474,0.727,47,30,13,6
7270,22000062,Cleveland Cavaliers,Indiana Pacers,99,119,218,20,Indiana Pacers,20,0.522,0.542,43,22,5,6,0.457,0.792,44,28,12,1
7271,22000063,Chicago Bulls,Washington Wizards,133,130,263,3,Chicago Bulls,3,0.389,0.76,44,34,9,3,0.483,0.78,37,27,8,4
7272,22000064,Philadelphia 76ers,Orlando Magic,116,92,208,24,Philadelphia 76ers,24,0.455,0.867,54,23,7,10,0.25,0.905,48,17,2,5
7273,22000065,Sacramento Kings,Houston Rockets,119,122,241,3,Houston Rockets,3,0.333,0.75,45,23,11,5,0.361,0.76,45,26,10,6
7274,22000066,New York Knicks,Toronto Raptors,83,100,183,17,Toronto Raptors,17,0.083,0.8,48,21,6,3,0.327,0.714,53,21,7,6
7275,22000067,New Orleans Pelicans,Oklahoma City Thunder,113,80,193,33,New Orleans Pelicans,33,0.361,0.632,58,23,9,4,0.313,0.333,40,24,6,3
7276,22000068,Phoenix Suns,Utah Jazz,106,95,201,11,Phoenix Suns,11,0.515,0.7,41,26,5,6,0.353,0.684,46,16,8,3
7277,22000069,Memphis Grizzlies,Charlotte Hornets,108,93,201,15,Memphis Grizzlies,15,0.359,0.8,48,34,10,6,0.29,0.667,42,23,9,4
7278,22000070,Boston Celtics,Detroit Pistons,93,96,189,3,Detroit Pistons,3,0.258,0.5,44,20,12,11,0.324,0.65,48,18,9,2
7279,22000071,Miami Heat,Dallas Mavericks,83,93,176,10,Dallas Mavericks,10,0.212,0.72,41,20,10,2,0.324,0.739,49,18,9,3
7280,22000072,Atlanta Hawks,Brooklyn Nets,114,96,210,18,Atlanta Hawks,18,0.41,0.857,48,24,8,3,0.189,0.826,45,19,6,6
7281,22000073,Chicago Bulls,Milwaukee Bucks,96,126,222,30,Milwaukee Bucks,30,0.231,0.7,42,18,10,6,0.489,0.667,44,27,16,6
7282,22000074,Washington Wizards,Minnesota Timberwolves,130,109,239,21,Washington Wizards,21,0.485,0.762,43,35,9,3,0.361,0.571,43,17,9,3
7283,22000075,Los Angeles Lakers,San Antonio Spurs,109,103,212,6,Los Angeles Lakers,6,0.424,0.813,58,27,8,7,0.382,0.692,45,23,3,8
7284,22000076,Phoenix Suns,Denver Nuggets,106,103,209,3,Phoenix Suns,3,0.371,0.905,37,24,1,4,0.414,0.813,38,28,7,1
7285,22000077,Los Angeles Clippers,Utah Jazz,100,106,206,6,Utah Jazz,6,0.394,0.875,43,19,6,8,0.357,0.643,46,28,3,3
7286,22000078,Portland Trail Blazers,Golden State Warriors,123,98,221,25,Portland Trail Blazers,25,0.465,0.767,51,23,11,3,0.2,0.879,44,19,4,9
7287,22000079,Sacramento Kings,Houston Rockets,94,102,196,8,Houston Rockets,8,0.321,0.714,47,11,5,4,0.317,0.739,48,15,10,10
7288,22000080,New York Knicks,Indiana Pacers,106,102,208,4,New York Knicks,4,0.444,0.769,51,23,4,3,0.38,0.833,32,22,6,4
7289,22000081,Oklahoma City Thunder,Orlando Magic,108,99,207,9,Oklahoma City Thunder,9,0.317,0.905,52,22,5,5,0.263,0.75,55,21,7,1
7290,22000082,Charlotte Hornets,Philadelphia 76ers,112,127,239,15,Philadelphia 76ers,15,0.371,0.885,40,34,15,5,0.457,0.708,45,35,10,7
7291,22000083,Cleveland Cavaliers,Atlanta Hawks,96,91,187,5,Cleveland Cavaliers,5,0.241,0.765,46,19,10,2,0.344,0.526,48,22,9,5
7292,22000084,Toronto Raptors,New Orleans Pelicans,116,120,236,4,New Orleans Pelicans,4,0.292,0.963,40,21,6,4,0.368,0.766,50,26,6,7
7293,22000085,Boston Celtics,Detroit Pistons,122,120,242,2,Boston Celtics,2,0.455,0.692,41,35,4,5,0.444,0.88,33,29,8,7
7294,22000086,Washington Wizards,Brooklyn Nets,123,122,245,1,Washington Wizards,1,0.364,0.735,49,27,9,3,0.438,0.903,51,25,5,9
7295,22000087,Los Angeles Lakers,Memphis Grizzlies,108,94,202,14,Los Angeles Lakers,14,0.343,0.737,49,24,9,5,0.273,0.875,50,23,6,3
7296,22000088,Denver Nuggets,Minnesota Timberwolves,124,109,233,15,Denver Nuggets,15,0.422,0.714,43,34,6,4,0.323,0.688,36,30,11,6
7297,22000089,Utah Jazz,San Antonio Spurs,130,109,239,21,Utah Jazz,21,0.512,0.579,57,29,4,11,0.316,0.714,45,23,13,4
7298,22000090,Dallas Mavericks,Chicago Bulls,108,118,226,10,Chicago Bulls,10,0.262,0.704,41,23,6,4,0.351,0.9,48,16,11,2
7299,22000091,Los Angeles Clippers,Phoenix Suns,112,107,219,5,Los Angeles Clippers,5,0.586,0.789,37,24,5,2,0.303,0.821,40,23,4,3
7300,22000092,Portland Trail Blazers,Golden State Warriors,122,137,259,15,Golden State Warriors,15,0.326,0.788,40,16,7,2,0.382,0.765,53,23,4,7
7301,22000093,Cleveland Cavaliers,Orlando Magic,83,103,186,20,Orlando Magic,20,0.357,0.583,35,20,12,4,0.441,0.923,54,22,9,7
7302,22000094,Charlotte Hornets,Philadelphia 76ers,101,118,219,17,Philadelphia 76ers,17,0.333,0.727,47,30,4,4,0.344,0.652,55,34,7,5
7303,22000095,New York Knicks,Atlanta Hawks,113,108,221,5,New York Knicks,5,0.333,0.8,45,26,9,6,0.323,0.783,40,24,4,2
7304,22000096,Oklahoma City Thunder,Miami Heat,90,118,208,28,Miami Heat,28,0.271,0.704,38,20,6,4,0.471,0.556,47,34,7,0
7305,22000097,Boston Celtics,Toronto Raptors,126,114,240,12,Boston Celtics,12,0.517,0.853,56,19,3,9,0.351,0.763,37,20,13,4
7306,22000098,Dallas Mavericks,Houston Rockets,113,100,213,13,Dallas Mavericks,13,0.41,0.95,51,24,4,3,0.275,0.806,35,17,5,4
7307,22000099,Detroit Pistons,Milwaukee Bucks,115,125,240,10,Milwaukee Bucks,10,0.425,1,31,27,9,5,0.412,0.813,49,32,6,4
7308,22000100,Indiana Pacers,New Orleans Pelicans,118,116,234,2,Indiana Pacers,2,0.422,0.692,42,32,10,8,0.333,0.792,57,26,5,4
7309,22000101,Sacramento Kings,Golden State Warriors,106,137,243,31,Golden State Warriors,31,0.286,0.718,52,20,5,6,0.535,0.857,48,41,4,6
7310,22000102,Utah Jazz,Brooklyn Nets,96,130,226,34,Brooklyn Nets,34,0.324,0.704,41,17,6,3,0.389,0.75,51,31,11,5
7311,22000103,Los Angeles Lakers,Memphis Grizzlies,94,92,186,2,Los Angeles Lakers,2,0.29,0.818,52,24,7,8,0.385,0.769,38,24,14,4
7312,22000104,Minnesota Timberwolves,Denver Nuggets,116,123,239,7,Denver Nuggets,7,0.324,0.778,42,24,8,4,0.32,0.733,42,22,9,2
7313,22000105,San Antonio Spurs,Los Angeles Clippers,116,113,229,3,San Antonio Spurs,3,0.5,0.727,44,23,9,3,0.429,0.923,45,29,6,7
7314,22000106,Chicago Bulls,Portland Trail Blazers,111,108,219,3,Chicago Bulls,3,0.39,0.833,52,27,5,5,0.373,0.647,46,23,8,3
7315,22000107,Houston Rockets,Indiana Pacers,107,114,221,7,Indiana Pacers,7,0.267,0.808,39,19,7,12,0.391,0.808,38,21,10,9
7316,22000108,Cleveland Cavaliers,Orlando Magic,94,105,199,11,Orlando Magic,11,0.154,0.692,45,24,9,4,0.414,0.722,43,20,4,4
7317,22000109,Washington Wizards,Philadelphia 76ers,136,141,277,5,Philadelphia 76ers,5,0.432,0.743,35,27,9,2,0.621,0.697,35,33,9,6
7318,22000110,Charlotte Hornets,Atlanta Hawks,102,94,196,8,Charlotte Hornets,8,0.306,0.818,49,22,11,7,0.175,0.833,57,25,6,1
7319,22000111,Boston Celtics,Miami Heat,107,105,212,2,Boston Celtics,2,0.343,0.917,53,22,7,5,0.361,0.846,42,26,2,7
7320,22000112,Utah Jazz,New York Knicks,100,112,212,12,New York Knicks,12,0.318,0.545,42,20,5,9,0.364,0.737,48,22,10,5
7321,22000113,Detroit Pistons,Milwaukee Bucks,115,130,245,15,Milwaukee Bucks,15,0.317,0.867,47,20,6,3,0.442,0.619,47,35,5,4
7322,22000114,Oklahoma City Thunder,New Orleans Pelicans,111,110,221,1,Oklahoma City Thunder,1,0.413,0.75,38,28,10,5,0.182,0.783,52,25,11,0
7323,22000115,Toronto Raptors,Phoenix Suns,115,123,238,8,Phoenix Suns,8,0.4,0.719,42,18,6,5,0.525,0.917,41,30,4,3
7324,22000116,Los Angeles Clippers,Golden State Warriors,108,101,209,7,Los Angeles Clippers,7,0.324,1,48,19,6,3,0.267,0.789,35,25,10,2
7325,22000117,Chicago Bulls,Sacramento Kings,124,128,252,4,Sacramento Kings,4,0.35,0.8,43,27,3,2,0.378,0.741,39,30,8,3
7326,22000118,Philadelphia 76ers,Brooklyn Nets,109,122,231,13,Brooklyn Nets,13,0.346,0.9,47,23,6,6,0.405,0.655,48,30,11,7
7327,22000119,Cleveland Cavaliers,Memphis Grizzlies,94,90,184,4,Cleveland Cavaliers,4,0.433,0.563,37,24,11,3,0.355,0.875,48,27,13,6
7328,22000120,Dallas Mavericks,Denver Nuggets,124,117,241,7,Dallas Mavericks,7,0.4,0.774,44,27,12,7,0.341,0.762,47,25,8,1
7329,22000121,San Antonio Spurs,Los Angeles Lakers,118,109,227,9,San Antonio Spurs,9,0.457,0.941,40,28,4,3,0.333,0.619,48,21,2,4
7330,22000122,Minnesota Timberwolves,Portland Trail Blazers,117,135,252,18,Portland Trail Blazers,18,0.341,0.758,48,24,11,4,0.439,0.826,44,25,10,6
7331,22000123,Phoenix Suns,Detroit Pistons,105,110,215,5,Detroit Pistons,5,0.327,0.462,50,24,10,7,0.324,0.862,46,23,13,4
7332,22000124,Washington Wizards,Boston Celtics,107,116,223,9,Boston Celtics,9,0.379,0.875,38,22,9,4,0.375,0.733,49,21,11,4
7333,22000125,Oklahoma City Thunder,New York Knicks,101,89,190,12,Oklahoma City Thunder,12,0.324,0.667,62,16,2,7,0.333,0.6,49,19,8,7
7334,22000126,Charlotte Hornets,New Orleans Pelicans,118,110,228,8,Charlotte Hornets,8,0.381,0.8,45,33,10,4,0.395,0.731,36,29,6,4
7335,22000127,Orlando Magic,Houston Rockets,90,132,222,42,Houston Rockets,42,0.276,0.875,42,17,5,2,0.468,0.727,49,34,6,8
7336,22000128,Brooklyn Nets,Memphis Grizzlies,110,115,225,5,Memphis Grizzlies,5,0.452,0.952,42,26,6,4,0.406,0.857,46,29,14,6
7337,22000129,Utah Jazz,Milwaukee Bucks,131,118,249,13,Utah Jazz,13,0.472,0.615,50,31,6,8,0.31,0.81,45,18,5,5
7338,22000130,Los Angeles Clippers,Golden State Warriors,105,115,220,10,Golden State Warriors,10,0.452,0.846,37,23,6,5,0.488,0.833,38,25,13,3
7339,22000131,Chicago Bulls,Los Angeles Lakers,115,117,232,2,Los Angeles Lakers,2,0.385,0.929,41,26,10,3,0.414,0.852,42,21,3,8
7340,22000132,Toronto Raptors,Sacramento Kings,144,123,267,21,Toronto Raptors,21,0.513,0.818,44,30,8,5,0.441,0.571,26,36,9,8
7341,22000133,Denver Nuggets,Philadelphia 76ers,115,103,218,12,Denver Nuggets,12,0.364,0.867,45,28,11,7,0.314,0.6,48,23,8,4
7342,22000134,Atlanta Hawks,Charlotte Hornets,105,113,218,8,Charlotte Hornets,8,0.311,0.821,47,25,10,4,0.455,0.75,41,27,11,7
7343,22000135,Phoenix Suns,Indiana Pacers,125,117,242,8,Phoenix Suns,8,0.39,1,40,33,6,2,0.414,0.708,52,23,2,4
7344,22000136,Miami Heat,Washington Wizards,128,124,252,4,Miami Heat,4,0.372,0.769,61,32,3,5,0.375,0.75,39,25,9,2
7345,22000137,Cleveland Cavaliers,Milwaukee Bucks,90,100,190,10,Milwaukee Bucks,10,0.269,0.688,47,16,6,4,0.333,0.778,45,25,11,4
7346,22000138,San Antonio Spurs,Minnesota Timberwolves,125,122,247,3,San Antonio Spurs,3,0.406,0.828,48,22,8,3,0.5,0.647,53,29,1,7
7347,22000139,Orlando Magic,Dallas Mavericks,98,112,210,14,Dallas Mavericks,14,0.194,0.727,43,17,11,2,0.5,0.778,44,25,5,8
7348,22000140,Portland Trail Blazers,Sacramento Kings,125,99,224,26,Portland Trail Blazers,26,0.415,0.87,50,26,10,5,0.267,0.714,47,21,4,5
7349,22000141,Utah Jazz,Detroit Pistons,96,86,182,10,Utah Jazz,10,0.314,0.682,63,17,3,5,0.238,0.857,39,21,10,7
7350,22000142,Chicago Bulls,Los Angeles Clippers,127,130,257,3,Los Angeles Clippers,3,0.545,0.882,38,30,6,2,0.526,0.8,35,28,13,5
7351,22000143,Oklahoma City Thunder,Brooklyn Nets,129,116,245,13,Oklahoma City Thunder,13,0.385,0.941,34,24,12,4,0.294,0.833,43,23,3,2
7352,22000144,Denver Nuggets,New York Knicks,114,89,203,25,Denver Nuggets,25,0.429,0.75,43,23,11,4,0.286,0.76,36,19,4,1
7353,22000146,Los Angeles Lakers,Houston Rockets,120,102,222,18,Los Angeles Lakers,18,0.345,0.75,49,28,13,8,0.293,0.696,43,22,7,8
7354,22000147,San Antonio Spurs,Minnesota Timberwolves,88,96,184,8,Minnesota Timberwolves,8,0.267,0.571,45,21,4,5,0.346,0.826,52,19,6,3
7355,22000148,Toronto Raptors,Golden State Warriors,105,106,211,1,Golden State Warriors,1,0.342,0.636,48,20,8,10,0.283,0.895,51,30,2,10
7356,22000149,New York Knicks,Charlotte Hornets,88,109,197,21,Charlotte Hornets,21,0.243,0.647,49,20,6,6,0.406,0.87,37,28,8,8
7357,22000150,Memphis Grizzlies,Cleveland Cavaliers,101,91,192,10,Memphis Grizzlies,10,0.25,0.762,40,32,10,6,0.423,0.429,40,20,11,7
7358,22000151,Milwaukee Bucks,Orlando Magic,121,99,220,22,Milwaukee Bucks,22,0.371,0.8,43,25,15,7,0.355,0.769,44,24,5,4
7359,22000152,Phoenix Suns,Washington Wizards,107,128,235,21,Washington Wizards,21,0.148,0.833,42,21,3,6,0.441,0.607,53,29,3,3
7360,22000153,Philadelphia 76ers,Atlanta Hawks,94,112,206,18,Atlanta Hawks,18,0.222,0.923,50,20,2,12,0.386,0.778,58,20,7,3
7361,22000155,Toronto Raptors,Portland Trail Blazers,111,112,223,1,Portland Trail Blazers,1,0.404,1,43,27,6,5,0.333,0.88,42,18,9,6
7362,22000156,Indiana Pacers,Sacramento Kings,122,127,249,5,Sacramento Kings,5,0.333,0.833,37,26,14,3,0.469,0.783,44,29,6,9
7363,22000157,Miami Heat,Philadelphia 76ers,134,137,271,3,Philadelphia 76ers,3,0.339,0.792,46,27,6,4,0.345,0.72,52,32,10,6
7364,22000158,Denver Nuggets,Brooklyn Nets,116,122,238,6,Brooklyn Nets,6,0.486,0.625,32,28,12,5,0.5,0.667,41,31,6,6
7365,22000159,Utah Jazz,Cleveland Cavaliers,117,87,204,30,Utah Jazz,30,0.533,0.75,48,26,8,8,0.258,0.643,40,23,7,4
7366,22000161,Los Angeles Lakers,Houston Rockets,117,100,217,17,Los Angeles Lakers,17,0.438,0.704,55,26,10,12,0.3,0.75,42,23,14,5
7367,22000162,San Antonio Spurs,Oklahoma City Thunder,112,102,214,10,San Antonio Spurs,10,0.286,0.909,46,26,8,5,0.269,0.793,52,18,1,5
7368,22000163,Indiana Pacers,Golden State Warriors,104,95,199,9,Indiana Pacers,9,0.321,0.68,50,26,9,9,0.342,0.636,46,25,8,8
7369,22000164,Dallas Mavericks,Charlotte Hornets,104,93,197,11,Dallas Mavericks,11,0.326,0.563,54,22,8,12,0.263,0.5,53,26,8,7
7370,22000165,Milwaukee Bucks,Detroit Pistons,110,101,211,9,Milwaukee Bucks,9,0.442,0.643,48,31,10,9,0.4,0.682,47,25,8,3
7371,22000166,Utah Jazz,Washington Wizards,122,131,253,9,Washington Wizards,9,0.375,0.571,47,19,10,3,0.412,0.789,43,23,6,2
7372,22000167,Orlando Magic,Boston Celtics,96,112,208,16,Boston Celtics,16,0.324,0.7,44,20,6,4,0.418,1,45,27,6,3
7373,22000168,Brooklyn Nets,New York Knicks,116,109,225,7,Brooklyn Nets,7,0.4,0.706,46,29,3,5,0.393,0.833,43,22,4,3
7374,22000169,Memphis Grizzlies,Minnesota Timberwolves,118,107,225,11,Memphis Grizzlies,11,0.32,0.769,47,33,11,5,0.243,0.833,48,27,3,6
7375,22000170,Los Angeles Lakers,Oklahoma City Thunder,128,99,227,29,Los Angeles Lakers,29,0.459,0.773,50,26,6,6,0.323,0.789,42,23,4,6
7376,22000171,Atlanta Hawks,Phoenix Suns,110,117,227,7,Phoenix Suns,7,0.406,0.714,36,30,9,1,0.375,0.833,49,27,6,1
7377,22000172,New Orleans Pelicans,Los Angeles Clippers,106,111,217,5,Los Angeles Clippers,5,0.357,0.75,48,18,4,4,0.486,0.852,36,26,4,6
7378,22000173,Portland Trail Blazers,Sacramento Kings,132,126,258,6,Portland Trail Blazers,6,0.479,0.778,38,28,9,8,0.5,0.731,42,35,4,2
7379,22000174,Miami Heat,Philadelphia 76ers,108,125,233,17,Philadelphia 76ers,17,0.353,0.615,41,28,4,1,0.459,0.833,35,27,15,3
7380,22000175,Charlotte Hornets,Toronto Raptors,108,111,219,3,Toronto Raptors,3,0.429,0.75,44,32,11,5,0.4,0.846,40,33,13,6
7381,22000176,Houston Rockets,San Antonio Spurs,109,105,214,4,Houston Rockets,4,0.394,0.632,49,25,6,6,0.29,0.75,41,26,10,4
7382,22000177,Golden State Warriors,Denver Nuggets,104,114,218,10,Denver Nuggets,10,0.379,0.708,43,29,9,4,0.297,0.778,50,29,11,5
7383,22000178,Indiana Pacers,Portland Trail Blazers,111,87,198,24,Indiana Pacers,24,0.3,0.778,50,29,11,5,0.302,1,43,16,8,5
7384,22000179,Washington Wizards,Detroit Pistons,91,120,211,29,Detroit Pistons,29,0.263,0.316,40,25,6,6,0.414,0.818,48,31,8,5
7385,22000180,Orlando Magic,Boston Celtics,97,124,221,27,Boston Celtics,27,0.25,0.636,46,14,5,1,0.405,0.895,45,25,7,4
7386,22000181,New York Knicks,Cleveland Cavaliers,103,106,209,3,Cleveland Cavaliers,3,0.36,0.875,39,20,9,10,0.333,0.735,48,26,9,6
7387,22000182,Dallas Mavericks,Milwaukee Bucks,109,112,221,3,Milwaukee Bucks,3,0.361,0.462,51,22,5,6,0.378,0.48,57,22,5,3
7388,22000184,Chicago Bulls,Oklahoma City Thunder,125,127,252,2,Oklahoma City Thunder,2,0.457,0.72,56,27,5,8,0.333,0.667,44,26,12,2
7389,22000185,Golden State Warriors,Phoenix Suns,98,120,218,22,Phoenix Suns,22,0.343,0.625,40,22,9,4,0.4,0.769,52,31,8,4
7390,22000186,Atlanta Hawks,Utah Jazz,92,116,208,24,Utah Jazz,24,0.179,0.733,41,21,6,1,0.455,0.714,53,27,7,6
7391,22000187,New Orleans Pelicans,Los Angeles Lakers,95,112,207,17,Los Angeles Lakers,17,0.31,0.5,47,22,3,5,0.405,0.731,44,31,11,6
7392,22000188,Los Angeles Clippers,Sacramento Kings,138,100,238,38,Los Angeles Clippers,38,0.514,0.8,47,29,10,3,0.308,0.706,32,23,4,2
7393,22000189,Houston Rockets,San Antonio Spurs,91,103,194,12,San Antonio Spurs,12,0.375,0.63,51,20,6,9,0.208,0.783,58,19,10,7
7394,22000190,Orlando Magic,Brooklyn Nets,115,122,237,7,Brooklyn Nets,7,0.304,0.813,38,28,13,4,0.457,0.88,41,24,9,5
7395,22000191,Charlotte Hornets,Toronto Raptors,113,116,229,3,Toronto Raptors,3,0.417,0.759,48,26,6,5,0.429,0.885,43,28,5,8
7396,22000192,Detroit Pistons,Miami Heat,120,100,220,20,Detroit Pistons,20,0.391,0.667,39,34,9,8,0.414,0.889,31,25,1,5
7397,22000193,Philadelphia 76ers,Memphis Grizzlies,104,106,210,2,Memphis Grizzlies,2,0.28,0.719,53,23,5,11,0.276,0.667,43,27,15,3
7398,22000194,Indiana Pacers,Phoenix Suns,122,111,233,11,Indiana Pacers,11,0.464,0.81,45,25,9,6,0.387,0.765,40,28,9,4
7399,22000195,Atlanta Hawks,Portland Trail Blazers,106,112,218,6,Portland Trail Blazers,6,0.2,0.857,48,24,4,6,0.341,0.85,55,18,6,8
7400,22000196,New York Knicks,Boston Celtics,105,75,180,30,New York Knicks,30,0.387,0.81,53,22,11,7,0.152,0.621,43,15,10,2
7401,22000198,Chicago Bulls,Dallas Mavericks,117,101,218,16,Chicago Bulls,16,0.28,0.727,47,32,14,6,0.258,0.579,47,18,6,2
7402,22000199,Philadelphia 76ers,Oklahoma City Thunder,117,93,210,24,Philadelphia 76ers,24,0.316,0.68,47,24,11,10,0.4,0.474,45,21,3,4
7403,22000200,Utah Jazz,Denver Nuggets,109,105,214,4,Utah Jazz,4,0.405,0.571,36,24,7,6,0.378,0.733,52,25,6,6
7404,22000201,New Orleans Pelicans,Sacramento Kings,128,123,251,5,New Orleans Pelicans,5,0.5,0.794,48,24,5,1,0.333,0.889,33,23,7,7
7405,22000202,Indiana Pacers,Los Angeles Clippers,96,129,225,33,Los Angeles Clippers,33,0.289,0.688,33,28,13,2,0.487,0.7,52,27,4,3
7406,22000203,Orlando Magic,New York Knicks,84,91,175,7,New York Knicks,7,0.316,0.875,51,18,4,9,0.185,0.706,53,15,6,4
7407,22000205,Minnesota Timberwolves,Atlanta Hawks,97,108,205,11,Atlanta Hawks,11,0.378,0.688,39,22,16,6,0.393,0.92,48,32,15,8
7408,22000206,Detroit Pistons,Miami Heat,107,113,220,6,Miami Heat,6,0.351,0.75,32,24,8,3,0.4,0.789,36,23,8,6
7409,22000207,San Antonio Spurs,Portland Trail Blazers,125,104,229,21,San Antonio Spurs,21,0.455,0.875,48,33,6,6,0.286,0.842,34,20,9,6
7410,22000208,Phoenix Suns,Memphis Grizzlies,104,108,212,4,Memphis Grizzlies,4,0.417,0.563,44,30,8,4,0.423,0.75,40,31,13,3
7411,22000209,Milwaukee Bucks,Brooklyn Nets,123,125,248,2,Brooklyn Nets,2,0.289,0.833,41,21,9,2,0.484,0.857,49,26,2,5
7412,22000210,Dallas Mavericks,Toronto Raptors,93,116,209,23,Toronto Raptors,23,0.25,0.815,38,21,6,4,0.364,0.889,46,23,9,6
7413,22000211,Houston Rockets,Chicago Bulls,120,125,245,5,Chicago Bulls,5,0.425,0.647,36,25,8,1,0.444,0.905,47,23,10,3
7414,22000212,Golden State Warriors,Los Angeles Lakers,115,113,228,2,Golden State Warriors,2,0.324,0.75,32,31,8,3,0.31,0.727,50,23,6,5
7415,22000213,Oklahoma City Thunder,Denver Nuggets,101,119,220,18,Denver Nuggets,18,0.326,0.652,41,22,8,4,0.333,0.929,58,29,11,3
7416,22000214,New Orleans Pelicans,Utah Jazz,102,118,220,16,Utah Jazz,16,0.231,0.667,38,17,8,3,0.447,0.647,54,28,4,7
7417,22000215,Washington Wizards,Charlotte Hornets,97,119,216,22,Charlotte Hornets,22,0.225,0.714,48,22,6,5,0.417,0.769,59,21,6,6
7418,22000216,Brooklyn Nets,Cleveland Cavaliers,135,147,282,12,Cleveland Cavaliers,12,0.366,0.889,52,30,8,11,0.5,0.714,50,29,10,6
7419,22000217,Dallas Mavericks,Indiana Pacers,124,112,236,12,Dallas Mavericks,12,0.296,0.824,49,32,5,6,0.41,0.667,38,21,6,3
7420,22000218,Boston Celtics,Philadelphia 76ers,109,117,226,8,Philadelphia 76ers,8,0.364,0.65,45,22,3,0,0.333,0.8,41,20,12,3
7421,22000219,Detroit Pistons,Atlanta Hawks,115,123,238,8,Atlanta Hawks,8,0.323,0.895,42,22,9,3,0.391,0.684,63,21,6,10
7422,22000220,Miami Heat,Toronto Raptors,111,102,213,9,Miami Heat,9,0.45,0.882,46,29,4,5,0.327,0.889,41,27,8,3
7423,22000221,Orlando Magic,Minnesota Timberwolves,97,96,193,1,Orlando Magic,1,0.323,0.714,48,26,5,8,0.429,0.643,43,25,5,12
7424,22000222,Phoenix Suns,Houston Rockets,109,103,212,6,Phoenix Suns,6,0.235,0.895,45,25,6,11,0.323,0.864,39,17,11,5
7425,22000223,San Antonio Spurs,Golden State Warriors,99,121,220,22,Golden State Warriors,22,0.121,0.806,43,17,7,2,0.395,0.7,54,31,6,2
7426,22000224,Sacramento Kings,Los Angeles Clippers,96,115,211,19,Los Angeles Clippers,19,0.464,0.417,39,25,11,4,0.457,0.944,48,24,14,6
7427,22000226,Los Angeles Lakers,Milwaukee Bucks,113,106,219,7,Los Angeles Lakers,7,0.514,0.8,38,25,8,8,0.321,0.75,46,27,5,5
7428,22000227,New Orleans Pelicans,Utah Jazz,118,129,247,11,Utah Jazz,11,0.44,0.767,41,27,9,2,0.436,0.96,39,27,8,8
7429,22000228,New York Knicks,Golden State Warriors,119,104,223,15,New York Knicks,15,0.458,0.78,55,24,5,9,0.237,0.744,46,27,5,3
7430,22000229,Chicago Bulls,Charlotte Hornets,123,110,233,13,Chicago Bulls,13,0.349,0.833,43,33,11,4,0.219,0.76,46,22,8,1
7431,22000230,Houston Rockets,Detroit Pistons,103,102,205,1,Houston Rockets,1,0.341,0.75,51,24,7,11,0.469,0.676,55,17,5,8
7432,22000231,Orlando Magic,Indiana Pacers,118,120,238,2,Indiana Pacers,2,0.459,0.625,49,29,7,3,0.353,0.889,44,28,9,5
7433,22000232,Brooklyn Nets,Cleveland Cavaliers,113,125,238,12,Cleveland Cavaliers,12,0.326,0.882,29,23,5,8,0.32,0.844,50,24,7,3
7434,22000233,Boston Celtics,Philadelphia 76ers,110,122,232,12,Philadelphia 76ers,12,0.4,0.8,32,23,10,5,0.429,0.833,45,23,9,7
7435,22000234,Miami Heat,Toronto Raptors,81,101,182,20,Toronto Raptors,20,0.226,0.8,32,19,13,4,0.425,0.667,45,22,11,3
7436,22000236,Atlanta Hawks,Minnesota Timberwolves,116,98,214,18,Atlanta Hawks,18,0.429,0.833,55,21,9,12,0.25,0.833,40,30,14,8
7437,22000237,Dallas Mavericks,San Antonio Spurs,122,117,239,5,Dallas Mavericks,5,0.359,0.9,42,23,3,2,0.429,0.767,49,21,3,5
7438,22000238,Denver Nuggets,Phoenix Suns,130,126,256,4,Denver Nuggets,4,0.231,0.947,43,32,12,1,0.386,1,45,30,7,4
7439,22000239,Oklahoma City Thunder,Los Angeles Clippers,106,120,226,14,Los Angeles Clippers,14,0.333,0.769,29,24,8,1,0.303,0.96,48,21,8,7
7440,22000241,New York Knicks,Sacramento Kings,94,103,197,9,Sacramento Kings,9,0.227,0.68,57,19,2,6,0.353,0.714,55,21,6,14
7441,22000242,Golden State Warriors,Utah Jazz,108,127,235,19,Utah Jazz,19,0.359,0.667,35,30,6,8,0.4,0.773,57,28,6,4
7442,22000243,Philadelphia 76ers,Detroit Pistons,114,110,224,4,Philadelphia 76ers,4,0.348,0.789,49,14,10,7,0.424,0.733,43,25,9,8
7443,22000244,Miami Heat,Brooklyn Nets,124,128,252,4,Brooklyn Nets,4,0.283,0.844,31,29,7,1,0.514,0.808,47,34,0,6
7444,22000245,Los Angeles Lakers,Chicago Bulls,101,90,191,11,Los Angeles Lakers,11,0.211,0.806,42,20,7,4,0.32,0.727,45,18,8,1
7445,22000246,New Orleans Pelicans,Minnesota Timberwolves,110,120,230,10,Minnesota Timberwolves,10,0.303,0.714,42,21,5,4,0.353,0.811,50,23,14,4
7446,22000247,Houston Rockets,Dallas Mavericks,133,108,241,25,Houston Rockets,25,0.432,0.793,52,28,5,5,0.2,0.725,36,15,7,4
7447,22000248,Denver Nuggets,Phoenix Suns,120,112,232,8,Denver Nuggets,8,0.417,0.781,65,22,4,3,0.302,0.778,50,26,8,4
7448,22000249,Toronto Raptors,Indiana Pacers,107,102,209,5,Toronto Raptors,5,0.429,0.692,45,24,12,8,0.333,0.864,47,23,10,8
7449,22000250,Cleveland Cavaliers,Boston Celtics,103,141,244,38,Boston Celtics,38,0.303,0.735,34,24,10,8,0.5,0.852,55,26,14,8
7450,22000251,Oklahoma City Thunder,Los Angeles Clippers,100,108,208,8,Los Angeles Clippers,8,0.2,0.643,51,22,7,2,0.304,0.75,46,26,4,2
7451,22000252,Charlotte Hornets,Orlando Magic,107,104,211,3,Charlotte Hornets,3,0.389,0.563,43,28,10,5,0.447,0.692,43,27,4,4
7452,22000253,Washington Wizards,San Antonio Spurs,101,121,222,20,San Antonio Spurs,20,0.333,0.643,50,23,5,5,0.484,0.909,44,27,11,5
7453,22000254,Atlanta Hawks,Milwaukee Bucks,115,129,244,14,Milwaukee Bucks,14,0.359,0.773,27,27,8,4,0.323,0.704,52,32,4,2
7454,22000256,New York Knicks,Portland Trail Blazers,113,116,229,3,Portland Trail Blazers,3,0.414,0.92,47,20,9,0,0.37,0.913,39,19,5,8
7455,22000257,Philadelphia 76ers,Detroit Pistons,104,119,223,15,Detroit Pistons,15,0.321,0.75,36,15,12,3,0.447,0.842,47,22,6,6
7456,22000258,Toronto Raptors,Indiana Pacers,114,129,243,15,Indiana Pacers,15,0.368,0.889,39,24,9,6,0.414,0.822,45,26,5,8
7457,22000259,Charlotte Hornets,Orlando Magic,108,117,225,9,Orlando Magic,9,0.289,0.704,41,22,5,6,0.514,0.636,49,31,10,3
7458,22000260,Miami Heat,Brooklyn Nets,85,98,183,13,Brooklyn Nets,13,0.256,0.706,45,20,3,7,0.289,0.864,49,24,6,5
7459,22000261,Los Angeles Lakers,Cleveland Cavaliers,115,108,223,7,Los Angeles Lakers,7,0.313,0.75,40,21,7,7,0.429,0.864,44,19,8,3
7460,22000262,Boston Celtics,Chicago Bulls,119,103,222,16,Boston Celtics,16,0.517,0.8,44,28,9,6,0.436,0.4,41,28,4,7
7461,22000265,Denver Nuggets,Dallas Mavericks,117,113,230,4,Denver Nuggets,4,0.429,0.786,49,25,9,4,0.344,0.833,34,26,11,4
7462,22000266,Minnesota Timberwolves,Golden State Warriors,108,130,238,22,Golden State Warriors,22,0.333,0.88,47,26,8,5,0.467,0.757,46,21,13,10
7463,22000267,Oklahoma City Thunder,Portland Trail Blazers,125,122,247,3,Oklahoma City Thunder,3,0.45,0.6,43,25,5,6,0.341,0.762,50,17,6,3
7464,22000268,Los Angeles Clippers,Atlanta Hawks,99,108,207,9,Atlanta Hawks,9,0.308,0.864,46,23,11,4,0.385,0.96,46,20,7,9
7465,22000269,Washington Wizards,Houston Rockets,88,107,195,19,Houston Rockets,19,0.192,0.739,50,19,7,3,0.324,0.724,44,16,13,4
7466,22000270,New York Knicks,Utah Jazz,94,108,202,14,Utah Jazz,14,0.37,0.706,44,15,6,4,0.313,0.864,53,24,6,5
7467,22000271,Indiana Pacers,Charlotte Hornets,116,106,222,10,Indiana Pacers,10,0.4,0.833,47,34,1,9,0.342,0.905,39,28,3,3
7468,22000272,Detroit Pistons,Cleveland Cavaliers,107,122,229,15,Cleveland Cavaliers,15,0.407,0.759,40,29,7,5,0.524,0.739,37,24,14,7
7469,22000273,Sacramento Kings,Orlando Magic,121,107,228,14,Sacramento Kings,14,0.424,0.654,50,30,8,3,0.385,0.944,47,25,8,8
7470,22000274,Brooklyn Nets,Atlanta Hawks,132,128,260,4,Brooklyn Nets,4,0.344,0.85,36,29,7,10,0.394,0.893,37,29,3,7
7471,22000275,Denver Nuggets,Miami Heat,109,82,191,27,Denver Nuggets,27,0.326,1,49,29,14,4,0.289,0.818,38,24,6,3
7472,22000276,Los Angeles Lakers,Philadelphia 76ers,106,107,213,1,Philadelphia 76ers,1,0.333,0.64,37,20,5,2,0.36,0.615,38,24,10,7
7473,22000277,Milwaukee Bucks,Toronto Raptors,115,108,223,7,Milwaukee Bucks,7,0.364,0.731,59,30,9,3,0.4,0.833,46,26,8,8
7474,22000278,Chicago Bulls,Memphis Grizzlies,90,101,191,11,Memphis Grizzlies,11,0.161,0.765,40,23,8,3,0.321,0.857,51,27,7,7
7475,22000279,Washington Wizards,New Orleans Pelicans,106,124,230,18,New Orleans Pelicans,18,0.342,0.905,39,29,11,2,0.395,0.625,50,27,7,4
7476,22000280,Boston Celtics,San Antonio Spurs,106,110,216,4,San Antonio Spurs,4,0.333,0.857,39,15,10,4,0.286,0.625,46,22,5,4
7477,22000281,Oklahoma City Thunder,Phoenix Suns,102,97,199,5,Oklahoma City Thunder,5,0.4,0.714,48,21,7,8,0.349,0.833,49,19,7,3
7478,22000282,Dallas Mavericks,Utah Jazz,104,116,220,12,Utah Jazz,12,0.343,0.889,36,22,4,7,0.39,0.762,50,20,7,7
7479,22000283,Minnesota Timberwolves,Golden State Warriors,111,123,234,12,Golden State Warriors,12,0.389,0.697,39,23,12,7,0.441,0.783,46,32,11,5
7480,22000284,Los Angeles Lakers,Detroit Pistons,92,107,199,15,Detroit Pistons,15,0.429,0.667,44,25,2,3,0.389,1,38,27,4,2
7481,22000285,Los Angeles Clippers,Miami Heat,109,105,214,4,Los Angeles Clippers,4,0.405,0.909,55,22,11,4,0.394,0.8,45,24,5,1
7482,22000286,Golden State Warriors,Phoenix Suns,93,114,207,21,Phoenix Suns,21,0.289,0.75,48,21,8,1,0.344,0.913,57,34,7,1
7483,22000287,Portland Trail Blazers,Houston Rockets,101,104,205,3,Houston Rockets,3,0.415,0.75,49,16,6,7,0.277,0.833,47,19,8,7
7484,22000288,Indiana Pacers,Charlotte Hornets,105,108,213,3,Charlotte Hornets,3,0.314,0.769,39,30,7,4,0.432,0.667,42,35,7,5
7485,22000289,Los Angeles Clippers,Orlando Magic,116,90,206,26,Los Angeles Clippers,26,0.351,1,49,25,8,5,0.303,0.889,49,20,6,2
7486,22000290,Atlanta Hawks,Washington Wizards,116,100,216,16,Atlanta Hawks,16,0.324,0.765,47,16,5,4,0.25,0.816,47,13,6,4
7487,22000291,Cleveland Cavaliers,New York Knicks,81,102,183,21,New York Knicks,21,0.308,0.833,43,15,8,5,0.37,0.875,41,20,8,6
7488,22000292,Sacramento Kings,Toronto Raptors,126,124,250,2,Sacramento Kings,2,0.444,0.774,38,31,7,5,0.406,0.818,35,20,14,2
7489,22000293,Milwaukee Bucks,New Orleans Pelicans,126,131,257,5,New Orleans Pelicans,5,0.371,0.773,49,29,5,5,0.438,0.714,45,32,7,3
7490,22000294,Philadelphia 76ers,Minnesota Timberwolves,118,94,212,24,Philadelphia 76ers,24,0.5,0.842,51,20,11,6,0.303,0.778,38,20,3,4
7491,22000295,Brooklyn Nets,Oklahoma City Thunder,147,125,272,22,Brooklyn Nets,22,0.422,0.875,50,33,7,4,0.421,0.853,36,23,4,4
7492,22000296,Denver Nuggets,San Antonio Spurs,109,119,228,10,San Antonio Spurs,10,0.452,0.65,37,25,8,5,0.435,0.808,41,29,8,1
7493,22000297,Dallas Mavericks,Utah Jazz,101,120,221,19,Utah Jazz,19,0.273,0.667,40,20,6,4,0.417,0.923,56,21,8,5
7494,22000298,Portland Trail Blazers,Chicago Bulls,123,122,245,1,Portland Trail Blazers,1,0.405,0.842,35,20,11,1,0.467,1,43,31,5,2
7495,22000299,Milwaukee Bucks,Charlotte Hornets,114,126,240,12,Charlotte Hornets,12,0.4,0.667,46,22,6,6,0.477,0.85,41,32,8,5
7496,22000300,Houston Rockets,New Orleans Pelicans,126,112,238,14,Houston Rockets,14,0.435,0.8,45,32,8,5,0.293,0.621,48,27,11,7
7497,22000301,Sacramento Kings,Miami Heat,104,105,209,1,Miami Heat,1,0.378,0.455,41,22,12,3,0.344,0.846,39,25,5,4
7498,22000302,Los Angeles Lakers,Boston Celtics,96,95,191,1,Los Angeles Lakers,1,0.29,0.684,45,20,8,4,0.286,0.643,42,24,10,6
7499,22000303,Phoenix Suns,Dallas Mavericks,111,105,216,6,Phoenix Suns,6,0.455,0.871,42,22,9,0,0.31,0.571,37,22,5,4
7500,22000304,Memphis Grizzlies,San Antonio Spurs,129,112,241,17,Memphis Grizzlies,17,0.486,0.667,45,34,7,7,0.448,0.808,38,25,7,5
7501,22000305,Detroit Pistons,Golden State Warriors,91,118,209,27,Golden State Warriors,27,0.25,0.75,38,17,7,4,0.472,0.7,47,34,6,5
7502,22000306,Utah Jazz,Denver Nuggets,117,128,245,11,Denver Nuggets,11,0.426,0.846,38,28,3,4,0.643,0.842,39,28,8,2
7503,22000307,Philadelphia 76ers,Indiana Pacers,119,110,229,9,Philadelphia 76ers,9,0.308,0.677,44,20,9,8,0.357,0.818,41,21,6,7
7504,22000308,Los Angeles Clippers,New York Knicks,129,115,244,14,Los Angeles Clippers,14,0.447,0.857,38,26,2,4,0.37,0.821,36,21,5,5
7505,22000309,Orlando Magic,Toronto Raptors,102,115,217,13,Toronto Raptors,13,0.361,0.821,42,22,8,5,0.308,0.955,48,27,8,5
7506,22000310,Brooklyn Nets,Washington Wizards,146,149,295,3,Washington Wizards,3,0.528,0.818,45,33,6,5,0.308,0.781,39,24,10,2
7507,22000311,Cleveland Cavaliers,Minnesota Timberwolves,104,109,213,5,Minnesota Timberwolves,5,0.25,0.783,55,20,3,3,0.4,0.733,34,24,10,11
7508,22000312,Minnesota Timberwolves,Cleveland Cavaliers,98,100,198,2,Cleveland Cavaliers,2,0.289,0.636,45,20,4,1,0.318,0.742,52,26,4,12
7509,22000313,Los Angeles Lakers,Atlanta Hawks,107,99,206,8,Los Angeles Lakers,8,0.304,0.833,31,24,10,7,0.379,0.824,36,27,8,3
7510,22000314,Charlotte Hornets,Miami Heat,129,121,250,8,Charlotte Hornets,8,0.512,0.846,44,31,6,4,0.413,0.64,48,28,8,7
7511,22000315,New York Knicks,Chicago Bulls,102,110,212,8,Chicago Bulls,8,0.207,0.846,45,21,6,6,0.324,0.75,40,30,3,1
7512,22000316,Portland Trail Blazers,Milwaukee Bucks,106,134,240,28,Milwaukee Bucks,28,0.357,1,45,19,8,6,0.5,0.583,53,38,10,7
7513,22000317,Sacramento Kings,New Orleans Pelicans,118,109,227,9,Sacramento Kings,9,0.326,0.769,52,31,3,8,0.3,0.833,46,22,11,5
7514,22000318,Houston Rockets,Oklahoma City Thunder,136,106,242,30,Houston Rockets,30,0.538,0.909,50,30,8,6,0.382,0.789,45,21,8,8
7515,22000319,Phoenix Suns,Dallas Mavericks,109,108,217,1,Phoenix Suns,1,0.371,0.833,45,19,7,3,0.313,0.96,42,16,9,7
7516,22000320,Memphis Grizzlies,San Antonio Spurs,133,102,235,31,Memphis Grizzlies,31,0.5,0.778,53,37,11,11,0.351,0.682,42,28,8,7
7517,22000321,Detroit Pistons,Denver Nuggets,119,134,253,15,Denver Nuggets,15,0.429,0.8,30,27,4,2,0.452,0.889,44,36,7,5
7518,22000322,Memphis Grizzlies,Indiana Pacers,116,134,250,18,Indiana Pacers,18,0.36,0.958,36,27,11,7,0.552,0.69,42,30,8,8
7519,22000323,Toronto Raptors,Orlando Magic,123,108,231,15,Toronto Raptors,15,0.444,0.92,40,32,14,4,0.368,0.857,46,24,4,4
7520,22000324,Los Angeles Clippers,Brooklyn Nets,120,124,244,4,Brooklyn Nets,4,0.417,0.882,39,21,12,5,0.419,0.808,44,25,6,4
7521,22000325,Detroit Pistons,Utah Jazz,105,117,222,12,Utah Jazz,12,0.333,0.9,46,18,7,5,0.381,0.862,44,23,9,6
7522,22000326,Boston Celtics,Golden State Warriors,111,107,218,4,Boston Celtics,4,0.382,0.741,51,16,3,4,0.405,0.696,36,30,9,4
7523,22000327,Philadelphia 76ers,Charlotte Hornets,118,111,229,7,Philadelphia 76ers,7,0.417,0.813,40,23,9,6,0.378,0.826,37,28,5,4
7524,22000328,Los Angeles Clippers,Cleveland Cavaliers,121,99,220,22,Los Angeles Clippers,22,0.588,0.765,46,22,4,6,0.4,0.765,37,21,8,6
7525,22000329,Indiana Pacers,Milwaukee Bucks,110,130,240,20,Milwaukee Bucks,20,0.324,0.867,46,28,7,6,0.438,0.929,53,33,13,7
7526,22000330,Dallas Mavericks,Atlanta Hawks,122,116,238,6,Dallas Mavericks,6,0.325,0.92,45,27,8,7,0.368,0.706,46,31,6,4
7527,22000331,Washington Wizards,Miami Heat,103,100,203,3,Washington Wizards,3,0.405,0.72,49,20,6,5,0.343,0.727,44,24,11,2
7528,22000332,New York Knicks,Chicago Bulls,107,103,210,4,New York Knicks,4,0.5,0.667,47,19,5,4,0.167,0.688,38,25,11,3
7529,22000333,Houston Rockets,Oklahoma City Thunder,87,104,191,17,Oklahoma City Thunder,17,0.261,0.692,41,21,11,4,0.303,0.846,51,19,13,5
7530,22000334,Minnesota Timberwolves,San Antonio Spurs,108,111,219,3,San Antonio Spurs,3,0.394,0.818,49,22,6,9,0.269,0.75,45,28,5,6
7531,22000335,Phoenix Suns,New Orleans Pelicans,101,123,224,22,New Orleans Pelicans,22,0.229,0.85,39,26,3,6,0.424,0.81,44,30,7,3
7532,22000336,Boston Celtics,Sacramento Kings,111,116,227,5,Sacramento Kings,5,0.333,0.759,45,28,9,3,0.351,0.826,44,23,7,2
7533,22000337,Portland Trail Blazers,Philadelphia 76ers,121,105,226,16,Portland Trail Blazers,16,0.419,0.783,53,17,8,5,0.259,0.833,37,19,6,3
7534,22000338,Utah Jazz,Atlanta Hawks,112,91,203,21,Utah Jazz,21,0.481,0.846,52,19,7,4,0.29,0.947,49,19,8,1
7535,22000339,Golden State Warriors,Dallas Mavericks,147,116,263,31,Golden State Warriors,31,0.512,0.852,45,37,6,6,0.4,0.87,42,26,2,3
7536,22000340,Houston Rockets,Memphis Grizzlies,115,103,218,12,Houston Rockets,12,0.422,0.824,44,26,8,3,0.343,0.708,43,28,10,6
7537,22000341,Denver Nuggets,Los Angeles Lakers,93,114,207,21,Los Angeles Lakers,21,0.286,0.867,42,19,9,2,0.333,0.636,40,29,10,7
7538,22000342,Utah Jazz,Charlotte Hornets,138,121,259,17,Utah Jazz,17,0.52,0.889,44,32,5,9,0.314,0.824,40,26,9,2
7539,22000343,New Orleans Pelicans,Indiana Pacers,114,113,227,1,New Orleans Pelicans,1,0.52,0.731,50,23,5,6,0.476,0.688,37,31,9,6
7540,22000344,Chicago Bulls,Orlando Magic,119,123,242,4,Orlando Magic,4,0.3,0.9,40,27,9,5,0.407,0.757,49,27,5,2
7541,22000345,Toronto Raptors,Brooklyn Nets,123,117,240,6,Toronto Raptors,6,0.406,0.857,41,22,10,6,0.405,0.759,40,29,5,6
7542,22000346,Milwaukee Bucks,Cleveland Cavaliers,123,105,228,18,Milwaukee Bucks,18,0.318,0.727,54,28,6,7,0.344,0.75,36,23,7,9
7543,22000347,Washington Wizards,Miami Heat,95,122,217,27,Miami Heat,27,0.242,0.875,40,19,7,9,0.444,0.87,48,27,9,7
7544,22000348,Minnesota Timberwolves,Oklahoma City Thunder,106,103,209,3,Minnesota Timberwolves,3,0.4,0.889,43,27,10,4,0.382,0.706,44,28,10,7
7545,22000349,Detroit Pistons,Phoenix Suns,92,109,201,17,Phoenix Suns,17,0.194,0.607,45,20,8,6,0.375,0.813,50,26,7,3
7546,22000350,Boston Celtics,Los Angeles Clippers,119,115,234,4,Boston Celtics,4,0.421,0.81,34,21,8,1,0.438,0.81,47,26,5,4
7547,22000351,Portland Trail Blazers,New York Knicks,99,110,209,11,New York Knicks,11,0.362,0.5,41,15,7,7,0.433,0.692,51,20,5,5
7548,22000352,Denver Nuggets,Sacramento Kings,114,119,233,5,Sacramento Kings,5,0.371,0.786,47,30,3,9,0.4,0.708,45,30,5,7
7549,22000353,Chicago Bulls,Orlando Magic,118,92,210,26,Chicago Bulls,26,0.5,0.692,47,28,6,10,0.222,1,47,17,5,10
7550,22000354,Brooklyn Nets,Philadelphia 76ers,108,124,232,16,Philadelphia 76ers,16,0.366,0.882,34,21,6,3,0.37,0.818,51,27,12,4
7551,22000355,Memphis Grizzlies,New Orleans Pelicans,109,118,227,9,New Orleans Pelicans,9,0.333,0.842,45,27,5,5,0.455,0.619,42,27,3,9
7552,22000356,Toronto Raptors,Atlanta Hawks,121,132,253,11,Atlanta Hawks,11,0.342,0.765,38,24,9,5,0.528,0.879,43,31,1,10
7553,22000357,Milwaukee Bucks,Cleveland Cavaliers,124,99,223,25,Milwaukee Bucks,25,0.471,0.609,43,25,10,2,0.214,0.714,40,21,4,1
7554,22000358,San Antonio Spurs,Houston Rockets,111,106,217,5,San Antonio Spurs,5,0.32,0.806,44,22,6,7,0.316,0.72,46,21,5,6
7555,22000359,Minnesota Timberwolves,Oklahoma City Thunder,118,120,238,2,Oklahoma City Thunder,2,0.333,0.545,40,27,12,3,0.364,0.8,43,25,8,1
7556,22000360,Golden State Warriors,Dallas Mavericks,132,134,266,2,Dallas Mavericks,2,0.444,0.87,40,27,11,4,0.447,0.833,47,27,5,0
7557,22000361,Detroit Pistons,Los Angeles Lakers,129,135,264,6,Los Angeles Lakers,6,0.381,0.821,35,31,13,4,0.474,0.857,41,32,12,5
7558,22000363,Utah Jazz,Indiana Pacers,103,95,198,8,Utah Jazz,8,0.31,0.667,60,22,2,4,0.276,0.722,45,23,9,6
7559,22000364,Miami Heat,New York Knicks,109,103,212,6,Miami Heat,6,0.371,0.8,44,25,6,1,0.381,0.733,44,23,8,2
7560,22000365,Boston Celtics,Phoenix Suns,91,100,191,9,Phoenix Suns,9,0.386,0.667,41,19,6,2,0.276,1,50,25,4,5
7561,22000366,Sacramento Kings,Los Angeles Clippers,113,110,223,3,Sacramento Kings,3,0.345,0.733,52,25,5,4,0.286,0.87,53,19,8,5
7562,22000367,Houston Rockets,Charlotte Hornets,94,119,213,25,Charlotte Hornets,25,0.277,0.688,39,20,9,4,0.463,0.923,51,28,5,6
7563,22000368,Washington Wizards,Chicago Bulls,105,101,206,4,Washington Wizards,4,0.231,0.75,47,23,8,4,0.3,0.833,50,23,6,3
7564,22000369,Toronto Raptors,Memphis Grizzlies,128,113,241,15,Toronto Raptors,15,0.541,0.923,37,28,11,2,0.333,0.897,42,27,7,4
7565,22000370,Minnesota Timberwolves,Dallas Mavericks,122,127,249,5,Dallas Mavericks,5,0.429,0.714,41,27,9,5,0.353,0.833,48,30,4,6
7566,22000371,Golden State Warriors,San Antonio Spurs,100,105,205,5,San Antonio Spurs,5,0.351,0.733,49,29,4,6,0.355,0.842,46,24,12,6
7567,22000372,Cleveland Cavaliers,Phoenix Suns,113,119,232,6,Phoenix Suns,6,0.333,0.68,39,23,5,5,0.458,0.737,41,29,7,6
7568,22000373,Milwaukee Bucks,Denver Nuggets,125,112,237,13,Milwaukee Bucks,13,0.4,0.864,50,24,7,7,0.417,0.938,38,22,5,4
7569,22000374,Oklahoma City Thunder,Los Angeles Lakers,112,119,231,7,Los Angeles Lakers,7,0.316,0.737,55,23,6,4,0.237,0.759,59,28,7,12
7570,22000375,Brooklyn Nets,Detroit Pistons,111,122,233,11,Detroit Pistons,11,0.367,0.875,34,30,8,6,0.448,0.714,37,28,10,6
7571,22000376,New York Knicks,Miami Heat,96,98,194,2,Miami Heat,2,0.357,0.75,46,22,8,5,0.424,0.821,38,21,5,6
7572,22000377,Houston Rockets,New Orleans Pelicans,101,130,231,29,New Orleans Pelicans,29,0.302,0.571,37,24,5,4,0.387,0.857,55,31,7,6
7573,22000378,Golden State Warriors,San Antonio Spurs,114,91,205,23,Golden State Warriors,23,0.425,0.684,50,26,8,4,0.333,0.905,45,20,2,5
7574,22000379,Boston Celtics,Utah Jazz,108,122,230,14,Utah Jazz,14,0.448,0.826,35,18,2,2,0.375,0.889,41,28,4,7
7575,22000380,Orlando Magic,Portland Trail Blazers,97,106,203,9,Portland Trail Blazers,9,0.314,0.545,53,22,7,3,0.391,0.947,54,18,6,6
7576,22000381,Philadelphia 76ers,Sacramento Kings,119,111,230,8,Philadelphia 76ers,8,0.45,0.8,59,24,4,5,0.333,0.579,39,24,6,8
7577,22000382,Toronto Raptors,Washington Wizards,137,115,252,22,Toronto Raptors,22,0.594,0.87,46,28,5,5,0.293,0.826,46,26,7,3
7578,22000383,Indiana Pacers,Brooklyn Nets,94,104,198,10,Brooklyn Nets,10,0.395,0.636,43,26,4,5,0.29,0.886,46,20,2,5
7579,22000384,Atlanta Hawks,Dallas Mavericks,117,118,235,1,Dallas Mavericks,1,0.359,0.821,42,27,7,4,0.4,0.9,37,25,3,3
7580,22000385,New Orleans Pelicans,Chicago Bulls,116,129,245,13,Chicago Bulls,13,0.361,0.808,35,27,11,1,0.532,0.727,35,36,4,6
7581,22000386,Charlotte Hornets,Memphis Grizzlies,114,130,244,16,Memphis Grizzlies,16,0.483,0.833,35,23,11,4,0.469,0.722,46,34,10,2
7582,22000387,Los Angeles Clippers,Minnesota Timberwolves,119,112,231,7,Los Angeles Clippers,7,0.522,0.862,48,23,9,4,0.366,0.789,43,29,8,8
7583,22000388,Cleveland Cavaliers,Denver Nuggets,95,133,228,38,Denver Nuggets,38,0.216,0.75,49,25,7,7,0.444,0.714,39,31,12,9
7584,22000389,Milwaukee Bucks,Phoenix Suns,124,125,249,1,Phoenix Suns,1,0.432,0.733,39,23,6,0,0.484,0.72,47,25,7,2
7585,22000390,Oklahoma City Thunder,Los Angeles Lakers,113,114,227,1,Los Angeles Lakers,1,0.226,0.857,46,32,11,4,0.286,0.833,43,22,6,6
7586,22000391,Indiana Pacers,Detroit Pistons,111,95,206,16,Indiana Pacers,16,0.452,0.9,41,26,10,5,0.179,0.737,43,21,5,5
7587,22000392,Miami Heat,Houston Rockets,101,94,195,7,Miami Heat,7,0.357,0.9,49,24,6,3,0.3,0.75,42,24,7,1
7588,22000393,Orlando Magic,Golden State Warriors,105,111,216,6,Golden State Warriors,6,0.455,0.778,49,19,7,6,0.4,0.75,46,29,6,6
7589,22000394,Philadelphia 76ers,Portland Trail Blazers,114,118,232,4,Portland Trail Blazers,4,0.222,0.828,46,20,6,5,0.447,0.913,47,15,5,2
7590,22000395,Minnesota Timberwolves,Charlotte Hornets,114,120,234,6,Charlotte Hornets,6,0.39,0.571,40,28,10,4,0.361,1,55,20,4,3
7591,22000396,New York Knicks,Washington Wizards,109,91,200,18,New York Knicks,18,0.25,0.682,65,22,11,4,0.265,0.7,46,20,5,5
7592,22000397,San Antonio Spurs,Atlanta Hawks,125,114,239,11,San Antonio Spurs,11,0.387,0.821,46,27,6,6,0.344,0.758,41,22,10,4
7593,22000398,Toronto Raptors,Boston Celtics,106,120,226,14,Boston Celtics,14,0.321,0.789,32,26,7,8,0.513,0.786,49,30,8,6
7594,22000399,New Orleans Pelicans,Dallas Mavericks,130,143,273,13,Dallas Mavericks,13,0.459,0.739,38,31,5,3,0.556,0.762,37,30,4,2
7595,22000400,Los Angeles Clippers,Chicago Bulls,125,106,231,19,Los Angeles Clippers,19,0.433,0.8,37,20,11,7,0.375,0.933,41,23,4,3
7596,22000401,Oklahoma City Thunder,Denver Nuggets,95,97,192,2,Denver Nuggets,2,0.313,0.765,50,26,8,3,0.25,0.7,41,24,6,6
7597,22000402,Milwaukee Bucks,Utah Jazz,115,129,244,14,Utah Jazz,14,0.364,0.704,33,19,8,6,0.368,0.853,46,22,4,5
7598,22000403,Memphis Grizzlies,Los Angeles Lakers,105,115,220,10,Los Angeles Lakers,10,0.414,0.789,33,31,9,2,0.2,0.697,47,26,9,4
7599,22000404,Cleveland Cavaliers,Portland Trail Blazers,110,129,239,19,Portland Trail Blazers,19,0.348,0.703,41,20,6,3,0.371,0.909,45,16,3,4
7600,22000405,Orlando Magic,Sacramento Kings,123,112,235,11,Orlando Magic,11,0.441,0.8,42,25,8,2,0.364,0.737,42,33,8,1
7601,22000406,Philadelphia 76ers,Phoenix Suns,111,120,231,9,Phoenix Suns,9,0.412,0.848,35,19,7,1,0.4,0.824,32,25,8,3
7602,22000407,Indiana Pacers,Atlanta Hawks,125,113,238,12,Indiana Pacers,12,0.387,0.852,43,34,8,6,0.29,0.783,38,35,5,4
7603,22000408,Houston Rockets,New York Knicks,99,121,220,22,New York Knicks,22,0.186,0.833,46,17,5,5,0.429,0.826,44,21,4,4
7604,22000409,Brooklyn Nets,Golden State Warriors,134,117,251,17,Brooklyn Nets,17,0.41,0.9,45,35,9,5,0.265,0.8,37,25,6,6
7605,22000410,Miami Heat,Utah Jazz,94,112,206,18,Utah Jazz,18,0.333,0.706,43,24,11,3,0.261,0.759,48,26,11,7
7606,22000411,Portland Trail Blazers,Dallas Mavericks,121,118,239,3,Portland Trail Blazers,3,0.45,0.684,36,15,7,2,0.341,0.96,35,19,5,6
7607,22000412,Detroit Pistons,Boston Celtics,108,102,210,6,Detroit Pistons,6,0.395,0.833,44,25,3,6,0.296,0.733,44,15,9,2
7608,22000413,Minnesota Timberwolves,Toronto Raptors,116,112,228,4,Minnesota Timberwolves,4,0.41,0.737,40,28,6,8,0.303,0.839,38,24,6,3
7609,22000414,San Antonio Spurs,Charlotte Hornets,122,110,232,12,San Antonio Spurs,12,0.294,0.842,43,31,13,4,0.353,0.727,49,23,6,6
7610,22000415,Milwaukee Bucks,Oklahoma City Thunder,109,114,223,5,Oklahoma City Thunder,5,0.342,0.667,47,24,9,5,0.417,0.563,49,32,8,1
7611,22000416,Los Angeles Lakers,Denver Nuggets,105,122,227,17,Denver Nuggets,17,0.214,0.655,46,27,4,4,0.404,0.735,47,28,6,4
7612,22000417,Orlando Magic,Phoenix Suns,90,109,199,19,Phoenix Suns,19,0.171,0.818,48,13,4,6,0.324,0.938,59,24,6,2
7613,22000418,Memphis Grizzlies,Sacramento Kings,124,110,234,14,Memphis Grizzlies,14,0.429,0.789,43,31,10,2,0.242,0.769,33,22,8,5
7614,22000419,Cleveland Cavaliers,Los Angeles Clippers,111,128,239,17,Los Angeles Clippers,17,0.28,0.72,40,25,4,4,0.433,0.861,47,31,8,5
7615,22000420,Chicago Bulls,Indiana Pacers,120,112,232,8,Chicago Bulls,8,0.394,0.864,60,25,6,2,0.273,0.806,47,18,9,14
7616,22000421,Houston Rockets,Washington Wizards,119,131,250,12,Washington Wizards,12,0.216,0.735,41,23,9,5,0.4,0.742,47,25,14,2
7617,22000422,Atlanta Hawks,New York Knicks,112,123,235,11,New York Knicks,11,0.333,0.906,42,17,5,6,0.5,0.815,42,22,5,6
7618,22000423,Philadelphia 76ers,Utah Jazz,123,134,257,11,Utah Jazz,11,0.348,0.875,42,19,6,4,0.4,0.839,36,18,9,4
7619,22000424,Cleveland Cavaliers,Golden State Warriors,98,129,227,31,Golden State Warriors,31,0.267,0.8,49,19,10,3,0.459,0.952,39,34,9,10
7620,22000425,Miami Heat,Los Angeles Clippers,118,125,243,7,Los Angeles Clippers,7,0.222,0.818,39,27,7,6,0.469,0.8,39,31,5,0
7621,22000426,Brooklyn Nets,Sacramento Kings,136,125,261,11,Brooklyn Nets,11,0.574,0.583,35,31,7,4,0.364,0.846,41,24,6,6
7622,22000427,Denver Nuggets,Boston Celtics,99,112,211,13,Boston Celtics,13,0.265,0.933,38,25,12,3,0.357,0.905,43,26,7,1
7623,22000428,San Antonio Spurs,Detroit Pistons,109,99,208,10,San Antonio Spurs,10,0.48,0.6,45,29,3,9,0.28,0.56,34,22,9,5
7624,22000429,New Orleans Pelicans,Memphis Grizzlies,144,113,257,31,New Orleans Pelicans,31,0.5,0.765,47,33,14,4,0.419,0.889,32,23,10,0
7625,22000430,Toronto Raptors,Milwaukee Bucks,124,113,237,11,Toronto Raptors,11,0.395,0.714,44,25,8,6,0.378,0.76,41,25,10,5
7626,22000431,Los Angeles Lakers,Minnesota Timberwolves,112,104,216,8,Los Angeles Lakers,8,0.423,0.81,38,20,8,8,0.471,0.769,38,26,11,4
7627,22000432,Portland Trail Blazers,Oklahoma City Thunder,115,104,219,11,Portland Trail Blazers,11,0.426,0.647,54,26,6,8,0.303,0.741,46,23,6,3
7628,22000433,Brooklyn Nets,Phoenix Suns,128,124,252,4,Brooklyn Nets,4,0.5,0.933,37,28,4,4,0.432,1,34,28,7,3
7629,22000435,San Antonio Spurs,Cleveland Cavaliers,116,110,226,6,San Antonio Spurs,6,0.389,0.818,51,19,5,4,0.259,0.781,47,19,8,4
7630,22000436,New York Knicks,Orlando Magic,89,107,196,18,Orlando Magic,18,0.259,0.842,46,16,7,5,0.471,0.7,50,27,10,7
7631,22000437,Denver Nuggets,Washington Wizards,128,130,258,2,Washington Wizards,2,0.447,0.833,42,23,7,7,0.455,0.794,45,31,7,3
7632,22000438,Atlanta Hawks,Boston Celtics,122,114,236,8,Atlanta Hawks,8,0.333,0.839,37,19,8,2,0.323,0.889,37,22,9,3
7633,22000439,Houston Rockets,Philadelphia 76ers,113,118,231,5,Philadelphia 76ers,5,0.319,0.778,39,26,13,6,0.462,0.875,47,23,12,6
7634,22000440,Indiana Pacers,Minnesota Timberwolves,134,128,262,6,Indiana Pacers,6,0.5,0.852,51,31,5,7,0.375,0.92,44,37,12,8
7635,22000441,Portland Trail Blazers,New Orleans Pelicans,126,124,250,2,Portland Trail Blazers,2,0.439,0.889,31,26,6,7,0.469,0.793,51,25,5,1
7636,22000443,Miami Heat,Golden State Warriors,112,120,232,8,Golden State Warriors,8,0.361,0.917,49,28,8,5,0.346,0.762,46,32,10,1
7637,22000444,Utah Jazz,Los Angeles Clippers,114,96,210,18,Utah Jazz,18,0.325,0.85,53,19,12,3,0.346,0.647,47,18,5,2
7638,22000445,Toronto Raptors,Milwaukee Bucks,110,96,206,14,Toronto Raptors,14,0.343,0.957,37,26,6,6,0.294,0.696,52,23,6,2
7639,22000446,Brooklyn Nets,Los Angeles Lakers,109,98,207,11,Brooklyn Nets,11,0.462,0.625,39,23,9,3,0.267,0.714,39,21,7,4
7640,22000447,Miami Heat,Sacramento Kings,118,110,228,8,Miami Heat,8,0.353,0.8,45,36,8,2,0.366,0.563,44,29,7,3
7641,22000449,Golden State Warriors,Orlando Magic,120,124,244,4,Orlando Magic,4,0.452,0.6,45,37,8,0,0.419,0.824,51,30,7,8
7642,22000450,Chicago Bulls,Philadelphia 76ers,105,112,217,7,Philadelphia 76ers,7,0.219,1,42,24,5,6,0.333,0.793,53,23,5,7
7643,22000451,Atlanta Hawks,Boston Celtics,109,121,230,12,Boston Celtics,12,0.333,0.92,41,21,14,6,0.4,0.7,44,26,8,12
7644,22000452,Detroit Pistons,Memphis Grizzlies,95,109,204,14,Memphis Grizzlies,14,0.311,0.692,45,27,8,7,0.25,0.87,49,20,12,4
7645,22000453,Oklahoma City Thunder,Milwaukee Bucks,85,98,183,13,Milwaukee Bucks,13,0.3,0.524,46,20,4,5,0.324,0.68,61,23,5,6
7646,22000454,Toronto Raptors,Minnesota Timberwolves,86,81,167,5,Toronto Raptors,5,0.3,0.818,51,16,8,6,0.237,0.727,43,24,6,9
7647,22000455,Phoenix Suns,New Orleans Pelicans,132,114,246,18,Phoenix Suns,18,0.564,0.667,37,38,8,4,0.344,0.792,37,28,11,3
7648,22000456,Dallas Mavericks,Houston Rockets,93,102,195,9,Houston Rockets,9,0.256,0.773,46,16,4,5,0.386,0.563,49,21,7,5
7649,22000457,Utah Jazz,Los Angeles Clippers,112,116,228,4,Los Angeles Clippers,4,0.353,0.857,38,13,7,6,0.333,0.909,45,22,5,4
7650,22000459,Golden State Warriors,Charlotte Hornets,100,102,202,2,Charlotte Hornets,2,0.333,0.765,39,23,10,3,0.5,0.889,44,23,7,2
7651,22000460,Sacramento Kings,Chicago Bulls,114,122,236,8,Chicago Bulls,8,0.276,0.818,41,22,8,3,0.478,0.867,38,24,5,8
7652,22000461,Indiana Pacers,Houston Rockets,132,124,256,8,Indiana Pacers,8,0.417,0.773,48,28,10,6,0.294,0.818,47,22,12,6
7653,22000462,Phoenix Suns,Memphis Grizzlies,128,97,225,31,Phoenix Suns,31,0.522,0.923,41,35,5,7,0.152,0.87,49,19,5,4
7654,22000463,Miami Heat,Los Angeles Lakers,96,94,190,2,Miami Heat,2,0.286,0.696,49,24,8,3,0.289,0.882,43,25,5,6
7655,22000464,Washington Wizards,Portland Trail Blazers,118,111,229,7,Washington Wizards,7,0.231,0.759,54,23,8,3,0.345,0.72,50,19,10,7
7656,22000465,Boston Celtics,New Orleans Pelicans,115,120,235,5,New Orleans Pelicans,5,0.27,0.794,49,22,9,11,0.306,0.676,52,22,5,7
7657,22000466,Oklahoma City Thunder,Cleveland Cavaliers,117,101,218,16,Oklahoma City Thunder,16,0.464,0.75,37,22,9,3,0.229,0.75,42,22,9,4
7658,22000467,Detroit Pistons,Orlando Magic,96,105,201,9,Orlando Magic,9,0.275,0.81,49,23,10,4,0.3,0.897,51,24,7,8
7659,22000468,Philadelphia 76ers,Toronto Raptors,103,110,213,7,Toronto Raptors,7,0.297,0.743,45,26,8,7,0.412,0.889,39,25,5,5
7660,22000469,Minnesota Timberwolves,New York Knicks,99,103,202,4,New York Knicks,4,0.457,0.81,43,24,6,3,0.333,0.816,48,17,4,4
7661,22000470,Denver Nuggets,Atlanta Hawks,115,123,238,8,Atlanta Hawks,8,0.444,0.813,33,25,8,3,0.353,0.818,44,29,6,4
7662,22000471,Sacramento Kings,Milwaukee Bucks,115,128,243,13,Milwaukee Bucks,13,0.364,0.75,43,29,6,3,0.393,0.806,56,22,8,5
7663,22000472,Brooklyn Nets,Los Angeles Clippers,112,108,220,4,Brooklyn Nets,4,0.289,0.684,40,21,10,4,0.429,0.722,52,24,3,4
7664,22000474,Chicago Bulls,Houston Rockets,120,100,220,20,Chicago Bulls,20,0.417,0.7,55,24,5,5,0.325,0.684,46,20,7,4
7665,22000475,Miami Heat,Oklahoma City Thunder,108,94,202,14,Miami Heat,14,0.375,0.84,45,30,7,6,0.359,0.842,38,20,6,1
7666,22000476,Memphis Grizzlies,Dallas Mavericks,92,102,194,10,Dallas Mavericks,10,0.194,0.632,51,17,7,1,0.366,0.654,49,17,6,4
7667,22000477,Portland Trail Blazers,Phoenix Suns,100,132,232,32,Phoenix Suns,32,0.308,0.737,46,15,6,6,0.485,0.889,43,29,6,5
7668,22000478,Charlotte Hornets,Utah Jazz,110,132,242,22,Utah Jazz,22,0.306,0.81,35,18,13,2,0.509,0.824,45,34,7,7
7669,22000479,Washington Wizards,Los Angeles Lakers,127,124,251,3,Washington Wizards,3,0.36,0.727,49,25,9,4,0.341,0.647,45,29,9,11
7670,22000480,Atlanta Hawks,Cleveland Cavaliers,111,112,223,1,Cleveland Cavaliers,1,0.452,0.739,41,22,10,4,0.536,0.789,36,28,7,10
7671,22000481,Detroit Pistons,Orlando Magic,105,93,198,12,Detroit Pistons,12,0.294,0.813,49,24,10,9,0.368,0.591,48,25,9,6
7672,22000482,Sacramento Kings,Brooklyn Nets,118,127,245,9,Brooklyn Nets,9,0.484,0.684,38,25,6,7,0.425,0.71,41,30,8,5
7673,22000483,Golden State Warriors,New York Knicks,114,106,220,8,Golden State Warriors,8,0.342,0.875,41,30,9,8,0.379,0.864,56,22,4,5
7674,22000484,Philadelphia 76ers,Toronto Raptors,109,102,211,7,Philadelphia 76ers,7,0.447,0.867,54,24,5,8,0.297,0.846,38,29,12,11
7675,22000485,Boston Celtics,Dallas Mavericks,107,110,217,3,Dallas Mavericks,3,0.308,0.722,46,19,6,6,0.394,0.867,38,19,5,1
7676,22000486,Minnesota Timberwolves,Milwaukee Bucks,112,139,251,27,Milwaukee Bucks,27,0.352,1,43,35,4,5,0.476,0.722,52,33,11,5
7677,22000487,Portland Trail Blazers,Denver Nuggets,106,111,217,5,Denver Nuggets,5,0.341,1,47,21,0,7,0.389,0.944,40,25,8,3
7678,22000488,Washington Wizards,Los Angeles Clippers,116,135,251,19,Los Angeles Clippers,19,0.55,0.688,36,32,5,1,0.5,0.615,46,26,7,5
7679,22000489,Golden State Warriors,Indiana Pacers,111,107,218,4,Golden State Warriors,4,0.192,0.903,41,27,10,4,0.241,0.813,39,20,11,6
7680,22000490,Boston Celtics,Atlanta Hawks,112,127,239,15,Atlanta Hawks,15,0.258,0.87,36,20,10,6,0.548,0.824,45,27,4,5
7681,22000491,Houston Rockets,Cleveland Cavaliers,96,112,208,16,Cleveland Cavaliers,16,0.303,0.824,33,18,8,8,0.444,0.667,55,24,4,10
7682,22000492,Toronto Raptors,Miami Heat,108,116,224,8,Miami Heat,8,0.455,0.824,32,30,5,3,0.447,0.862,42,31,6,4
7683,22000493,Minnesota Timberwolves,Chicago Bulls,126,133,259,7,Chicago Bulls,7,0.316,0.952,41,28,11,4,0.4,0.813,43,28,11,5
7684,22000494,Detroit Pistons,New Orleans Pelicans,118,128,246,10,New Orleans Pelicans,10,0.361,0.688,38,31,8,6,0.435,0.621,45,31,10,6
7685,22000495,San Antonio Spurs,Oklahoma City Thunder,99,102,201,3,Oklahoma City Thunder,3,0.36,0.667,44,20,10,4,0.409,0.909,52,21,6,4
7686,22000496,Charlotte Hornets,Phoenix Suns,124,121,245,3,Charlotte Hornets,3,0.361,0.926,46,24,8,5,0.368,0.704,41,26,9,6
7687,22000497,Los Angeles Lakers,Utah Jazz,89,114,203,25,Utah Jazz,25,0.242,0.65,45,17,5,4,0.458,0.667,53,28,7,1
7688,22000498,Dallas Mavericks,Philadelphia 76ers,97,111,208,14,Philadelphia 76ers,14,0.382,0.87,50,17,2,9,0.414,0.84,39,26,11,6
7689,22000499,Orlando Magic,Brooklyn Nets,92,129,221,37,Brooklyn Nets,37,0.25,0.867,35,19,8,1,0.444,0.786,51,30,11,2
7690,22000500,Sacramento Kings,New York Knicks,121,140,261,19,New York Knicks,19,0.343,0.758,34,25,12,0,0.528,0.905,43,24,8,2
7691,22000501,Los Angeles Clippers,Memphis Grizzlies,94,122,216,28,Memphis Grizzlies,28,0.353,0.875,41,19,4,4,0.579,0.688,48,27,7,1
7692,22000502,Washington Wizards,Denver Nuggets,112,110,222,2,Washington Wizards,2,0.308,0.88,42,24,9,2,0.395,0.875,44,23,6,7
7693,22000503,New Orleans Pelicans,Milwaukee Bucks,125,129,254,4,Milwaukee Bucks,4,0.333,0.714,47,32,5,4,0.419,0.75,42,21,4,8
7694,22000504,Sacramento Kings,Detroit Pistons,110,107,217,3,Sacramento Kings,3,0.219,0.707,49,24,5,6,0.364,0.656,45,20,6,6
7695,22000505,Indiana Pacers,Boston Celtics,112,118,230,6,Boston Celtics,6,0.326,0.931,40,26,8,6,0.409,0.862,45,24,3,6
7696,22000506,Houston Rockets,Toronto Raptors,111,122,233,11,Toronto Raptors,11,0.34,0.85,37,23,4,5,0.39,0.963,48,29,6,8
7697,22000507,Utah Jazz,Miami Heat,116,124,240,8,Miami Heat,8,0.326,0.913,36,24,9,3,0.452,0.88,50,24,5,1
7698,22000508,Phoenix Suns,Chicago Bulls,106,97,203,9,Phoenix Suns,9,0.273,0.8,30,35,11,4,0.387,0.7,41,25,2,4
7699,22000509,Los Angeles Clippers,Memphis Grizzlies,119,99,218,20,Los Angeles Clippers,20,0.4,0.944,47,34,6,8,0.321,0.75,37,24,10,4
7700,22000510,Atlanta Hawks,Oklahoma City Thunder,109,118,227,9,Oklahoma City Thunder,9,0.3,0.647,54,21,6,5,0.381,0.625,39,31,6,2
7701,22000511,Charlotte Hornets,Golden State Warriors,121,130,251,9,Golden State Warriors,9,0.415,0.688,38,27,11,1,0.458,0.92,37,38,10,3
7702,22000512,Portland Trail Blazers,Los Angeles Lakers,93,102,195,9,Los Angeles Lakers,9,0.297,0.9,45,19,5,5,0.259,0.75,52,25,9,7
7703,22000513,Cleveland Cavaliers,Philadelphia 76ers,112,109,221,3,Cleveland Cavaliers,3,0.333,0.759,52,24,12,3,0.357,0.657,46,25,9,10
7704,22000514,New Orleans Pelicans,San Antonio Spurs,114,117,231,3,San Antonio Spurs,3,0.281,0.806,52,27,3,2,0.375,0.821,38,24,7,5
7705,22000515,Indiana Pacers,New York Knicks,107,110,217,3,New York Knicks,3,0.393,0.8,35,27,5,7,0.5,0.818,38,26,12,2
7706,22000516,Utah Jazz,Orlando Magic,124,109,233,15,Utah Jazz,15,0.378,0.708,52,29,2,3,0.412,0.875,37,27,6,3
7707,22000517,Minnesota Timberwolves,Washington Wizards,112,128,240,16,Washington Wizards,16,0.314,0.655,50,23,9,10,0.394,0.794,57,27,6,6
7708,22000518,Denver Nuggets,Oklahoma City Thunder,126,96,222,30,Denver Nuggets,30,0.484,0.813,49,30,6,3,0.234,0.733,37,24,7,6
7709,22000519,Dallas Mavericks,Brooklyn Nets,115,98,213,17,Dallas Mavericks,17,0.389,0.647,36,23,12,8,0.318,0.737,47,21,5,4
7710,22000520,Los Angeles Clippers,Milwaukee Bucks,100,105,205,5,Milwaukee Bucks,5,0.318,0.857,49,20,7,3,0.316,0.773,48,21,7,5
7711,22000521,New York Knicks,Detroit Pistons,109,90,199,19,New York Knicks,19,0.5,0.8,41,23,9,7,0.281,0.806,40,16,8,4
7712,22000522,Atlanta Hawks,Miami Heat,99,109,208,10,Miami Heat,10,0.229,0.864,49,22,12,6,0.297,0.909,45,27,8,6
7713,22000523,Chicago Bulls,Toronto Raptors,122,113,235,9,Chicago Bulls,9,0.4,0.889,49,35,5,3,0.324,0.818,41,19,10,4
7714,22000524,Washington Wizards,Boston Celtics,110,111,221,1,Boston Celtics,1,0.281,0.862,36,16,10,5,0.333,0.708,49,25,7,0
7715,22000525,Memphis Grizzlies,Houston Rockets,133,84,217,49,Memphis Grizzlies,49,0.333,0.821,56,27,16,3,0.089,0.829,38,10,7,6
7716,22000526,Phoenix Suns,Minnesota Timberwolves,118,99,217,19,Phoenix Suns,19,0.259,0.958,47,27,7,5,0.229,0.875,44,21,12,4
7717,22000527,Golden State Warriors,Los Angeles Lakers,91,117,208,26,Los Angeles Lakers,26,0.235,0.684,35,26,10,4,0.355,0.684,60,22,14,6
7718,22000528,Charlotte Hornets,Sacramento Kings,127,126,253,1,Charlotte Hornets,1,0.367,0.963,37,30,3,6,0.444,0.588,33,32,6,2
7719,22000529,Dallas Mavericks,Orlando Magic,130,124,254,6,Dallas Mavericks,6,0.37,0.826,46,29,6,6,0.488,0.714,41,25,5,1
7720,22000530,Indiana Pacers,Philadelphia 76ers,114,130,244,16,Philadelphia 76ers,16,0.276,0.857,34,27,8,1,0.429,0.938,39,27,10,6
7721,22000531,Denver Nuggets,Chicago Bulls,118,112,230,6,Denver Nuggets,6,0.37,0.8,50,22,4,6,0.316,0.727,44,25,7,3
7722,22000532,Cleveland Cavaliers,Houston Rockets,101,90,191,11,Cleveland Cavaliers,11,0.333,0.792,48,23,7,6,0.323,0.75,30,13,13,4
7723,22000533,Utah Jazz,New Orleans Pelicans,124,129,253,5,New Orleans Pelicans,5,0.395,0.833,39,26,11,7,0.636,0.783,53,27,5,5
7724,22000534,Brooklyn Nets,San Antonio Spurs,124,113,237,11,Brooklyn Nets,11,0.415,0.765,51,35,6,8,0.429,0.667,48,30,2,3
7725,22000535,Charlotte Hornets,Portland Trail Blazers,111,123,234,12,Portland Trail Blazers,12,0.441,0.588,37,25,12,5,0.522,0.7,38,26,12,7
7726,22000536,Memphis Grizzlies,Washington Wizards,125,111,236,14,Memphis Grizzlies,14,0.448,0.783,44,26,15,1,0.355,0.72,37,29,8,3
7727,22000537,Los Angeles Clippers,Boston Celtics,112,117,229,5,Boston Celtics,5,0.474,0.889,35,28,3,5,0.5,0.739,43,25,6,4
7728,22000538,Atlanta Hawks,Miami Heat,94,80,174,14,Atlanta Hawks,14,0.361,0.867,47,26,5,2,0.273,0.682,26,15,16,4
7729,22000539,Detroit Pistons,Toronto Raptors,129,105,234,24,Detroit Pistons,24,0.488,0.619,49,39,11,4,0.333,0.833,34,17,6,5
7730,22000540,Denver Nuggets,Milwaukee Bucks,128,97,225,31,Denver Nuggets,31,0.367,0.917,45,28,10,3,0.275,0.71,40,22,4,4
7731,22000541,New York Knicks,San Antonio Spurs,93,119,212,26,San Antonio Spurs,26,0.417,0.8,41,18,2,5,0.429,0.714,45,31,12,4
7732,22000542,Phoenix Suns,Los Angeles Lakers,114,104,218,10,Phoenix Suns,10,0.552,0.88,35,30,5,7,0.355,0.765,34,18,6,8
7733,22000543,Indiana Pacers,Cleveland Cavaliers,114,111,225,3,Indiana Pacers,3,0.32,0.75,27,27,18,8,0.393,0.933,43,29,8,1
7734,22000544,Atlanta Hawks,Orlando Magic,115,112,227,3,Atlanta Hawks,3,0.467,0.947,42,26,7,5,0.371,1,46,24,6,5
7735,22000545,Utah Jazz,Philadelphia 76ers,123,131,254,8,Philadelphia 76ers,8,0.477,0.737,52,22,7,1,0.32,0.771,50,22,9,6
7736,22000546,Brooklyn Nets,Houston Rockets,132,114,246,18,Brooklyn Nets,18,0.486,0.708,53,33,5,1,0.419,0.714,37,24,10,5
7737,22000547,Charlotte Hornets,Minnesota Timberwolves,135,102,237,33,Charlotte Hornets,33,0.436,0.762,54,33,14,7,0.225,0.833,45,25,11,2
7738,22000548,Chicago Bulls,New Orleans Pelicans,128,124,252,4,Chicago Bulls,4,0.429,0.909,45,28,6,8,0.273,0.684,35,29,10,6
7739,22000549,Oklahoma City Thunder,Dallas Mavericks,78,87,165,9,Dallas Mavericks,9,0.231,0.647,45,13,6,4,0.2,0.789,53,18,8,3
7740,22000550,Golden State Warriors,Portland Trail Blazers,106,108,214,2,Portland Trail Blazers,2,0.357,0.643,54,27,8,1,0.286,0.846,47,15,5,4
7741,22000551,Los Angeles Lakers,Sacramento Kings,120,123,243,3,Sacramento Kings,3,0.444,0.714,41,27,7,3,0.48,0.789,30,32,5,1
7742,22000552,Toronto Raptors,Boston Celtics,125,132,257,7,Boston Celtics,7,0.42,0.824,28,36,6,1,0.448,0.725,39,25,6,7
7743,22000553,Denver Nuggets,Indiana Pacers,113,103,216,10,Denver Nuggets,10,0.429,0.688,41,27,6,5,0.359,0.583,34,27,12,3
7744,22000554,Los Angeles Clippers,Washington Wizards,117,119,236,2,Washington Wizards,2,0.457,0.926,45,24,4,4,0.391,0.714,41,20,12,3
7745,22000555,Milwaukee Bucks,Memphis Grizzlies,112,111,223,1,Milwaukee Bucks,1,0.294,0.818,52,21,11,5,0.235,0.958,56,21,13,8
7746,22000556,Oklahoma City Thunder,San Antonio Spurs,107,102,209,5,Oklahoma City Thunder,5,0.3,0.808,45,20,9,4,0.323,1,46,23,9,5
7747,22000557,Miami Heat,New Orleans Pelicans,103,93,196,10,Miami Heat,10,0.333,0.84,41,27,6,3,0.256,0.8,44,28,5,3
7748,22000558,Sacramento Kings,Portland Trail Blazers,119,123,242,4,Portland Trail Blazers,4,0.379,0.625,51,25,3,3,0.395,0.96,41,20,6,7
7749,22000559,Portland Trail Blazers,Washington Wizards,132,121,253,11,Portland Trail Blazers,11,0.457,1,44,19,6,1,0.4,0.765,39,32,2,5
7750,22000560,Boston Celtics,Washington Wizards,91,104,195,13,Washington Wizards,13,0.257,0.6,50,14,5,2,0.233,0.861,54,24,9,3
7751,22000561,New Orleans Pelicans,Detroit Pistons,112,123,235,11,Detroit Pistons,11,0.257,0.821,44,23,5,2,0.486,0.8,37,34,3,8
7752,22000562,Oklahoma City Thunder,Memphis Grizzlies,113,122,235,9,Memphis Grizzlies,9,0.463,0.857,39,25,5,3,0.462,0.788,44,31,14,4
7753,22000563,Denver Nuggets,Cleveland Cavaliers,120,103,223,17,Denver Nuggets,17,0.484,0.765,37,24,9,2,0.387,0.619,34,30,8,4
7754,22000564,Detroit Pistons,Chicago Bulls,102,105,207,3,Chicago Bulls,3,0.286,0.833,40,15,9,2,0.286,0.625,46,29,8,7
7755,22000565,Detroit Pistons,New York Knicks,104,114,218,10,New York Knicks,10,0.389,0.8,29,23,6,2,0.333,0.789,47,25,10,4
7756,22000566,Washington Wizards,Memphis Grizzlies,112,127,239,15,Memphis Grizzlies,15,0.306,0.926,39,23,9,6,0.348,0.655,60,31,4,6
7757,22000567,San Antonio Spurs,Dallas Mavericks,104,115,219,11,Dallas Mavericks,11,0.429,0.8,30,18,10,2,0.325,0.842,51,29,3,1
7758,22000568,Detroit Pistons,Charlotte Hornets,102,105,207,3,Charlotte Hornets,3,0.326,0.786,50,27,6,5,0.333,0.958,45,26,9,3
7759,22000569,Boston Celtics,Brooklyn Nets,109,121,230,12,Brooklyn Nets,12,0.325,0.636,39,22,10,10,0.452,0.818,45,21,3,5
7760,22000570,Atlanta Hawks,Toronto Raptors,121,120,241,1,Atlanta Hawks,1,0.357,0.8,53,20,8,13,0.459,0.826,50,23,8,4
7761,22000571,Orlando Magic,Miami Heat,103,111,214,8,Miami Heat,8,0.353,0.867,57,22,6,4,0.327,0.591,44,27,8,4
7762,22000572,Philadelphia 76ers,Chicago Bulls,127,105,232,22,Philadelphia 76ers,22,0.303,0.733,45,25,11,7,0.483,0.813,38,26,3,6
7763,22000573,New York Knicks,Milwaukee Bucks,101,134,235,33,Milwaukee Bucks,33,0.351,0.667,38,19,3,5,0.474,0.941,43,29,9,9
7764,22000574,Minnesota Timberwolves,New Orleans Pelicans,135,105,240,30,Minnesota Timberwolves,30,0.475,0.875,38,28,11,10,0.188,0.542,51,28,7,6
7765,22000575,Dallas Mavericks,Oklahoma City Thunder,108,116,224,8,Oklahoma City Thunder,8,0.441,0.697,37,20,4,9,0.5,0.9,55,25,2,6
7766,22000576,Golden State Warriors,Los Angeles Clippers,104,130,234,26,Los Angeles Clippers,26,0.25,0.704,44,20,6,6,0.439,0.828,56,23,10,6
7767,22000577,Phoenix Suns,Portland Trail Blazers,127,121,248,6,Phoenix Suns,6,0.542,0.842,38,28,6,1,0.419,0.895,41,26,8,2
7768,22000578,Houston Rockets,Sacramento Kings,105,125,230,20,Sacramento Kings,20,0.244,0.706,44,24,7,6,0.333,0.857,53,25,11,5
7769,22000579,Philadelphia 76ers,Washington Wizards,127,101,228,26,Philadelphia 76ers,26,0.524,1,49,26,13,6,0.333,0.591,32,19,10,2
7770,22000580,Denver Nuggets,Memphis Grizzlies,103,102,205,1,Denver Nuggets,1,0.351,0.727,45,27,10,5,0.5,1,45,27,6,5
7771,22000581,Cleveland Cavaliers,New Orleans Pelicans,82,116,198,34,New Orleans Pelicans,34,0.219,0.75,33,13,8,9,0.25,0.842,70,25,2,7
7772,22000582,Miami Heat,Chicago Bulls,101,90,191,11,Miami Heat,11,0.343,0.75,41,26,11,6,0.395,1,50,25,5,3
7773,22000583,Orlando Magic,San Antonio Spurs,77,104,181,27,San Antonio Spurs,27,0.263,0.75,46,17,3,4,0.345,0.778,45,24,8,5
7774,22000584,Houston Rockets,Utah Jazz,99,114,213,15,Utah Jazz,15,0.209,0.615,50,15,11,5,0.375,0.84,51,24,7,10
7775,22000585,Indiana Pacers,Los Angeles Lakers,100,105,205,5,Los Angeles Lakers,5,0.222,0.857,44,22,7,4,0.318,0.769,44,20,10,5
7776,22000586,New York Knicks,Oklahoma City Thunder,119,97,216,22,New York Knicks,22,0.4,0.773,44,23,12,2,0.25,0.714,40,22,3,4
7777,22000587,Detroit Pistons,Brooklyn Nets,95,100,195,5,Brooklyn Nets,5,0.25,0.75,46,26,10,8,0.222,0.727,35,22,8,7
7778,22000588,Toronto Raptors,Charlotte Hornets,104,114,218,10,Charlotte Hornets,10,0.326,0.833,47,25,10,6,0.429,0.789,51,30,10,6
7779,22000589,Milwaukee Bucks,Washington Wizards,125,119,244,6,Milwaukee Bucks,6,0.378,0.88,57,33,9,3,0.39,0.773,41,25,9,2
7780,22000590,Sacramento Kings,Atlanta Hawks,106,121,227,15,Atlanta Hawks,15,0.194,0.813,47,27,5,1,0.364,0.697,45,21,6,2
7781,22000591,Portland Trail Blazers,Minnesota Timberwolves,125,121,246,4,Portland Trail Blazers,4,0.325,0.867,34,26,6,5,0.385,0.742,56,23,5,7
7782,22000592,Dallas Mavericks,Denver Nuggets,116,103,219,13,Dallas Mavericks,13,0.391,0.875,48,26,5,3,0.39,0.722,42,27,5,1
7783,22000593,Memphis Grizzlies,Oklahoma City Thunder,122,128,250,6,Oklahoma City Thunder,6,0.318,0.724,32,27,13,3,0.516,0.824,46,26,7,4
7784,22000594,Utah Jazz,Golden State Warriors,119,131,250,12,Golden State Warriors,12,0.341,0.759,51,24,6,6,0.516,0.833,40,33,12,2
7785,22000595,San Antonio Spurs,Philadelphia 76ers,99,134,233,35,Philadelphia 76ers,35,0.19,0.742,32,20,8,10,0.517,0.636,54,35,7,7
7786,22000596,Miami Heat,Orlando Magic,102,97,199,5,Miami Heat,5,0.28,0.933,43,28,15,6,0.4,0.714,45,25,4,1
7787,22000597,Cleveland Cavaliers,Atlanta Hawks,82,100,182,18,Atlanta Hawks,18,0.267,0.522,34,19,4,5,0.414,0.923,49,21,4,6
7788,22000598,Boston Celtics,Houston Rockets,134,107,241,27,Boston Celtics,27,0.486,0.667,55,29,8,3,0.32,0.677,37,23,8,5
7789,22000599,Portland Trail Blazers,Minnesota Timberwolves,112,114,226,2,Minnesota Timberwolves,2,0.378,0.81,42,22,6,3,0.342,0.744,45,24,6,4
7790,22000600,Toronto Raptors,Chicago Bulls,95,118,213,23,Chicago Bulls,23,0.267,0.714,38,23,5,7,0.273,0.783,60,35,6,7
7791,22000601,Los Angeles Clippers,New Orleans Pelicans,115,135,250,20,New Orleans Pelicans,20,0.349,0.842,32,23,12,2,0.462,0.81,40,38,8,1
7792,22000602,Sacramento Kings,Charlotte Hornets,116,122,238,6,Charlotte Hornets,6,0.29,0.647,44,28,7,6,0.4,0.8,46,30,7,3
7793,22000603,Milwaukee Bucks,Washington Wizards,133,122,255,11,Milwaukee Bucks,11,0.393,0.947,46,29,6,5,0.421,0.75,33,34,5,1
7794,22000604,New York Knicks,Brooklyn Nets,112,117,229,5,Brooklyn Nets,5,0.357,0.852,40,16,9,2,0.414,0.773,41,29,3,6
7795,22000605,Los Angeles Clippers,Dallas Mavericks,109,99,208,10,Los Angeles Clippers,10,0.438,0.818,46,23,10,0,0.415,0.8,33,24,8,4
7796,22000606,Indiana Pacers,Denver Nuggets,106,121,227,15,Denver Nuggets,15,0.405,0.846,39,28,8,9,0.536,0.842,54,32,7,7
7797,22000607,Memphis Grizzlies,Phoenix Suns,99,122,221,23,Phoenix Suns,23,0.217,0.692,39,15,11,0,0.4,0.889,42,28,7,5
7798,22000608,Los Angeles Lakers,Golden State Warriors,128,97,225,31,Los Angeles Lakers,31,0.407,0.76,46,36,9,3,0.351,0.667,30,24,9,2
7799,22000609,Utah Jazz,Boston Celtics,117,109,226,8,Utah Jazz,8,0.442,0.917,38,23,6,6,0.345,0.75,45,28,8,5
7800,22000610,Cleveland Cavaliers,Miami Heat,98,113,211,15,Miami Heat,15,0.286,0.714,42,23,7,6,0.37,0.905,48,30,11,5
7801,22000611,New York Knicks,Philadelphia 76ers,96,99,195,3,Philadelphia 76ers,3,0.333,0.636,47,19,7,5,0.344,0.737,50,19,8,10
7802,22000612,Oklahoma City Thunder,Chicago Bulls,102,123,225,21,Chicago Bulls,21,0.35,0.846,43,16,9,9,0.333,0.833,42,24,8,4
7803,22000613,Atlanta Hawks,Houston Rockets,119,107,226,12,Atlanta Hawks,12,0.459,0.875,38,32,8,6,0.382,0.769,37,27,6,6
7804,22000614,New Orleans Pelicans,Portland Trail Blazers,124,125,249,1,Portland Trail Blazers,1,0.485,0.8,41,38,8,3,0.419,1,32,20,8,8
7805,22000615,Minnesota Timberwolves,Los Angeles Lakers,121,137,258,16,Los Angeles Lakers,16,0.314,0.727,34,28,9,6,0.5,0.857,43,37,3,3
7806,22000616,Toronto Raptors,Detroit Pistons,112,116,228,4,Detroit Pistons,4,0.3,0.765,30,27,7,6,0.414,0.875,54,23,8,5
7807,22000617,Brooklyn Nets,Indiana Pacers,124,115,239,9,Brooklyn Nets,9,0.333,0.775,50,22,10,2,0.281,0.8,34,29,10,3
7808,22000618,Milwaukee Bucks,Philadelphia 76ers,109,105,214,4,Milwaukee Bucks,4,0.231,0.75,58,22,11,1,0.341,0.625,59,28,14,7
7809,22000619,Sacramento Kings,Washington Wizards,121,119,240,2,Sacramento Kings,2,0.303,0.829,38,25,10,4,0.16,0.821,52,25,5,2
7810,22000620,Boston Celtics,Cleveland Cavaliers,110,117,227,7,Cleveland Cavaliers,7,0.263,0.69,40,19,10,9,0.435,0.818,40,23,6,3
7811,22000621,San Antonio Spurs,Chicago Bulls,106,99,205,7,San Antonio Spurs,7,0.258,0.733,46,19,5,6,0.333,0.889,51,24,6,3
7812,22000622,Golden State Warriors,Houston Rockets,108,94,202,14,Golden State Warriors,14,0.356,0.833,48,32,7,4,0.259,0.525,48,19,7,3
7813,22000623,Miami Heat,Memphis Grizzlies,85,89,174,4,Memphis Grizzlies,4,0.235,0.722,51,17,4,2,0.238,0.76,50,22,5,4
7814,22000624,Charlotte Hornets,Denver Nuggets,104,129,233,25,Denver Nuggets,25,0.316,0.714,33,25,11,1,0.364,0.692,48,37,12,3
7815,22000625,Los Angeles Clippers,Dallas Mavericks,89,105,194,16,Dallas Mavericks,16,0.281,0.545,37,22,12,3,0.441,0.833,43,14,7,7
7816,22000626,Oklahoma City Thunder,Atlanta Hawks,93,116,209,23,Atlanta Hawks,23,0.382,0.75,38,18,5,3,0.333,0.846,50,26,6,7
7817,22000627,Orlando Magic,New York Knicks,93,94,187,1,New York Knicks,1,0.294,0.813,49,21,6,6,0.412,0.545,43,24,6,4
7818,22000628,Minnesota Timberwolves,Phoenix Suns,123,119,242,4,Minnesota Timberwolves,4,0.324,0.686,38,22,14,4,0.417,0.737,47,29,6,6
7819,22000629,New Orleans Pelicans,Portland Trail Blazers,93,101,194,8,Portland Trail Blazers,8,0.27,0.68,44,24,6,5,0.326,0.84,50,11,8,8
7820,22000630,Charlotte Hornets,Los Angeles Lakers,105,116,221,11,Los Angeles Lakers,11,0.379,0.6,44,26,7,8,0.333,0.75,48,23,7,6
7821,22000631,Sacramento Kings,Boston Celtics,107,96,203,11,Sacramento Kings,11,0.4,0.808,45,22,6,9,0.387,0.857,45,22,8,4
7822,22000632,Indiana Pacers,Miami Heat,137,110,247,27,Indiana Pacers,27,0.556,0.684,47,38,7,9,0.265,0.95,36,22,10,4
7823,22000633,Brooklyn Nets,Orlando Magic,113,121,234,8,Orlando Magic,8,0.27,0.739,39,24,9,3,0.525,0.7,44,26,4,1
7824,22000634,Utah Jazz,Toronto Raptors,115,112,227,3,Utah Jazz,3,0.324,0.854,48,21,7,5,0.477,0.786,31,31,9,4
7825,22000635,Detroit Pistons,Houston Rockets,113,100,213,13,Detroit Pistons,13,0.483,0.893,49,28,7,4,0.281,0.813,38,21,7,4
7826,22000636,Golden State Warriors,Memphis Grizzlies,116,103,219,13,Golden State Warriors,13,0.366,0.722,43,31,13,6,0.308,0.81,46,24,10,6
7827,22000637,Chicago Bulls,Denver Nuggets,127,131,258,4,Denver Nuggets,4,0.486,0.696,42,32,6,2,0.412,0.778,43,29,10,3
7828,22000638,Minnesota Timberwolves,Phoenix Suns,101,113,214,12,Phoenix Suns,12,0.371,0.778,39,22,8,6,0.519,0.765,40,29,8,1
7829,22000639,Dallas Mavericks,Portland Trail Blazers,119,125,244,6,Portland Trail Blazers,6,0.452,0.923,39,25,4,4,0.468,0.882,43,17,5,0
7830,22000640,Atlanta Hawks,Los Angeles Lakers,99,94,193,5,Atlanta Hawks,5,0.351,0.889,49,26,13,7,0.308,0.75,52,18,6,3
7831,22000641,Sacramento Kings,Philadelphia 76ers,105,129,234,24,Philadelphia 76ers,24,0.357,0.63,33,28,4,2,0.478,0.759,52,24,7,3
7832,22000642,Golden State Warriors,Memphis Grizzlies,103,111,214,8,Memphis Grizzlies,8,0.317,0.824,46,23,8,7,0.313,0.871,60,25,8,5
7833,22000643,San Antonio Spurs,Milwaukee Bucks,113,120,233,7,Milwaukee Bucks,7,0.364,0.9,41,29,6,4,0.368,0.889,49,24,5,3
7834,22000644,Charlotte Hornets,Los Angeles Clippers,98,125,223,27,Los Angeles Clippers,27,0.366,0.75,39,25,5,4,0.353,1,42,26,9,1
7835,22000645,Indiana Pacers,Miami Heat,109,106,215,3,Indiana Pacers,3,0.333,0.9,50,27,8,10,0.243,0.826,51,27,7,7
7836,22000646,New Orleans Pelicans,Denver Nuggets,113,108,221,5,New Orleans Pelicans,5,0.286,0.767,45,26,8,7,0.353,0.8,37,30,9,5
7837,22000647,Washington Wizards,Brooklyn Nets,106,113,219,7,Brooklyn Nets,7,0.333,0.789,43,24,5,4,0.31,0.727,35,24,11,8
7838,22000648,Toronto Raptors,Cleveland Cavaliers,105,116,221,11,Cleveland Cavaliers,11,0.326,0.842,37,19,13,3,0.515,0.75,54,29,8,4
7839,22000649,Chicago Bulls,Detroit Pistons,100,86,186,14,Chicago Bulls,14,0.5,0.857,52,26,8,8,0.16,0.72,37,20,11,5
7840,22000650,Philadelphia 76ers,New York Knicks,101,100,201,1,Philadelphia 76ers,1,0.44,0.609,44,19,12,9,0.458,0.565,44,16,13,2
7841,22000651,Los Angeles Lakers,Phoenix Suns,94,111,205,17,Phoenix Suns,17,0.2,0.679,41,20,3,2,0.281,0.783,51,30,7,6
7842,22000652,Dallas Mavericks,Portland Trail Blazers,132,92,224,40,Dallas Mavericks,40,0.514,0.85,52,23,4,3,0.22,0.789,33,17,7,3
7843,22000653,Sacramento Kings,Cleveland Cavaliers,119,105,224,14,Sacramento Kings,14,0.433,0.667,49,26,6,7,0.235,0.826,39,22,13,4
7844,22000654,Oklahoma City Thunder,Minnesota Timberwolves,112,103,215,9,Oklahoma City Thunder,9,0.568,0.9,47,27,8,10,0.359,0.722,42,24,11,4
7845,22000655,Charlotte Hornets,San Antonio Spurs,100,97,197,3,Charlotte Hornets,3,0.375,0.87,40,27,5,7,0.344,0.824,38,17,5,9
7846,22000656,Utah Jazz,Chicago Bulls,120,95,215,25,Utah Jazz,25,0.436,0.867,46,25,9,10,0.231,0.917,49,21,5,3
7847,22000657,Toronto Raptors,Houston Rockets,99,117,216,18,Houston Rockets,18,0.25,0.789,44,19,6,5,0.389,0.808,47,28,7,7
7848,22000658,Boston Celtics,Memphis Grizzlies,126,132,258,6,Memphis Grizzlies,6,0.486,0.625,43,31,3,6,0.343,0.667,54,38,8,6
7849,22000659,Indiana Pacers,Milwaukee Bucks,113,140,253,27,Milwaukee Bucks,27,0.24,0.917,40,27,8,3,0.615,0.667,55,35,3,5
7850,22000660,Atlanta Hawks,Los Angeles Clippers,110,119,229,9,Los Angeles Clippers,9,0.353,0.75,48,21,3,3,0.447,0.9,44,26,4,7
7851,22000661,Denver Nuggets,Orlando Magic,110,99,209,11,Denver Nuggets,11,0.267,0.923,52,25,12,7,0.324,0.714,37,27,8,4
7852,22000662,Washington Wizards,New York Knicks,113,131,244,18,New York Knicks,18,0.391,0.8,38,25,5,5,0.533,0.875,42,23,6,8
7853,22000663,Los Angeles Lakers,New Orleans Pelicans,111,128,239,17,New Orleans Pelicans,17,0.486,0.7,34,25,10,4,0.345,0.923,53,28,9,3
7854,22000664,Phoenix Suns,Miami Heat,110,100,210,10,Phoenix Suns,10,0.324,0.889,39,29,5,6,0.361,0.882,50,23,3,4
7855,22000665,Philadelphia 76ers,Golden State Warriors,108,98,206,10,Philadelphia 76ers,10,0.292,0.657,51,15,5,4,0.32,0.692,38,22,5,7
7856,22000666,Brooklyn Nets,Portland Trail Blazers,116,112,228,4,Brooklyn Nets,4,0.3,0.778,47,25,5,2,0.345,0.913,44,25,4,5
7857,22000667,Detroit Pistons,Indiana Pacers,111,116,227,5,Indiana Pacers,5,0.393,0.632,41,29,8,9,0.441,0.786,37,25,7,8
7858,22000668,Denver Nuggets,Toronto Raptors,111,135,246,24,Toronto Raptors,24,0.326,0.833,46,25,5,2,0.5,0.913,45,31,3,6
7859,22000669,Boston Celtics,Milwaukee Bucks,119,121,240,2,Milwaukee Bucks,2,0.404,1,38,24,9,6,0.459,0.7,46,19,8,5
7860,22000670,Phoenix Suns,Orlando Magic,111,112,223,1,Orlando Magic,1,0.333,0.909,47,22,9,3,0.351,0.789,49,18,3,5
7861,22000671,Cleveland Cavaliers,Chicago Bulls,103,94,197,9,Cleveland Cavaliers,9,0.379,0.8,46,28,8,7,0.286,0.857,45,21,6,4
7862,22000672,Charlotte Hornets,Houston Rockets,122,97,219,25,Charlotte Hornets,25,0.474,0.759,50,27,4,3,0.327,0.682,39,24,6,2
7863,22000673,Dallas Mavericks,Minnesota Timberwolves,128,108,236,20,Dallas Mavericks,20,0.364,0.727,53,27,5,6,0.316,0.769,37,24,6,2
7864,22000674,Memphis Grizzlies,Oklahoma City Thunder,116,107,223,9,Memphis Grizzlies,9,0.367,0.846,56,19,12,10,0.286,0.647,44,26,13,8
7865,22000675,Los Angeles Clippers,San Antonio Spurs,134,101,235,33,Los Angeles Clippers,33,0.515,0.633,44,23,10,3,0.318,0.842,40,22,6,6
7866,22000676,Brooklyn Nets,Utah Jazz,88,118,206,30,Utah Jazz,30,0.2,0.733,48,19,9,1,0.418,0.929,56,24,6,6
7867,22000677,Atlanta Hawks,Sacramento Kings,108,110,218,2,Sacramento Kings,2,0.28,0.826,42,17,5,3,0.333,0.909,42,21,5,6
7868,22000678,Portland Trail Blazers,Miami Heat,125,122,247,3,Portland Trail Blazers,3,0.435,0.895,40,24,3,7,0.471,0.923,39,34,3,7
7869,22000679,Washington Wizards,New York Knicks,102,106,208,4,New York Knicks,4,0.308,0.606,46,26,8,9,0.25,0.738,55,14,12,4
7870,22000680,Los Angeles Clippers,San Antonio Spurs,98,85,183,13,Los Angeles Clippers,13,0.382,0.944,57,16,6,5,0.348,0.846,39,16,4,6
7871,22000681,Philadelphia 76ers,Los Angeles Lakers,109,101,210,8,Philadelphia 76ers,8,0.378,0.667,39,24,13,9,0.346,0.727,42,22,10,0
7872,22000682,Golden State Warriors,Sacramento Kings,119,141,260,22,Sacramento Kings,22,0.531,1,38,24,4,0,0.5,0.842,38,28,6,4
7873,22000683,Brooklyn Nets,Detroit Pistons,113,111,224,2,Brooklyn Nets,2,0.394,0.765,49,19,3,4,0.355,0.723,36,19,6,4
7874,22000684,Phoenix Suns,Toronto Raptors,104,100,204,4,Phoenix Suns,4,0.25,1,47,26,4,3,0.267,0.875,38,20,5,4
7875,22000685,Boston Celtics,Milwaukee Bucks,122,114,236,8,Boston Celtics,8,0.468,0.875,44,27,10,8,0.404,0.636,49,24,7,3
7876,22000686,Miami Heat,Charlotte Hornets,105,110,215,5,Charlotte Hornets,5,0.349,0.5,39,28,9,3,0.419,0.737,42,30,6,7
7877,22000687,Portland Trail Blazers,Orlando Magic,112,105,217,7,Portland Trail Blazers,7,0.45,0.667,46,21,7,9,0.444,0.529,40,29,7,5
7878,22000688,Houston Rockets,Minnesota Timberwolves,101,107,208,6,Minnesota Timberwolves,6,0.386,0.769,47,26,5,9,0.263,0.792,50,30,12,3
7879,22000689,Denver Nuggets,New Orleans Pelicans,113,108,221,5,Denver Nuggets,5,0.5,0.714,36,28,7,7,0.414,0.9,37,30,7,7
7880,22000690,Indiana Pacers,Dallas Mavericks,109,94,203,15,Indiana Pacers,15,0.426,0.722,49,26,9,10,0.229,0.571,51,17,4,4
7881,22000691,Memphis Grizzlies,Utah Jazz,114,117,231,3,Utah Jazz,3,0.4,0.778,48,27,3,2,0.364,0.833,51,25,5,4
7882,22000692,Atlanta Hawks,Golden State Warriors,124,108,232,16,Atlanta Hawks,16,0.394,0.792,45,31,6,5,0.429,0.692,33,29,7,4
7883,22000693,Cleveland Cavaliers,Los Angeles Lakers,86,100,186,14,Los Angeles Lakers,14,0.192,0.679,37,24,11,4,0.231,0.72,45,23,15,3
7884,22000694,Detroit Pistons,Washington Wizards,92,106,198,14,Washington Wizards,14,0.345,0.842,43,19,9,5,0.429,1,48,24,7,5
7885,22000695,New York Knicks,Milwaukee Bucks,102,96,198,6,New York Knicks,6,0.364,0.75,44,28,9,11,0.389,0.625,48,21,11,7
7886,22000696,Houston Rockets,Minnesota Timberwolves,129,107,236,22,Houston Rockets,22,0.462,0.846,41,29,7,7,0.325,0.786,40,26,8,6
7887,22000697,Chicago Bulls,San Antonio Spurs,104,120,224,16,San Antonio Spurs,16,0.235,0.778,48,28,6,3,0.4,0.643,41,29,9,7
7888,22000698,Dallas Mavericks,New Orleans Pelicans,103,112,215,9,New Orleans Pelicans,9,0.323,0.792,38,19,2,4,0.346,0.655,42,20,2,5
7889,22000699,Boston Celtics,Oklahoma City Thunder,111,94,205,17,Boston Celtics,17,0.316,0.786,52,22,10,4,0.289,0.625,50,16,7,4
7890,22000700,Memphis Grizzlies,Utah Jazz,110,126,236,16,Utah Jazz,16,0.273,0.767,47,24,16,2,0.422,0.75,52,22,8,8
7891,22000701,Philadelphia 76ers,Los Angeles Clippers,112,122,234,10,Los Angeles Clippers,10,0.385,0.727,38,17,5,2,0.423,0.778,38,26,9,3
7892,22000702,Cleveland Cavaliers,Sacramento Kings,98,100,198,2,Sacramento Kings,2,0.346,0.652,36,20,11,2,0.233,0.786,44,16,4,9
7893,22000703,Phoenix Suns,Charlotte Hornets,101,97,198,4,Phoenix Suns,4,0.2,0.862,50,17,15,2,0.302,0.696,52,16,8,3
7894,22000704,Portland Trail Blazers,Toronto Raptors,122,117,239,5,Portland Trail Blazers,5,0.294,0.833,47,24,7,11,0.333,0.758,45,17,3,6
7895,22000705,Atlanta Hawks,Denver Nuggets,102,126,228,24,Denver Nuggets,24,0.353,0.857,31,18,7,3,0.417,0.688,49,32,7,3
7896,22000706,Orlando Magic,Los Angeles Lakers,93,96,189,3,Los Angeles Lakers,3,0.333,0.824,51,19,5,4,0.275,0.739,52,25,9,5
7897,22000707,Indiana Pacers,Washington Wizards,124,132,256,8,Washington Wizards,8,0.4,0.727,37,32,11,6,0.526,0.667,55,30,5,8
7898,22000708,New Orleans Pelicans,Boston Celtics,115,109,224,6,New Orleans Pelicans,6,0.516,0.567,47,30,8,2,0.326,0.789,46,21,5,9
7899,22000709,Minnesota Timberwolves,Brooklyn Nets,107,112,219,5,Brooklyn Nets,5,0.318,0.765,51,23,10,10,0.333,0.88,50,31,10,7
7900,22000710,Miami Heat,New York Knicks,98,88,186,10,Miami Heat,10,0.294,0.824,47,22,7,5,0.278,0.6,41,15,4,6
7901,22000711,Toronto Raptors,Detroit Pistons,104,118,222,14,Detroit Pistons,14,0.306,0.821,39,21,5,6,0.5,0.794,43,26,6,6
7902,22000712,Memphis Grizzlies,Houston Rockets,120,110,230,10,Memphis Grizzlies,10,0.355,0.708,47,31,8,4,0.262,0.864,42,28,9,5
7903,22000713,Dallas Mavericks,Oklahoma City Thunder,127,106,233,21,Dallas Mavericks,21,0.364,0.692,43,30,11,3,0.346,0.636,47,17,8,4
7904,22000714,Sacramento Kings,San Antonio Spurs,132,115,247,17,Sacramento Kings,17,0.5,0.8,37,29,9,6,0.37,0.786,41,24,5,4
7905,22000715,Cleveland Cavaliers,Utah Jazz,75,114,189,39,Utah Jazz,39,0.206,0.625,40,17,5,5,0.463,0.826,55,29,6,5
7906,22000716,Chicago Bulls,Golden State Warriors,102,116,218,14,Golden State Warriors,14,0.25,0.727,39,33,8,5,0.421,0.889,39,28,9,8
7907,22000717,Milwaukee Bucks,Los Angeles Clippers,105,129,234,24,Los Angeles Clippers,24,0.367,0.857,32,18,8,4,0.559,0.8,46,25,5,2
7908,22000718,Charlotte Hornets,Washington Wizards,114,104,218,10,Charlotte Hornets,10,0.412,0.842,50,24,6,6,0.27,0.8,51,22,5,1
7909,22000719,Philadelphia 76ers,Denver Nuggets,95,104,199,9,Denver Nuggets,9,0.314,0.933,34,18,14,6,0.387,0.824,51,26,9,6
7910,22000720,Orlando Magic,Los Angeles Clippers,103,96,199,7,Orlando Magic,7,0.294,0.88,50,23,10,6,0.324,1,48,25,3,4
7911,22000721,Portland Trail Blazers,Detroit Pistons,124,101,225,23,Portland Trail Blazers,23,0.533,0.923,43,27,11,7,0.333,0.706,36,29,7,7
7912,22000722,Miami Heat,Indiana Pacers,92,87,179,5,Miami Heat,5,0.313,0.643,42,22,5,4,0.297,0.667,48,23,7,4
7913,22000723,Dallas Mavericks,Boston Celtics,113,108,221,5,Dallas Mavericks,5,0.487,0.72,43,20,6,4,0.234,0.826,36,20,11,2
7914,22000724,Houston Rockets,Brooklyn Nets,108,120,228,12,Brooklyn Nets,12,0.325,0.708,31,22,5,8,0.361,1,45,25,6,3
7915,22000725,Utah Jazz,Memphis Grizzlies,111,107,218,4,Utah Jazz,4,0.327,0.76,46,20,10,5,0.278,0.783,46,23,10,4
7916,22000726,New York Knicks,Minnesota Timberwolves,101,102,203,1,Minnesota Timberwolves,1,0.478,0.706,41,20,7,6,0.35,0.842,40,25,9,8
7917,22000727,Toronto Raptors,Oklahoma City Thunder,103,113,216,10,Oklahoma City Thunder,10,0.348,0.85,35,21,13,7,0.424,0.75,64,19,2,6
7918,22000728,Sacramento Kings,San Antonio Spurs,106,120,226,14,San Antonio Spurs,14,0.314,0.895,43,22,7,5,0.385,0.706,54,24,9,2
7919,22000729,Milwaukee Bucks,Los Angeles Lakers,112,97,209,15,Milwaukee Bucks,15,0.538,0.778,42,23,13,8,0.278,0.773,40,22,9,5
7920,22000730,Chicago Bulls,Phoenix Suns,116,121,237,5,Phoenix Suns,5,0.333,0.905,50,27,6,4,0.44,0.75,32,29,6,7
7921,22000731,Philadelphia 76ers,Cleveland Cavaliers,114,94,208,20,Philadelphia 76ers,20,0.405,0.76,55,27,11,8,0.286,0.762,40,26,5,3
7922,22000732,Charlotte Hornets,Brooklyn Nets,89,111,200,22,Brooklyn Nets,22,0.342,0.842,43,22,11,5,0.444,0.75,56,34,8,5
7923,22000733,Golden State Warriors,Miami Heat,109,116,225,7,Miami Heat,7,0.405,0.88,46,23,7,3,0.333,0.833,37,30,10,6
7924,22000734,Orlando Magic,New Orleans Pelicans,115,110,225,5,Orlando Magic,5,0.2,0.87,48,20,17,5,0.414,0.842,55,26,7,7
7925,22000735,Atlanta Hawks,San Antonio Spurs,134,129,263,5,Atlanta Hawks,5,0.542,0.808,57,28,3,9,0.325,0.75,46,25,8,6
7926,22000736,Denver Nuggets,Los Angeles Clippers,101,94,195,7,Denver Nuggets,7,0.52,0.714,38,28,6,5,0.294,0.875,45,17,6,5
7927,22000737,Golden State Warriors,Toronto Raptors,77,130,207,53,Toronto Raptors,53,0.324,0.778,38,19,5,4,0.429,0.84,53,26,14,8
7928,22000738,Houston Rockets,Boston Celtics,102,118,220,16,Boston Celtics,16,0.333,0.615,40,26,6,1,0.415,0.75,50,35,9,7
7929,22000739,Dallas Mavericks,New York Knicks,99,86,185,13,Dallas Mavericks,13,0.324,0.5,47,19,6,2,0.316,1,43,18,7,3
7930,22000740,Charlotte Hornets,Indiana Pacers,114,97,211,17,Charlotte Hornets,17,0.258,0.69,44,27,16,3,0.303,0.579,48,29,7,6
7931,22000741,Minnesota Timberwolves,Memphis Grizzlies,108,120,228,12,Memphis Grizzlies,12,0.364,0.87,39,21,6,6,0.487,0.68,53,26,8,4
7932,22000742,Atlanta Hawks,New Orleans Pelicans,126,103,229,23,Atlanta Hawks,23,0.448,0.714,42,25,10,9,0.276,0.826,34,22,7,6
7933,22000743,Chicago Bulls,Utah Jazz,106,113,219,7,Utah Jazz,7,0.25,0.765,41,26,5,3,0.361,0.963,43,16,6,5
7934,22000744,Oklahoma City Thunder,Phoenix Suns,103,140,243,37,Phoenix Suns,37,0.395,0.783,38,19,6,3,0.455,0.81,41,36,12,8
7935,22000745,Milwaukee Bucks,Portland Trail Blazers,127,109,236,18,Milwaukee Bucks,18,0.308,0.895,50,25,7,5,0.389,0.727,45,19,11,3
7936,22000746,Los Angeles Lakers,Sacramento Kings,115,94,209,21,Los Angeles Lakers,21,0.515,0.6,55,26,10,2,0.286,0.75,38,24,8,5
7937,22000747,Dallas Mavericks,Washington Wizards,109,87,196,22,Dallas Mavericks,22,0.333,0.792,50,17,7,4,0.2,0.8,44,12,4,3
7938,22000748,New York Knicks,Detroit Pistons,125,81,206,44,New York Knicks,44,0.487,0.741,44,31,12,11,0.321,0.7,43,20,4,4
7939,22000749,Cleveland Cavaliers,Miami Heat,101,115,216,14,Miami Heat,14,0.323,0.84,35,25,7,4,0.395,0.75,37,35,6,3
7940,22000750,Minnesota Timberwolves,Philadelphia 76ers,113,122,235,9,Philadelphia 76ers,9,0.333,0.861,36,17,7,5,0.429,0.757,42,26,7,7
7941,22000751,Indiana Pacers,San Antonio Spurs,139,133,272,6,Indiana Pacers,6,0.414,0.885,44,27,10,6,0.345,0.844,46,22,6,6
7942,22000752,Orlando Magic,Utah Jazz,91,137,228,46,Utah Jazz,46,0.087,0.806,39,11,5,4,0.473,0.75,50,34,10,6
7943,22000753,Oklahoma City Thunder,Portland Trail Blazers,85,133,218,48,Portland Trail Blazers,48,0.235,0.708,46,17,4,6,0.435,0.786,56,25,13,3
7944,22000754,Milwaukee Bucks,Sacramento Kings,129,128,257,1,Milwaukee Bucks,1,0.355,0.9,47,31,10,3,0.436,1,40,31,7,4
7945,22000755,Brooklyn Nets,Chicago Bulls,107,115,222,8,Chicago Bulls,8,0.393,0.857,35,28,3,3,0.364,0.7,40,29,4,3
7946,22000756,Los Angeles Lakers,Los Angeles Clippers,86,104,190,18,Los Angeles Clippers,18,0.304,0.75,36,16,9,7,0.5,0.889,50,23,10,4
7947,22000757,Charlotte Hornets,Boston Celtics,86,116,202,30,Boston Celtics,30,0.323,0.6,42,23,3,5,0.389,0.818,44,29,11,5
7948,22000758,Memphis Grizzlies,Philadelphia 76ers,116,100,216,16,Memphis Grizzlies,16,0.421,0.8,49,30,6,10,0.235,0.643,50,23,4,6
7949,22000759,Golden State Warriors,Atlanta Hawks,111,117,228,6,Atlanta Hawks,6,0.25,0.714,45,25,12,6,0.375,0.778,49,19,10,3
7950,22000760,New Orleans Pelicans,Houston Rockets,122,115,237,7,New Orleans Pelicans,7,0.432,0.629,55,26,12,9,0.4,0.708,48,25,3,3
7951,22000761,Orlando Magic,Denver Nuggets,109,119,228,10,Denver Nuggets,10,0.371,0.706,36,27,11,4,0.31,0.774,54,27,6,5
7952,22000762,New York Knicks,Brooklyn Nets,112,114,226,2,Brooklyn Nets,2,0.483,0.818,41,24,7,4,0.313,0.769,45,27,6,6
7953,22000763,Washington Wizards,Toronto Raptors,101,103,204,2,Toronto Raptors,2,0.343,0.833,54,21,7,5,0.212,0.727,45,22,11,9
7954,22000764,Utah Jazz,Dallas Mavericks,103,111,214,8,Dallas Mavericks,8,0.273,0.773,48,20,3,4,0.469,0.75,44,22,2,2
7955,22000765,Sacramento Kings,Minnesota Timberwolves,106,116,222,10,Minnesota Timberwolves,10,0.25,0.792,42,27,9,8,0.375,0.848,51,22,10,4
7956,22000766,Detroit Pistons,Oklahoma City Thunder,132,108,240,24,Detroit Pistons,24,0.464,0.875,50,32,10,7,0.185,0.84,42,17,10,6
7957,22000767,Cleveland Cavaliers,San Antonio Spurs,125,101,226,24,Cleveland Cavaliers,24,0.353,0.852,47,29,5,4,0.192,0.813,38,22,4,3
7958,22000768,Phoenix Suns,Houston Rockets,133,130,263,3,Phoenix Suns,3,0.486,0.871,37,29,11,3,0.515,0.818,38,28,6,3
7959,22000769,Chicago Bulls,Indiana Pacers,113,97,210,16,Chicago Bulls,16,0.424,0.786,57,28,9,5,0.3,0.75,33,20,15,12
7960,22000770,New Orleans Pelicans,Atlanta Hawks,107,123,230,16,Atlanta Hawks,16,0.316,0.75,49,24,7,7,0.645,0.682,42,24,7,6
7961,22000771,Philadelphia 76ers,Boston Celtics,106,96,202,10,Philadelphia 76ers,10,0.375,0.744,38,16,11,4,0.412,0.889,32,19,5,6
7962,22000772,Los Angeles Lakers,Toronto Raptors,110,101,211,9,Los Angeles Lakers,9,0.45,0.636,49,29,8,7,0.152,0.8,42,17,13,3
7963,22000773,Memphis Grizzlies,Miami Heat,124,112,236,12,Memphis Grizzlies,12,0.415,0.75,42,30,11,2,0.394,0.611,35,34,9,4
7964,22000774,Milwaukee Bucks,Golden State Warriors,121,122,243,1,Golden State Warriors,1,0.438,0.864,40,25,7,2,0.375,0.882,42,28,6,5
7965,22000775,Portland Trail Blazers,Los Angeles Clippers,116,133,249,17,Los Angeles Clippers,17,0.306,0.838,48,18,4,5,0.39,0.833,48,24,5,5
7966,22000776,Minnesota Timberwolves,Indiana Pacers,137,141,278,4,Indiana Pacers,4,0.357,0.775,42,30,7,2,0.5,0.895,35,32,6,7
7967,22000777,Washington Wizards,Orlando Magic,131,116,247,15,Washington Wizards,15,0.528,0.875,37,35,7,3,0.387,0.696,39,22,11,3
7968,22000778,New York Knicks,Boston Celtics,99,101,200,2,Boston Celtics,2,0.485,0.813,39,22,7,4,0.375,0.7,53,22,6,7
7969,22000779,New Orleans Pelicans,Brooklyn Nets,111,139,250,28,Brooklyn Nets,28,0.222,0.744,40,23,9,2,0.463,0.818,45,37,10,8
7970,22000780,Memphis Grizzlies,Atlanta Hawks,131,113,244,18,Memphis Grizzlies,18,0.425,0.857,54,30,5,5,0.357,0.867,42,26,5,3
7971,22000781,Charlotte Hornets,Oklahoma City Thunder,113,102,215,11,Charlotte Hornets,11,0.341,0.923,42,27,12,5,0.39,0.706,46,29,4,5
7972,22000782,San Antonio Spurs,Denver Nuggets,96,106,202,10,Denver Nuggets,10,0.25,0.667,42,23,11,4,0.308,0.75,53,26,10,6
7973,22000783,Utah Jazz,Phoenix Suns,113,117,230,4,Phoenix Suns,4,0.25,0.667,45,14,6,4,0.324,0.8,61,20,7,5
7974,22000784,Los Angeles Lakers,Miami Heat,104,110,214,6,Miami Heat,6,0.343,0.88,40,26,9,3,0.4,0.8,38,22,12,8
7975,22000785,Cleveland Cavaliers,Oklahoma City Thunder,129,102,231,27,Cleveland Cavaliers,27,0.351,0.833,44,35,8,3,0.406,0.692,44,28,5,5
7976,22000786,Milwaukee Bucks,Dallas Mavericks,101,116,217,15,Dallas Mavericks,15,0.364,0.813,52,16,8,1,0.378,0.722,56,23,6,8
7977,22000787,Portland Trail Blazers,Utah Jazz,103,122,225,19,Utah Jazz,19,0.271,0.778,41,18,3,5,0.286,0.889,58,21,4,3
7978,22000788,Phoenix Suns,Los Angeles Clippers,103,113,216,10,Los Angeles Clippers,10,0.25,0.833,36,20,6,6,0.486,0.917,35,26,5,1
7979,22000789,Detroit Pistons,Sacramento Kings,113,101,214,12,Detroit Pistons,12,0.348,0.85,43,24,7,4,0.233,0.692,38,20,9,4
7980,22000790,Indiana Pacers,Orlando Magic,111,106,217,5,Indiana Pacers,5,0.333,0.857,49,26,8,10,0.25,0.774,50,23,3,8
7981,22000791,Chicago Bulls,Atlanta Hawks,108,120,228,12,Atlanta Hawks,12,0.394,0.929,38,25,6,1,0.259,0.826,41,25,7,4
7982,22000792,Minnesota Timberwolves,Boston Celtics,136,145,281,9,Boston Celtics,9,0.357,0.9,37,30,14,0,0.452,0.941,45,32,9,5
7983,22000793,Memphis Grizzlies,New York Knicks,129,133,262,4,New York Knicks,4,0.467,0.618,43,33,7,6,0.438,0.879,48,24,7,7
7984,22000794,Toronto Raptors,Cleveland Cavaliers,135,115,250,20,Toronto Raptors,20,0.531,0.857,39,29,12,11,0.429,0.846,32,27,11,5
7985,22000795,Philadelphia 76ers,New Orleans Pelicans,94,101,195,7,New Orleans Pelicans,7,0.355,0.708,47,20,8,5,0.182,0.633,56,22,11,7
7986,22000796,Charlotte Hornets,Milwaukee Bucks,127,119,246,8,Charlotte Hornets,8,0.38,0.909,49,35,4,10,0.368,0.739,48,23,10,3
7987,22000797,San Antonio Spurs,Denver Nuggets,119,121,240,2,Denver Nuggets,2,0.333,0.857,38,33,10,2,0.519,0.913,46,32,5,4
7988,22000798,Washington Wizards,Golden State Warriors,110,107,217,3,Washington Wizards,3,0.263,0.792,47,30,6,1,0.306,0.667,41,27,15,3
7989,22000799,Houston Rockets,Los Angeles Clippers,109,126,235,17,Los Angeles Clippers,17,0.324,0.704,41,28,3,6,0.514,0.846,38,31,10,4
7990,22000800,Los Angeles Lakers,Brooklyn Nets,126,101,227,25,Los Angeles Lakers,25,0.559,0.65,47,30,12,4,0.185,0.867,42,19,6,10
7991,22000801,Sacramento Kings,Utah Jazz,112,128,240,16,Utah Jazz,16,0.333,0.636,38,23,8,4,0.36,0.857,52,22,8,5
7992,22000802,Houston Rockets,Golden State Warriors,109,125,234,16,Golden State Warriors,16,0.351,0.7,45,25,8,3,0.4,0.813,45,31,13,5
7993,22000803,Washington Wizards,Phoenix Suns,106,134,240,28,Phoenix Suns,28,0.36,0.679,49,27,2,1,0.395,1,45,36,8,3
7994,22000804,Detroit Pistons,Portland Trail Blazers,103,118,221,15,Portland Trail Blazers,15,0.346,0.714,38,25,9,6,0.448,0.792,49,18,5,8
7995,22000805,Atlanta Hawks,Charlotte Hornets,105,101,206,4,Atlanta Hawks,4,0.436,0.75,41,27,7,1,0.349,0.857,38,28,5,5
7996,22000806,Boston Celtics,Denver Nuggets,105,87,192,18,Boston Celtics,18,0.212,0.87,52,20,4,7,0.235,0.833,46,23,5,4
7997,22000807,New Orleans Pelicans,Cleveland Cavaliers,116,109,225,7,New Orleans Pelicans,7,0.292,0.808,50,30,9,3,0.325,0.824,36,29,7,5
7998,22000808,Milwaukee Bucks,Orlando Magic,124,87,211,37,Milwaukee Bucks,37,0.475,0.867,56,28,8,7,0.222,0.789,37,19,8,6
7999,22000809,Toronto Raptors,New York Knicks,96,102,198,6,New York Knicks,6,0.324,0.826,40,19,8,7,0.257,0.852,46,19,9,4
8000,22000810,San Antonio Spurs,Dallas Mavericks,119,117,236,2,San Antonio Spurs,2,0.381,0.778,41,20,10,7,0.31,0.933,37,25,5,3
8001,22000811,Indiana Pacers,Memphis Grizzlies,132,125,257,7,Indiana Pacers,7,0.351,0.882,53,35,5,10,0.3,0.684,50,27,11,6
8002,22000812,Chicago Bulls,Minnesota Timberwolves,117,121,238,4,Minnesota Timberwolves,4,0.395,0.615,38,30,10,8,0.444,1,36,27,7,6
8003,22000813,Detroit Pistons,Los Angeles Clippers,124,131,255,7,Los Angeles Clippers,7,0.469,0.895,31,33,12,4,0.556,0.762,37,35,4,5
8004,22000814,Miami Heat,Portland Trail Blazers,107,98,205,9,Miami Heat,9,0.414,0.65,30,21,12,4,0.314,0.684,41,21,5,5
8005,22000815,Los Angeles Lakers,New York Knicks,96,111,207,15,New York Knicks,15,0.333,0.778,33,22,5,7,0.185,0.815,47,18,14,9
8006,22000816,San Antonio Spurs,Orlando Magic,120,97,217,23,San Antonio Spurs,23,0.4,0.778,47,30,6,5,0.25,0.625,44,15,6,2
8007,22000817,Brooklyn Nets,Minnesota Timberwolves,127,97,224,30,Brooklyn Nets,30,0.417,0.833,57,31,8,4,0.265,0.727,44,16,13,12
8008,22000818,Philadelphia 76ers,Dallas Mavericks,113,95,208,18,Philadelphia 76ers,18,0.387,0.697,40,24,9,4,0.25,0.8,46,16,7,3
8009,22000819,Sacramento Kings,New Orleans Pelicans,110,117,227,7,New Orleans Pelicans,7,0.286,0.595,34,21,14,3,0.316,0.692,51,24,8,5
8010,22000820,Washington Wizards,Utah Jazz,125,121,246,4,Washington Wizards,4,0.474,0.786,44,29,7,4,0.417,0.774,43,21,2,3
8011,22000821,Denver Nuggets,Golden State Warriors,107,116,223,9,Golden State Warriors,9,0.308,0.84,41,23,11,2,0.409,0.909,36,23,11,3
8012,22000822,Houston Rockets,Phoenix Suns,120,126,246,6,Phoenix Suns,6,0.405,0.789,51,32,9,3,0.556,0.611,42,33,14,3
8013,22000823,Los Angeles Clippers,Indiana Pacers,126,115,241,11,Los Angeles Clippers,11,0.464,0.895,48,34,10,5,0.225,0.818,42,14,9,5
8014,22000824,Atlanta Hawks,Toronto Raptors,108,103,211,5,Atlanta Hawks,5,0.433,0.682,39,21,7,2,0.256,0.692,42,16,7,4
8015,22000825,Los Angeles Lakers,Charlotte Hornets,101,93,194,8,Los Angeles Lakers,8,0.364,0.944,38,24,9,2,0.257,0.667,45,22,5,3
8016,22000826,Oklahoma City Thunder,Utah Jazz,96,106,202,10,Utah Jazz,10,0.412,0.556,50,13,8,1,0.362,0.85,51,24,6,10
8017,22000827,Miami Heat,Phoenix Suns,86,106,192,20,Phoenix Suns,20,0.205,0.789,36,24,13,2,0.31,0.944,48,28,11,2
8018,22000828,Boston Celtics,Portland Trail Blazers,116,115,231,1,Boston Celtics,1,0.429,0.708,46,30,5,4,0.395,0.706,46,31,6,5
8019,22000829,Cleveland Cavaliers,Charlotte Hornets,103,90,193,13,Cleveland Cavaliers,13,0.419,0.842,47,27,9,7,0.364,0.5,38,23,8,5
8020,22000830,Brooklyn Nets,Philadelphia 76ers,117,123,240,6,Philadelphia 76ers,6,0.19,0.9,43,23,6,3,0.464,0.8,32,23,8,9
8021,22000831,San Antonio Spurs,Toronto Raptors,112,117,229,5,Toronto Raptors,5,0.436,0.704,41,26,6,7,0.467,0.84,54,21,8,5
8022,22000832,Los Angeles Clippers,Detroit Pistons,100,98,198,2,Los Angeles Clippers,2,0.241,0.905,47,10,8,2,0.292,0.773,46,17,5,4
8023,22000833,Orlando Magic,Chicago Bulls,115,106,221,9,Orlando Magic,9,0.444,0.75,46,29,8,10,0.459,0.778,40,23,7,6
8024,22000834,Milwaukee Bucks,Minnesota Timberwolves,130,105,235,25,Milwaukee Bucks,25,0.475,0.826,52,26,14,4,0.366,0.71,47,22,13,7
8025,22000835,New York Knicks,New Orleans Pelicans,116,106,222,10,New York Knicks,10,0.515,0.846,48,19,6,5,0.214,0.833,49,25,3,5
8026,22000836,Golden State Warriors,Oklahoma City Thunder,147,109,256,38,Golden State Warriors,38,0.511,0.826,41,39,12,6,0.259,0.56,50,22,6,2
8027,22000837,Dallas Mavericks,Memphis Grizzlies,114,113,227,1,Dallas Mavericks,1,0.325,0.765,45,25,4,3,0.382,0.762,45,27,7,3
8028,22000838,Miami Heat,Denver Nuggets,106,123,229,17,Denver Nuggets,17,0.406,0.833,30,29,7,8,0.472,0.769,43,32,5,7
8029,22000839,Washington Wizards,Sacramento Kings,123,111,234,12,Washington Wizards,12,0.292,0.815,56,23,12,3,0.333,0.75,30,22,17,8
8030,22000840,Milwaukee Bucks,Atlanta Hawks,120,109,229,11,Milwaukee Bucks,11,0.372,0.706,51,25,8,1,0.412,0.895,39,23,5,4
8031,22000841,Golden State Warriors,Cleveland Cavaliers,119,101,220,18,Golden State Warriors,18,0.37,0.8,47,33,9,5,0.323,0.778,39,21,11,2
8032,22000842,Boston Celtics,Los Angeles Lakers,121,113,234,8,Boston Celtics,8,0.438,0.846,48,33,4,6,0.324,0.684,36,28,12,2
8033,22000843,Sacramento Kings,Phoenix Suns,114,122,236,8,Phoenix Suns,8,0.467,0.737,32,22,7,4,0.368,0.857,39,30,9,4
8034,22000844,Indiana Pacers,Utah Jazz,111,119,230,8,Utah Jazz,8,0.333,0.941,43,23,13,3,0.381,0.792,56,22,5,6
8035,22000845,Oklahoma City Thunder,Detroit Pistons,104,110,214,6,Detroit Pistons,6,0.179,0.731,56,19,13,8,0.286,0.706,54,22,13,7
8036,22000846,Los Angeles Clippers,Philadelphia 76ers,103,106,209,3,Philadelphia 76ers,3,0.487,0.625,43,26,6,3,0.318,0.733,46,21,13,7
8037,22000847,New Orleans Pelicans,Washington Wizards,115,117,232,2,Washington Wizards,2,0.25,0.848,56,26,11,7,0.148,0.719,46,24,5,7
8038,22000848,Charlotte Hornets,Brooklyn Nets,115,130,245,15,Brooklyn Nets,15,0.353,0.75,37,26,12,3,0.512,0.938,37,35,12,5
8039,22000849,Orlando Magic,Toronto Raptors,102,113,215,11,Toronto Raptors,11,0.348,0.706,35,20,8,4,0.4,0.944,42,24,6,10
8040,22000850,Memphis Grizzlies,Chicago Bulls,126,115,241,11,Memphis Grizzlies,11,0.425,0.792,42,33,9,4,0.382,0.8,46,34,3,1
8041,22000851,Denver Nuggets,Houston Rockets,128,99,227,29,Denver Nuggets,29,0.29,0.871,54,22,11,3,0.314,0.667,35,23,7,3
8042,22000852,Miami Heat,Minnesota Timberwolves,111,119,230,8,Minnesota Timberwolves,8,0.412,0.731,33,33,11,5,0.417,0.69,45,30,8,2
8043,22000853,Portland Trail Blazers,San Antonio Spurs,107,106,213,1,Portland Trail Blazers,1,0.379,0.875,38,23,9,6,0.304,0.9,49,30,7,9
8044,22000854,New York Knicks,Dallas Mavericks,117,109,226,8,New York Knicks,8,0.5,0.714,45,22,4,5,0.333,0.737,41,30,6,7
8045,22000855,Utah Jazz,Los Angeles Lakers,115,127,242,12,Los Angeles Lakers,12,0.39,1,37,31,10,3,0.333,0.87,52,26,8,8
8046,22000856,Detroit Pistons,Washington Wizards,100,121,221,21,Washington Wizards,21,0.333,0.739,45,19,7,6,0.563,0.632,48,25,11,6
8047,22000857,Cleveland Cavaliers,Chicago Bulls,96,106,202,10,Chicago Bulls,10,0.4,0.857,44,27,6,1,0.4,0.889,38,30,6,2
8048,22000858,Golden State Warriors,Boston Celtics,114,119,233,5,Boston Celtics,5,0.425,0.75,40,22,6,2,0.326,0.8,45,18,9,2
8049,22000859,Memphis Grizzlies,Milwaukee Bucks,128,115,243,13,Memphis Grizzlies,13,0.375,0.917,43,31,10,3,0.34,0.778,45,27,7,1
8050,22000860,San Antonio Spurs,Phoenix Suns,111,85,196,26,San Antonio Spurs,26,0.414,0.75,46,23,10,9,0.222,0.438,48,19,7,2
8051,22000861,Indiana Pacers,Atlanta Hawks,117,129,246,12,Atlanta Hawks,12,0.313,0.85,41,33,7,5,0.406,0.765,51,20,8,7
8052,22000862,New Orleans Pelicans,New York Knicks,112,122,234,10,New York Knicks,10,0.222,0.8,52,25,6,4,0.379,0.875,49,27,9,6
8053,22000863,Brooklyn Nets,Miami Heat,107,109,216,2,Miami Heat,2,0.395,0.667,38,26,10,6,0.41,0.81,53,28,9,1
